,y_true,y_pred,default_final_strength,predicted_prob,num_args,num_rels,num_rels_not_flat,num_atts,num_supp,num_pos_args,num_neg_args
0,0,0,1.7614112413981002,0.14661367987331164,11,13,7,6,7,5,6
1,1,1,2.6551399747903206,0.9343270842404344,8,9,4,1,8,7,1
2,0,1,1.0581753720364677,0.7423417021503338,25,34,20,8,26,12,13
3,1,1,4.515172912077886,0.9891767122989189,17,24,13,3,21,14,3
4,0,0,0.9838932667252193,0.2721199578590655,6,6,2,1,5,1,5
5,0,0,3.7760435316985412,0.02239991455011281,25,35,22,6,29,7,18
6,0,1,0.459614446633933,0.6129227081796663,8,8,3,3,5,4,4
7,1,1,0.17308518068583534,0.5431635893119071,14,17,9,5,12,9,5
8,1,1,0.3893531163063737,0.5961269655226782,12,13,8,3,10,7,5
9,1,0,4.864028954670366,0.007660188910994625,17,19,10,3,16,4,13
10,1,0,1.7904524667235304,0.14301725869728255,6,5,2,0,5,0,6
11,1,0,1.5828873800913534,0.1703869472036158,26,38,25,8,30,10,16
12,1,1,1.1878824600302216,0.7663621299954523,14,20,15,3,17,11,3
13,1,0,0.6459369305778553,0.3439057239508152,16,18,7,5,13,5,11
14,0,0,2.6001872709226035,0.06912636887772494,19,26,16,4,22,5,14
15,1,1,3.4045226993583695,0.9678455822218344,22,29,18,5,24,13,9
16,0,0,1.2721052111306506,0.21889708765669302,17,22,13,3,19,4,13
17,1,1,2.8249884920219177,0.9440113126991398,21,30,14,7,23,13,8
18,1,1,4.634810717007392,0.9903853936507705,11,16,11,0,16,11,0
19,0,1,0.3443066681719904,0.585236283335429,10,12,7,3,9,5,5
20,0,1,0.8067068192989713,0.6914073038430593,15,21,12,6,15,9,6
21,1,1,2.08540190701801,0.8894762038592073,12,15,6,4,11,7,5
22,0,0,1.3665894163949028,0.20317143643214797,10,11,7,1,10,1,9
23,0,0,1.215637896602359,0.22870501063028048,31,48,35,6,42,15,16
24,1,1,0.002482173048150127,0.500620542943431,6,5,2,2,3,3,3
25,1,1,1.1870948392645229,0.7662210759550739,4,3,1,1,2,3,1
26,0,0,2.96445427512448,0.04905779126084531,16,18,8,4,14,3,13
27,0,1,2.4373352391182275,0.9196303544826931,10,11,5,2,9,6,4
28,1,1,1.688052335339018,0.8439678512701403,3,2,1,0,2,3,0
29,1,1,1.2321109414735811,0.7741878248293684,15,19,11,4,15,8,7
30,1,1,2.8166352926432343,0.9435681720876348,8,10,4,1,9,7,1
31,1,1,1.83896377754478,0.8628261091251761,14,19,11,3,16,11,3
32,1,1,1.8467785017965195,0.8637484183236299,16,20,13,5,15,8,8
33,1,1,4.3926462179018975,0.9877831400372644,17,28,18,3,25,15,2
34,1,0,0.6140328680507843,0.351139795981255,5,5,3,0,5,0,5
35,0,0,3.643867874774781,0.025484552785028036,18,22,13,4,18,6,12
36,1,1,2.175837002839963,0.8980585834230194,24,34,19,9,25,12,12
37,1,1,1.6688663572489673,0.8414246186155737,10,12,6,2,10,7,3
38,1,1,2.0959932489174085,0.8905131334282753,10,11,6,3,8,4,6
39,0,0,4.392509305451205,0.012218512278906246,31,47,30,10,37,9,22
40,1,1,0.19254708095464812,0.5479885994788065,14,17,8,7,10,6,8
41,0,0,2.0645784693295837,0.11258757578297296,14,15,7,1,14,2,12
42,1,0,0.5957032773144917,0.3553273303007126,2,1,0,0,1,0,2
43,0,0,1.9403205332602527,0.12561264680506445,28,42,28,8,34,11,17
44,1,0,2.4651067185664286,0.07834081915854552,24,37,25,6,31,8,16
45,0,0,0.09183646762834874,0.4770570058069765,23,34,19,11,23,10,13
46,1,0,0.9153019865585339,0.28591611321813304,17,22,11,6,16,5,12
47,1,1,2.4531769868471427,0.9207934675232439,16,24,15,4,20,13,3
48,0,0,3.7950649223222865,0.02198714343886987,15,17,12,2,15,3,12
49,0,1,6.998519525859744,0.999087600250495,29,43,26,8,35,19,10
50,0,0,0.8500968202694661,0.29941254765934877,6,5,3,2,3,2,4
51,1,1,5.713013122033881,0.9967081658796761,17,24,16,2,22,15,2
52,0,0,1.1492986640453147,0.2406172082413457,14,16,9,6,10,6,8
53,1,1,1.9581213830124484,0.876329499134134,6,7,4,0,7,6,0
54,1,1,1.0184979226844662,0.7346799097654613,19,26,13,8,18,10,9
55,1,1,4.558454841809608,0.989630417962836,22,29,18,6,23,12,10
56,1,1,1.6916473373709902,0.8444406779391851,9,11,8,1,10,8,1
57,0,0,1.9020577494330917,0.12987575496377446,6,5,2,0,5,0,6
58,0,0,4.220170913236258,0.01448328426174017,18,23,12,5,18,5,13
59,1,1,4.020118635286969,0.9823657149345794,39,64,39,16,48,21,18
60,0,0,2.3297227113282677,0.08869107254630026,7,8,4,0,8,0,7
61,0,1,1.1720818132171302,0.7635211070860908,8,9,5,2,7,6,2
62,0,0,1.049626977238055,0.25929673786005547,8,8,4,1,7,2,6
63,0,0,2.5430946506202528,0.07289176478505455,22,28,17,2,26,3,19
64,1,1,2.464840253677799,0.9216399389726335,12,16,9,2,14,10,2
65,1,1,0.7786334811116025,0.6853855231286916,14,18,11,6,12,7,7
66,0,0,4.838425541056723,0.007857287298792426,21,26,18,2,24,3,18
67,0,0,0.1709037309291217,0.4573777596364791,14,20,11,7,13,7,7
68,1,0,0.24909029344636213,0.4380474215524832,11,11,5,4,7,4,7
69,0,0,0.26470543861966256,0.4342073609872622,12,13,6,3,10,4,8
70,1,1,1.6731276800067738,0.8419923767270232,13,16,10,6,10,9,4
71,0,0,2.039477018261141,0.11511999610395407,16,20,11,2,18,3,13
72,0,0,1.4870893194720214,0.18435900662193316,21,31,18,6,25,6,15
73,1,1,1.5604250651164053,0.8264143385966696,11,13,5,3,10,7,4
74,0,0,0.9201617772945354,0.2849249322069419,11,13,8,2,11,3,8
75,0,0,2.7260530432034678,0.0614534173766319,9,9,4,2,7,2,7
76,1,1,1.966740475711244,0.8772605770301747,5,6,3,0,6,5,0
77,0,0,0.8167567220663665,0.30645255114919845,13,17,10,4,13,6,7
78,0,0,0.2510084510806849,0.43757530051604443,17,25,16,9,16,8,9
79,0,0,1.0052400324675892,0.2679124166828304,30,46,25,14,32,12,18
80,0,1,1.0312864331211247,0.7371652217037208,7,7,4,2,5,5,2
81,0,0,1.7024022495756808,0.15415177784748502,19,25,13,8,17,7,12
82,1,1,1.6084372052663323,0.8331942998610373,25,38,22,9,29,15,10
83,0,0,2.1411309718770637,0.1051629133769908,6,5,1,1,4,2,4
84,0,0,3.263232963204522,0.03685427991163659,25,36,24,10,26,10,15
85,0,0,2.9929848491211213,0.04774380234355735,9,10,5,2,8,1,8
86,0,1,0.1113466551707421,0.5278079393118009,15,21,16,5,16,11,4
87,1,0,0.2597033974641521,0.4354366210672628,1,0,0,0,0,0,1
88,1,1,2.5477021812989977,0.9274189933870142,20,30,19,7,23,11,9
89,0,0,1.6483221746357015,0.16133584142382118,11,13,7,3,10,4,7
90,1,1,3.315163136087321,0.9649453479966679,10,13,9,1,12,9,1
91,1,1,5.7141885871787474,0.9967120203274911,15,23,14,1,22,14,1
92,1,1,3.1276361847527094,0.9580184252310403,13,18,11,2,16,11,2
93,0,0,4.682558800429316,0.009170426039289636,21,28,17,5,23,4,17
94,0,0,2.2148540435043476,0.09842449894688743,6,6,4,0,6,0,6
95,0,0,4.789077526481361,0.008251475600638436,24,34,17,9,25,8,16
96,0,0,7.219659954334328,0.0007315158003375899,27,35,18,10,25,9,18
97,1,1,6.776216311342843,0.9988607170933199,15,22,11,1,21,13,2
98,1,1,5.188684527233225,0.9944516148738305,18,29,19,3,26,16,2
99,1,1,2.724286612085837,0.938444621402498,13,17,10,2,15,9,4
100,1,1,4.3242024035382185,0.9869290043557688,11,16,12,0,16,11,0
101,1,0,3.4383867314302647,0.031117085517034626,19,24,14,5,19,4,15
102,0,0,2.664294107402627,0.0651134466232397,18,24,15,6,18,5,13
103,0,0,2.5009668897141464,0.07579042525019186,11,12,8,1,11,2,9
104,1,0,0.01182949625027252,0.49704266042411593,40,63,39,17,46,19,21
105,0,0,3.795900667848531,0.021969178988098803,19,26,16,5,21,4,15
106,1,1,2.820639814246097,0.9437810235895632,18,25,15,4,21,13,5
107,1,1,4.36334539750576,0.9874244482937273,13,18,9,2,16,10,3
108,1,1,8.198341757411562,0.999724966274316,19,33,24,3,30,18,1
109,1,1,6.504964365297278,0.9985062405881436,16,23,13,3,20,12,4
110,0,1,0.1386187460714534,0.5345993016687858,11,13,8,4,9,5,6
111,0,0,1.220356702732817,0.2278736836099039,12,13,7,2,11,3,9
112,0,0,0.025020008899867996,0.49374532405766436,15,18,10,4,14,4,11
113,1,1,2.3886488558362204,0.915957616461375,25,39,27,7,32,18,7
114,1,1,4.805846353693795,0.9918846247523666,13,18,11,1,17,11,2
115,0,0,0.003711705594203085,0.49907207466676595,8,8,3,2,6,3,5
116,1,1,1.8837389226200658,0.8680399968422462,9,12,8,3,9,8,1
117,0,0,6.287594492782472,0.0018557766458876523,17,18,8,2,16,2,15
118,1,1,1.1754481123391813,0.7641283754224196,17,24,14,6,18,10,7
119,0,0,2.7137184323254644,0.06216869953961823,11,12,8,2,10,3,8
120,1,0,0.045089331382772935,0.48872957653208404,7,6,3,1,5,2,5
121,0,0,3.0526417246052477,0.045103559617246436,24,31,18,5,26,6,18
122,0,0,3.2333279332641003,0.03793061758845573,14,20,13,0,20,0,14
123,0,0,3.9455128197533647,0.018974307543820346,29,43,28,9,34,10,19
124,0,0,3.4166003958116664,0.03178067009384422,19,26,17,4,22,4,15
125,1,1,4.841087997041169,0.9921634408383543,12,16,11,2,14,10,2
126,1,1,4.412881650193343,0.9880249383858297,36,58,40,12,46,22,14
127,0,0,0.7306931383865445,0.3250426414033304,16,21,14,3,18,6,10
128,1,1,1.5857596077169391,0.830018672919553,5,5,3,0,5,5,0
129,0,0,2.8273513581419167,0.055863931427516667,25,38,24,9,29,7,18
130,0,1,0.6398413027913492,0.654717586004488,14,18,11,3,15,8,6
131,1,1,3.655724666784017,0.9748082608483146,12,19,12,2,17,11,1
132,1,1,1.4261727928639567,0.8063042920464809,19,26,15,8,18,9,10
133,0,0,2.8887871503051294,0.05271064588646157,19,25,14,5,20,4,15
134,0,0,2.4499539503729055,0.07944191676937018,16,22,13,6,16,5,11
135,0,1,3.5785188233476455,0.9728411756964963,33,51,31,13,38,18,15
136,0,0,0.46524986371625787,0.38574115159599254,7,7,3,1,6,1,6
137,1,1,6.20912226971144,0.9979930342049955,23,36,25,5,31,18,5
138,1,1,0.9165640308444294,0.7143414863191861,5,5,2,1,4,4,1
139,0,1,1.0226851922292741,0.7354953122436154,12,15,8,4,11,6,6
140,0,0,3.601686171486905,0.026553374111560557,26,37,23,6,31,9,17
141,0,0,0.6636585754253319,0.3399182428285442,14,17,8,3,14,4,10
142,0,0,3.294389544327515,0.03576416320811615,22,31,18,4,27,4,18
143,0,0,2.741096472035156,0.060591461899617394,9,12,5,2,10,1,8
144,1,1,1.193774035923937,0.7674153679364721,21,30,19,8,22,14,7
145,1,1,0.4119994424508404,0.6015672105981085,4,3,1,1,2,3,1
146,0,1,0.8490193862454776,0.7003613959105022,24,36,22,11,25,11,13
147,0,0,2.7419684650369196,0.06054184695246889,10,13,7,3,10,2,8
148,0,0,0.140324008775786,0.46497644917891323,7,6,2,1,5,2,5
149,0,0,4.131991339328537,0.01579732321420213,17,22,13,1,21,2,15
150,1,1,2.5961302802394073,0.9306121154508241,13,16,9,2,14,10,3
151,0,0,8.514314202134246,0.00020053640459460897,20,26,18,2,24,3,17
152,1,1,3.3378812425589497,0.965705742151286,14,18,10,4,14,8,6
153,0,0,2.376092860443002,0.08501399652751751,26,37,24,8,29,10,16
154,0,0,3.866164360150837,0.020509097923824715,13,13,6,2,11,1,12
155,1,1,4.760606529239543,0.9915122430475315,20,27,17,4,23,14,6
156,1,1,2.377802242551729,0.9151188762354874,10,12,6,2,10,8,2
157,1,1,2.99325973199511,0.9522686934690725,16,19,9,3,16,11,5
158,1,1,2.166390711919941,0.8971905238928629,11,15,9,1,14,10,1
159,0,0,2.466724371848632,0.07822409851323653,27,42,27,10,32,13,14
160,0,0,0.30064104936522007,0.42540078082622,17,21,11,5,16,7,10
161,1,1,0.7246245713213464,0.6736245651470505,7,6,2,2,4,4,3
162,1,1,2.9327661832214327,0.9494426207429189,7,8,5,1,7,6,1
163,0,0,6.651071880339963,0.0012909670614592583,30,39,24,6,33,7,23
164,0,1,0.20011401614226632,0.5498622180368682,17,22,10,8,14,8,9
165,1,1,1.5879644766160887,0.8303295264295307,25,35,24,7,28,16,9
166,1,1,7.8696788889780915,0.9996179889308833,17,27,16,2,25,16,1
167,1,1,1.549070143633455,0.8247793911111525,14,16,11,3,13,8,6
168,0,1,2.371396909015654,0.9146200087365463,8,10,4,1,9,7,1
169,1,1,3.618874357124075,0.9738873141043293,23,30,17,6,24,14,9
170,1,1,0.574737386891663,0.6398555822866918,2,1,0,0,1,2,0
171,0,0,3.4663874878602003,0.03028388949326144,19,29,17,5,24,5,14
172,1,1,1.519698026980201,0.8204940092265199,4,4,2,0,4,4,0
173,1,1,0.6552231920588087,0.6581865299053649,29,44,29,12,32,16,13
174,0,0,0.519775928235994,0.3729046306520082,17,23,13,6,17,6,11
175,0,0,0.061594929630250705,0.48460613422901866,5,4,1,1,3,1,4
176,1,0,0.5080349711298899,0.37565428702294357,12,16,9,5,11,5,7
177,0,0,0.17381545203257343,0.45665520913635704,8,8,3,2,6,3,5
178,1,1,0.542759620448114,0.6324541419496073,12,15,8,4,11,7,5
179,1,0,3.1711948177082405,0.040264218698014,17,20,11,3,17,4,13
180,1,0,0.9970510469879552,0.26952161563555443,12,12,6,1,11,2,10
181,0,0,3.7177007232179147,0.023713751399368155,17,23,13,1,22,1,16
182,1,1,6.0283940776493985,0.9975964309447308,14,22,14,0,22,14,0
183,0,0,1.3949453073461775,0.19861944015843036,4,3,1,0,3,0,4
184,1,1,1.9719597446910193,0.8778214533312454,20,29,21,4,25,15,5
185,0,1,0.574737386891663,0.6398555822866918,2,1,0,0,1,2,0
186,1,1,2.7178396210158176,0.9380711481080563,30,46,28,10,36,17,13
187,0,0,1.3258802507265566,0.20984163657367738,16,21,12,3,18,4,12
188,1,1,2.4378968786278885,0.9196718556820511,13,15,7,4,11,8,5
189,0,0,2.9746706801222738,0.048583374250107725,12,15,7,1,14,1,11
190,0,0,3.5035264977924596,0.029212057604610653,8,9,5,1,8,1,7
191,0,0,0.5496015095881353,0.3659568667513089,10,9,3,2,7,3,7
192,1,1,4.538686413876671,0.9894255772635777,14,19,12,2,17,12,2
193,0,1,1.0803887806269679,0.746567549411029,13,19,13,5,14,8,5
194,0,0,4.3808667935022365,0.012359829262864941,42,63,39,15,48,17,25
195,1,0,0.8941776653473774,0.2902484569075464,20,27,15,7,20,7,13
196,0,1,2.679635375807208,0.9358142255723817,13,18,10,1,17,12,1
197,1,1,0.797013717593323,0.6893353242344108,10,12,7,1,11,8,2
198,1,1,1.5371255386817912,0.8230464745401971,4,4,2,0,4,4,0
199,1,1,1.9865707015188059,0.879379861665845,11,13,5,3,10,8,3
200,0,0,0.880412738262883,0.29309225669953787,12,14,7,5,9,4,8
201,0,0,4.586337880677849,0.01008731667450613,18,22,13,5,17,5,13
202,1,1,3.7230479226835813,0.9764097290306946,8,10,6,0,10,8,0
203,0,0,1.94871303916566,0.1246937559827963,25,33,22,6,27,13,12
204,1,1,0.14504583015168526,0.5361980177375352,34,50,31,10,40,19,15
205,1,1,1.8442402605066934,0.8634494242020239,13,16,9,3,13,9,4
206,1,0,1.1531887426224492,0.2399071282566988,19,24,15,4,20,5,14
207,0,0,4.64641872578508,0.009504699832022734,11,13,8,0,13,0,11
208,0,0,2.3981104790975607,0.08331689543729415,10,10,5,3,7,4,6
209,1,1,1.530942292856358,0.8221441410733812,6,6,3,1,5,5,1
210,1,1,1.5442212112451856,0.8240775274741133,5,5,2,1,4,4,1
211,0,0,1.8820625127545056,0.1321521486482733,19,25,15,6,19,6,13
212,0,0,1.1789908832734195,0.2352336866176764,40,61,40,12,49,19,21
213,1,0,2.5275960596779465,0.0739460952879063,12,14,8,0,14,0,12
214,1,1,8.255507646999293,0.9997402438981043,22,35,24,1,34,21,1
215,1,1,4.077376089223273,0.9833306887031271,21,27,15,5,22,14,7
216,1,1,0.18940307643414345,0.547209721821897,18,24,16,5,19,7,11
217,0,1,0.7801295521623057,0.6857080347236839,23,34,22,7,27,13,10
218,1,1,6.525896033649037,0.9985371372383168,25,42,29,3,39,21,4
219,0,1,0.592910040959316,0.6440325653008037,11,13,7,3,10,7,4
220,1,1,1.7640094378627467,0.8537111031666935,17,25,15,4,21,12,5
221,1,1,1.7904455547535039,0.8569818941466162,13,15,8,4,11,8,5
222,1,1,5.256935998349267,0.9948157687594641,20,28,18,3,25,14,6
223,0,0,5.307671958467742,0.004929029453849987,25,33,19,8,25,7,18
224,0,0,3.0686015068829433,0.04442115289758086,34,49,32,10,39,15,19
225,0,0,0.288457089006953,0.42838163911465965,7,6,1,2,4,2,5
226,0,0,0.12526246126441754,0.4687252674897172,23,33,21,7,26,14,9
227,1,1,2.686772458123638,0.9362415901720572,14,19,10,2,17,12,2
228,0,0,0.040706010509103274,0.4898249023277693,8,8,4,1,7,2,6
229,0,0,4.433687931332129,0.011731371991606565,12,13,9,1,12,1,11
230,0,0,1.5212577738181547,0.17927638048594297,21,30,16,6,24,7,14
231,0,0,2.227713409074605,0.09728927387328168,11,13,8,1,12,1,10
232,0,0,2.28034177246199,0.09276418588776347,24,35,21,6,29,5,19
233,1,1,2.689342840801322,0.9363948527931435,13,15,7,2,13,9,4
234,0,0,2.844746733064827,0.05495350137513855,18,23,11,3,20,5,13
235,1,1,5.830276423305087,0.9970713373187007,11,16,9,0,16,11,0
236,0,1,1.6061876851204744,0.8328814236678918,5,6,3,0,6,5,0
237,0,0,0.45721957086057374,0.3876456258404518,12,14,10,2,12,5,7
238,1,1,0.25339328020841556,0.5630115258206646,7,6,2,2,4,4,3
239,0,0,1.4709803764893783,0.18679364730382741,17,25,15,7,18,6,11
240,1,1,3.492132512579942,0.9704630845635339,10,11,5,2,9,7,3
241,1,1,0.22456254299550515,0.5559058961947809,7,7,3,2,5,4,3
242,1,1,1.6957773466103665,0.8449824270793223,9,11,8,1,10,8,1
243,1,1,1.0778435978135645,0.7460856873760471,11,12,6,4,8,5,6
244,0,0,2.458929486372319,0.07878800050611146,23,34,19,7,27,7,16
245,1,1,1.7970620250794556,0.8577909208939624,4,4,2,0,4,4,0
246,1,0,0.002556794170077592,0.4993608018056942,3,2,0,1,1,1,2
247,0,1,0.49355618993491013,0.6209438212638658,8,8,4,3,5,4,4
248,1,1,1.0908967494682336,0.7485505477640659,12,17,12,2,15,8,4
249,0,0,3.450153155434811,0.03076429226306676,25,33,19,4,29,7,18
250,0,1,0.4171534542737869,0.6028018962275294,11,15,8,4,11,8,3
251,0,0,4.920269879369312,0.0072442984142401246,10,9,5,0,9,0,10
252,1,1,0.4845116440871635,0.6188126663595074,29,44,26,13,31,13,16
253,1,1,1.1392587003894623,0.7575435095060247,21,29,19,5,24,10,11
254,0,0,1.3651291535075818,0.20340794495739256,29,43,26,10,33,10,19
255,1,0,0.11003934641929414,0.4725178887570095,20,30,17,8,22,11,9
256,1,0,1.3684369533990397,0.2028724975099938,20,25,14,6,19,6,14
257,1,0,2.614047370710809,0.06823980905324256,14,17,10,2,15,3,11
258,0,1,0.3499650880080618,0.5866091128246295,8,7,2,3,4,4,4
259,0,0,4.481802238567104,0.011186453617864744,22,31,16,5,26,5,17
260,1,1,0.8406521859079854,0.6986025561110971,19,26,16,9,17,11,8
261,1,1,2.5261522258427545,0.9259549729164446,9,12,8,1,11,8,1
262,1,1,4.115478639855262,0.9839438778238982,18,29,20,3,26,16,2
263,0,0,3.384722036340362,0.03277636572279641,11,14,9,2,12,1,10
264,0,0,0.646016670493224,0.3438877320926954,26,38,27,5,33,12,14
265,1,1,6.220854090079375,0.9980163955589525,16,26,16,1,25,15,1
266,1,0,0.030237718405582648,0.49244114632384295,21,30,16,9,21,12,9
267,1,1,2.8459082968059213,0.9451067916526472,21,31,20,5,26,14,7
268,0,0,2.8418727244822595,0.05510295007978083,16,18,10,2,16,3,13
269,0,0,2.5789319240342543,0.07050669568522061,33,50,31,10,40,14,19
270,1,1,0.933541549050289,0.7177932363173725,6,6,3,1,5,5,1
271,0,0,0.7134897516967149,0.3288281916891498,3,2,0,1,1,1,2
272,0,0,2.0563136853384476,0.11341597139520965,11,10,5,1,9,3,8
273,0,1,3.478665378611683,0.9700746006084626,15,20,10,2,18,12,3
274,1,1,2.9038286724984412,0.9480353776680301,19,26,17,4,22,12,7
275,0,0,2.611152804039275,0.06842408485557738,16,20,14,3,17,8,8
276,0,0,1.370903498864856,0.20247391181706154,12,14,7,2,12,3,9
277,0,0,4.012568599236009,0.01776555417630954,17,25,15,5,20,2,15
278,0,0,0.4709556750303363,0.3843900731028175,11,13,8,2,11,4,7
279,1,1,3.9320109527721563,0.9807727257693827,11,16,9,1,15,10,1
280,1,1,1.891456508132206,0.868921511507673,12,12,5,3,9,7,5
281,1,1,0.24012116140542705,0.5597435073748546,3,2,0,1,1,2,1
282,0,1,0.6219097243871665,0.6506527608733652,29,43,28,9,34,16,13
283,1,0,0.5216336817030438,0.3724703036843514,2,1,0,0,1,0,2
284,1,1,0.9271254380185836,0.7164917354549429,12,14,8,3,11,7,5
285,0,0,0.03904608591779013,0.49023971853022297,24,34,22,7,27,12,12
286,1,1,1.6077150508113986,0.8330939095580582,13,17,10,2,15,10,3
287,1,1,0.12973117616252816,0.5323873829917912,8,7,1,4,3,3,5
288,1,1,1.3331805049464944,0.791366240957676,10,13,7,2,11,8,2
289,1,0,3.1573029080928023,0.04080448570446604,19,24,16,4,20,5,14
290,0,0,2.702221307176795,0.06284240897516669,20,25,12,6,19,8,12
291,0,0,0.7645199116763097,0.31766574986730123,2,1,0,0,1,0,2
292,1,1,1.0794248218600044,0.7463851207832106,18,24,14,5,19,10,8
293,1,1,3.6769228571830896,0.9753236208210964,12,18,12,2,16,11,1
294,1,1,1.6301006062411019,0.8361834203568751,24,36,19,10,26,14,10
295,0,0,5.050070753333913,0.006368067798361299,12,14,6,0,14,0,12
296,0,0,1.5200294557266067,0.17945718194282978,28,42,25,9,33,11,17
297,1,1,3.799539092054218,0.9781088623162069,29,48,34,8,40,22,7
298,0,0,2.331395119969053,0.08855599312390006,9,10,5,1,9,2,7
299,0,0,2.249482074678375,0.09539414943665858,12,14,8,2,12,2,10
300,0,1,2.6819014604296725,0.9359502057713238,19,28,18,5,23,11,8
301,0,1,1.5410929326858123,0.8236235493059507,9,10,5,2,8,5,4
302,0,0,2.3891866764702674,0.08400099176427589,25,37,27,7,30,10,15
303,0,1,1.0181200705422342,0.7346062502773574,8,8,3,2,6,5,3
304,0,0,0.42629860964030264,0.3950105349006453,6,7,3,1,6,1,5
305,1,0,3.3052039301301885,0.035393094701958616,40,63,36,12,51,13,27
306,0,0,0.3235103968956465,0.4198204762644119,6,6,4,2,4,3,3
307,1,1,1.5823186354744712,0.8295326426952031,27,41,24,10,31,17,10
308,1,1,4.6548671610268935,0.9905745080809082,21,29,16,5,24,16,5
309,1,1,1.585615805216149,0.8299983831961171,36,58,41,9,49,21,15
310,1,1,0.22455205571541903,0.5559033071509127,5,5,2,1,4,4,1
311,0,0,0.35317154509108944,0.41261354152447893,11,12,7,1,11,4,7
312,0,0,3.607088646185269,0.026414085973355816,17,21,12,5,16,5,12
313,1,1,3.63946717429011,0.9744059268971947,10,14,9,1,13,9,1
314,1,1,3.2289885167441748,0.9619107110144405,11,15,6,2,13,9,2
315,0,0,2.884259621494907,0.052937173871444254,20,25,11,7,18,8,12
316,0,0,0.2597033974641521,0.4354366210672628,1,0,0,0,0,0,1
317,0,1,1.5801276681477132,0.8292225981406588,17,24,16,7,17,10,7
318,0,0,3.9253334733517056,0.019353600456097575,22,31,18,7,24,7,15
319,0,0,4.96080196987827,0.006958545274734718,22,30,19,7,23,5,17
320,1,1,2.607104888083332,0.9313174407592678,12,12,5,3,9,8,4
321,0,1,2.756899787134651,0.9403018431538663,14,20,11,6,14,8,6
322,0,0,5.563699446809434,0.003819916642386456,15,20,13,0,20,0,15
323,0,0,0.6973915920565672,0.33239079894414303,18,24,13,5,19,6,12
324,1,1,4.309731417307428,0.9867410051127814,11,14,9,1,13,10,1
325,1,1,3.5291110818753797,0.9715048145141575,15,22,14,3,19,11,4
326,0,0,1.4891195915596454,0.18405390868129212,10,11,7,1,10,1,9
327,0,0,2.7820888402428223,0.05829977045431245,14,15,7,1,14,3,11
328,1,1,4.715631429410113,0.9911252559947248,8,10,4,0,10,8,0
329,1,1,1.5447202492960779,0.8241498631946895,6,6,3,1,5,5,1
330,0,0,0.4795659157400215,0.3823546331454305,7,8,5,2,6,3,4
331,0,0,4.129027223414366,0.015843474804636992,8,8,4,1,7,1,7
332,0,0,1.1113850826465268,0.2476127565266476,23,32,20,7,25,9,14
333,1,1,2.6276486479175962,0.9326199406998344,7,8,4,1,7,6,1
334,1,1,0.923713107833573,0.7157980725268923,20,26,13,9,17,11,9
335,0,1,1.1863764038318205,0.7660923606335116,25,35,19,11,24,8,17
336,0,0,0.9524406045975873,0.2783942616539391,12,15,8,4,11,3,9
337,1,1,1.110949758952193,0.752306133463081,8,8,4,2,6,4,4
338,1,0,0.678797200239892,0.3365298078882295,6,6,3,2,4,1,5
339,1,1,2.7360631406124707,0.9391214057468095,15,20,16,4,16,12,3
340,0,0,4.299402296635835,0.013394814415813805,17,19,10,4,15,3,14
341,1,1,1.64875489673617,0.8387227001469816,8,9,4,2,7,6,2
342,1,0,1.3418140927380504,0.2072118899637223,3,2,0,0,2,0,3
343,1,1,0.7075246750606752,0.6698539729603801,11,12,4,5,7,5,6
344,1,1,4.212795100752478,0.9854110590544949,21,31,20,7,24,12,9
345,0,0,0.9635370349497334,0.2761705807308592,5,5,2,0,5,0,5
346,0,0,3.150235154005955,0.04108201347755125,21,32,20,11,21,8,13
347,1,0,2.962440973416943,0.049151799365792614,11,13,8,0,13,0,11
348,1,1,0.3027378268918346,0.575111664553875,5,4,1,2,2,3,2
349,1,1,3.978717928908937,0.9816340095187243,13,16,7,2,14,9,4
350,0,0,0.7906304493822542,0.31203331574240156,43,70,43,19,51,19,24
351,0,0,1.287914076635349,0.2162060842535326,7,7,3,3,4,3,4
352,0,0,4.0868833233966395,0.016514187968954208,10,12,6,3,9,1,9
353,0,0,2.5689826575803236,0.071161518602881,15,15,6,2,13,2,13
354,0,0,0.5484173139052446,0.3662316821534276,12,14,7,3,11,4,8
355,1,1,5.941049842890309,0.9973776270376464,20,29,19,2,27,17,3
356,0,0,0.4252347926557034,0.3952647912917451,17,22,11,5,17,6,11
357,0,0,1.9828263661381156,0.12101786795524139,24,37,22,9,28,8,16
358,1,1,3.593744942999302,0.97324058511364,38,63,42,16,47,24,14
359,0,1,2.07385395012932,0.8883358276582891,9,10,4,3,7,5,4
360,0,0,4.394702523463199,0.01219207014638013,18,25,17,5,20,4,14
361,0,0,10.271387589762778,3.460812079159048e-05,18,25,15,0,25,0,18
362,1,1,4.029076142390825,0.9825202200522498,10,13,7,2,11,8,2
363,0,0,5.414599136612501,0.004431397059093123,22,29,18,3,26,3,19
364,1,1,3.239468552603517,0.9622928304795166,10,12,6,3,9,7,3
365,0,0,4.610694752599954,0.009846979366766373,12,17,9,2,15,1,11
366,0,0,2.819365234884291,0.056286641820705974,41,67,42,16,51,19,22
367,1,1,2.669533684837494,0.9352047799207313,24,37,24,7,30,17,7
368,0,0,4.0720831431962825,0.01675629264884515,23,33,21,7,26,6,17
369,0,0,6.864075078551372,0.00104355807232559,14,16,8,1,15,1,13
370,1,0,0.06954971435955759,0.4826195768400061,16,21,10,6,15,6,10
371,1,1,3.6676103118744887,0.9750984966724374,21,28,19,5,23,13,8
372,0,0,1.5420620293337868,0.1762357163061089,8,8,4,2,6,2,6
373,0,0,1.547944700911584,0.17538331546621078,9,10,5,1,9,1,8
374,1,1,7.5896352545957635,0.9994945901088408,17,25,14,1,24,16,1
375,1,0,0.7098560341584015,0.32963065215976994,12,14,6,4,10,5,7
376,0,0,4.456703319556519,0.011467514205402263,14,17,9,0,17,0,14
377,1,0,0.14823930013875364,0.46300789162778777,24,36,23,10,26,11,13
378,0,0,1.0967854839199043,0.2503426822984006,16,21,12,4,17,6,10
379,0,1,0.03659304598042579,0.50914724079938,9,10,4,2,8,6,3
380,1,1,3.7917226916868825,0.9779408712674628,13,18,12,2,16,11,2
381,0,1,1.3190891149569204,0.7890301190688247,27,42,28,8,34,16,11
382,0,0,4.91806900904488,0.007260143852121037,43,70,42,19,51,17,26
383,1,1,2.162371309346676,0.896819183120693,11,12,6,3,9,6,5
384,0,0,0.2597033974641521,0.4354366210672628,1,0,0,0,0,0,1
385,1,1,0.574737386891663,0.6398555822866918,2,1,0,0,1,2,0
386,0,0,4.0264107454748395,0.01752561502845018,22,30,19,6,24,7,15
387,1,0,3.399205730036205,0.032320296818227345,40,60,38,14,46,18,22
388,0,0,5.527183861909502,0.0039614183546961,9,10,5,0,10,0,9
389,0,0,0.49342876364407595,0.3790861718547055,15,20,12,3,17,7,8
390,0,1,1.301739559815678,0.7861276025388346,6,7,3,1,6,5,1
391,1,1,3.676823270014503,0.97532122389789,18,27,19,2,25,15,3
392,0,1,0.5113260309801635,0.6251172756026799,7,8,4,2,6,4,3
393,0,1,0.0394536377240845,0.5098621301901588,4,3,1,1,2,2,2
394,1,0,0.03779078255327328,0.49055342858968576,12,14,8,3,11,4,8
395,1,1,3.56456856172667,0.9724701513742231,10,14,7,1,13,9,1
396,1,1,2.870000711335112,0.9463433841127176,20,28,18,7,21,14,6
397,1,1,0.18181255149178188,0.5453283428756754,23,31,19,10,21,14,9
398,0,1,0.5240808981507556,0.6281015205837441,14,19,12,6,13,8,6
399,0,1,2.018039097795447,0.882678095372909,33,52,33,14,38,18,15
400,0,0,0.678512440221537,0.3365933913515379,27,40,29,7,33,12,15
401,0,0,2.706496653896261,0.06259109005008112,18,21,10,6,15,7,11
402,0,0,1.1154510615712017,0.2468560394773004,40,66,42,13,53,16,24
403,0,0,0.8846707205635468,0.2922108266936134,10,10,4,2,8,2,8
404,0,0,1.401248452767767,0.19761807557912636,14,17,9,2,15,3,11
405,1,1,4.659702621359579,0.9906195481616489,19,26,14,5,21,13,6
406,0,0,2.078537843838231,0.11120039659116254,13,14,9,1,13,2,11
407,1,1,3.8373155302479938,0.9789032854819354,10,14,8,1,13,9,1
408,0,0,5.624480351563548,0.0035954637607154005,24,33,19,8,25,7,17
409,1,1,0.5049580454574265,0.6236237808981864,14,18,9,7,11,8,6
410,1,1,4.572535174394822,0.9897739194008521,13,21,14,0,21,13,0
411,0,1,0.539952021004044,0.6318012565282403,8,9,5,2,7,4,4
412,1,1,3.2750950800617824,0.9635644727951574,12,17,12,1,16,11,1
413,0,0,1.9288125477830982,0.12688207138062502,27,38,21,7,31,7,20
414,0,0,6.201977459538017,0.002021327444567733,16,17,9,1,16,1,15
415,1,1,1.3065123437680306,0.7869289595793766,10,13,9,1,12,8,2
416,1,1,1.6786684445053732,0.8427281307019087,23,31,20,6,25,13,10
417,0,0,7.50854957401858,0.0005480753395110671,20,25,14,2,23,3,17
418,0,0,2.761067116409934,0.05946465557431013,17,21,11,2,19,3,14
419,0,0,1.0833321815453985,0.2528759503362221,15,21,12,6,15,5,10
420,1,1,2.1244316648649417,0.8932552272242638,15,20,13,3,17,11,4
421,1,1,2.1890378690031933,0.899260779666197,7,8,3,1,7,6,1
422,0,0,4.023143527702575,0.01758196028226433,39,57,36,10,47,16,23
423,0,0,1.5794425430059018,0.17087444601573754,22,33,20,8,25,7,15
424,1,1,3.276046214916544,0.9635978504990419,9,11,6,2,9,7,2
425,1,1,1.4980781827898941,0.8172876690193212,5,6,3,0,6,5,0
426,1,1,3.552542220798264,0.972146346719788,19,30,20,5,25,14,5
427,1,0,0.5629111598674172,0.3628741414393406,20,28,13,6,22,7,13
428,1,1,2.315423541048505,0.9101463799280355,10,13,9,2,11,8,2
429,0,0,0.91149631875172,0.2866937417636606,3,2,0,0,2,0,3
430,0,0,2.3743181916232743,0.08515214371515745,25,35,22,7,28,11,14
431,0,0,4.606059016976889,0.009892280718452717,13,15,8,2,13,3,10
432,0,0,1.372574779351622,0.2022041705989729,20,26,17,4,22,7,13
433,0,0,2.5515978175204137,0.07231921586678314,12,11,4,1,10,2,10
434,1,1,2.585448602225453,0.9299191845979156,10,13,7,1,12,9,1
435,1,0,0.6641918362485142,0.33979860327061884,9,10,6,3,7,5,4
436,0,0,2.569597787346818,0.07112087075198759,23,34,19,6,28,8,15
437,1,1,3.451763132750833,0.9692836775504056,17,26,16,6,20,10,7
438,0,1,1.1098347223829237,0.7520982972988284,21,30,21,7,23,10,11
439,1,1,0.6273410299464217,0.6518863046020671,13,16,7,5,11,8,5
440,0,0,2.838660095416573,0.05527046007654868,13,18,11,3,15,2,11
441,1,1,2.4937730192317282,0.923704130907685,6,6,4,0,6,6,0
442,1,1,3.9141140593743264,0.9804323136250636,27,40,24,8,32,17,10
443,1,1,1.9696972263317776,0.8775785885851987,4,4,2,0,4,4,0
444,1,1,7.304440514849661,0.9993279063281206,14,24,18,0,24,14,0
445,0,0,4.501773144957783,0.010967691927307177,20,27,16,3,24,4,16
446,1,1,2.9866343292980817,0.9519666448764539,7,9,6,0,9,7,0
447,0,0,3.8261235963608913,0.02132908941280931,16,19,11,2,17,3,13
448,0,0,1.3418140927380504,0.2072118899637223,3,2,0,0,2,0,3
449,1,1,0.4475445726552303,0.6100552757490495,14,17,9,4,13,8,6
450,1,1,4.347996807201357,0.987232425793846,13,18,10,2,16,11,2
451,0,0,3.580841241741294,0.02709753050664987,13,16,8,4,12,4,9
452,0,0,2.236247271143969,0.09654236677639494,17,23,16,4,19,6,11
453,1,0,0.8616265638754932,0.2969996219072969,20,24,15,4,20,7,13
454,0,0,0.5976650758850808,0.3548780691107214,6,6,4,2,4,3,3
455,1,1,1.7147682202531167,0.8474537220137484,5,6,3,0,6,5,0
456,0,0,6.294649595441795,0.0018427540695769018,28,37,20,7,30,9,19
457,0,1,0.1603027399906498,0.5399900863191779,19,24,14,9,15,8,11
458,1,1,3.3792408497785025,0.9670494235796201,18,28,18,4,24,15,3
459,1,1,2.162199549416398,0.8968032883119437,14,20,12,3,17,11,3
460,0,0,6.944794571576939,0.0009627105660119373,19,24,12,3,21,2,17
461,1,0,0.4335691886554214,0.3932743651221845,20,29,16,8,21,7,13
462,0,0,2.350562638763947,0.08702106130503029,27,40,26,7,33,9,18
463,1,1,2.645004809574314,0.933702446371598,22,29,17,7,22,14,8
464,1,0,2.907652055315134,0.05177658838573973,20,27,16,4,23,4,16
465,1,1,0.9999644957460643,0.7310515980127351,3,2,0,0,2,3,0
466,0,0,1.0134952169219558,0.26629638852773685,11,13,6,1,12,2,9
467,0,0,0.801861564254877,0.30962745311836504,5,4,1,1,3,1,4
468,0,0,3.3107093205248574,0.03520561835056257,25,34,22,4,30,6,19
469,0,0,3.7027467552943234,0.024062433779801773,30,43,26,7,36,7,23
470,0,0,2.997206903452135,0.047552215575074275,27,40,25,8,32,9,18
471,1,1,1.4669419730058466,0.8125921359566051,4,3,2,0,3,4,0
472,0,0,2.453439443257615,0.07918739289460552,14,18,10,1,17,4,10
473,1,0,0.1754168836124852,0.4562578876288981,17,25,14,8,17,8,9
474,1,1,4.291569189437457,0.9865012724441269,16,25,17,3,22,13,3
475,0,0,4.326014809403977,0.013047635967888938,19,22,11,3,19,4,15
476,1,1,0.9909533128657109,0.7292761783620041,6,5,1,2,3,4,2
477,0,0,2.6206356122234946,0.06782209769490166,29,42,27,9,33,11,18
478,0,0,3.9437643863374197,0.01900688076570578,15,18,10,5,13,5,10
479,0,0,3.633475605662238,0.025743922420585874,18,24,12,3,21,2,16
480,1,1,4.404974225086727,0.9879310184748435,29,42,21,10,32,20,9
481,1,1,1.109950473371737,0.7521198780298395,42,70,43,19,51,19,23
482,0,0,0.4960955001184415,0.3784586785377594,18,26,16,6,20,9,9
483,1,0,0.8043158967143619,0.3091030644776852,9,11,6,1,10,1,8
484,0,0,2.75872926221575,0.05959554325307703,9,9,4,3,6,4,5
485,1,1,2.7880161932040215,0.9420247958989619,4,3,0,0,3,4,0
486,1,1,2.34977597166348,0.9129164189474984,6,7,3,1,6,5,1
487,1,1,0.11887154309801495,0.5296829412423847,13,17,10,4,13,6,7
488,1,1,5.527436988278963,0.9960395802870842,23,38,26,7,31,19,4
489,0,0,1.6525057417012219,0.1607705789418099,19,25,15,2,23,5,14
490,0,0,3.717363359127775,0.023721563108659804,9,9,3,1,8,1,8
491,1,1,1.75487060102063,0.852566074603615,10,13,7,2,11,8,2
492,0,0,1.9466290559462731,0.12492139075445996,13,15,9,2,13,3,10
493,0,1,3.8751524137409192,0.9796706823568958,14,19,11,3,16,10,4
494,1,1,1.22110510324643,0.7722579685974178,29,49,35,12,37,19,10
495,1,1,1.8417217459725606,0.8631522080642389,20,27,18,5,22,8,12
496,0,0,4.498929691216578,0.010998578940983106,30,43,26,5,38,6,24
497,1,1,3.742200315536188,0.9768468787586096,10,13,7,2,11,8,2
498,1,1,0.03667643436636725,0.5091680809026826,20,26,14,8,18,10,10
499,1,1,2.5728303712619587,0.9290923866020713,6,6,2,1,5,5,1
500,1,1,4.511768879490468,0.9891402074837657,18,26,19,2,24,16,2
501,1,1,3.9025807295673998,0.9802098187168732,16,22,13,3,19,13,3
502,0,0,6.2659357904372035,0.001896331739260848,33,48,28,6,42,6,27
503,1,1,2.325582056258485,0.9109736886853683,34,53,35,11,42,20,14
504,0,0,5.182176750327449,0.0055844082269024264,25,35,21,5,30,6,19
505,1,1,0.43824851100675577,0.6078416069373767,32,48,29,12,36,15,17
506,1,0,3.1957147023174883,0.03932730497621928,31,44,29,7,37,11,20
507,1,1,5.760660975808401,0.9968608557795864,13,19,11,0,19,13,0
508,1,1,4.81663294899079,0.9919709925388738,14,21,13,2,19,12,2
509,1,1,2.054733808300573,0.8864250705112036,26,38,23,9,29,12,14
510,1,1,2.8736197481280588,0.9465268534910988,20,29,19,5,24,15,5
511,1,1,1.7748977731232125,0.855065700163995,5,4,1,1,3,4,1
512,0,0,2.6882790389659323,0.0636685361683621,42,68,42,19,49,21,21
513,0,0,0.7901949370955756,0.31212681417533983,12,13,5,5,8,5,7
514,1,1,0.5094479495603796,0.6246770520445056,17,22,11,5,17,10,7
515,0,0,1.94771713474355,0.12480249482747274,31,48,30,5,43,8,23
516,0,0,0.6640117119677896,0.3398390127093984,6,5,1,2,3,2,4
517,0,0,4.481779493175539,0.011186705214645709,21,27,15,5,22,5,16
518,0,0,2.133652492794919,0.10586874662352774,16,20,10,5,15,5,11
519,0,0,4.309843764202707,0.013257525111373347,28,40,25,8,32,10,18
520,0,0,1.1623630490912085,0.23823817201572695,16,21,13,7,14,6,10
521,0,0,4.5265669224292076,0.01070197923140459,22,26,13,4,22,5,17
522,0,0,3.2734141982203124,0.036494585574384675,18,24,15,5,19,5,13
523,0,0,4.638515453982691,0.009579393243544287,14,18,12,2,16,3,11
524,0,0,1.6456952180322892,0.16169160225804258,9,10,5,0,10,0,9
525,0,0,4.53497254556241,0.010613350183295012,21,30,18,9,21,6,15
526,1,1,1.5605941964431251,0.8264385997683744,14,17,9,4,13,8,6
527,0,1,0.3012668872491675,0.5747521886830348,13,15,9,2,13,6,7
528,1,1,3.906463276604016,0.9802849941677284,16,21,10,4,17,12,4
529,1,1,5.560488341937102,0.9961678445709786,18,26,15,3,23,14,4
530,0,0,2.16063205819961,0.10334186878933871,10,12,7,1,11,1,9
531,1,1,1.9397415670346334,0.8743237491700779,13,17,8,5,12,8,5
532,0,1,5.073421714530729,0.9937779954944472,19,25,15,5,20,11,8
533,0,0,4.244389143038392,0.014141638792095623,17,21,10,4,17,5,12
534,0,0,5.37953985307823,0.004588788640301877,29,42,26,5,37,7,22
535,0,1,1.112801450341759,0.7526510194002528,4,3,1,0,3,4,0
536,1,0,3.9562450185237816,0.01877556327419927,14,16,9,0,16,0,14
537,0,0,4.0533201703352235,0.017068241688286023,7,6,1,1,5,1,6
538,0,0,2.360872560791462,0.08620543451971174,12,15,9,3,12,4,8
539,1,1,3.2026059556572424,0.9609322262406637,14,19,11,3,16,11,3
540,1,1,1.1021465233916032,0.7506620833320163,14,18,10,5,13,8,6
541,0,0,1.5931557430396812,0.16894036912069343,14,16,7,4,12,5,9
542,0,0,1.6352375598415079,0.16311413074749426,19,25,12,5,20,6,13
543,1,1,3.8723253459665603,0.9796143019542055,20,29,18,5,24,13,7
544,0,0,1.4625153535219169,0.18808290988755072,34,51,34,6,45,15,19
545,0,1,0.08909463756263292,0.5222589373212003,5,4,2,1,3,3,2
546,0,0,4.5718321876178205,0.010233198335723448,23,34,22,2,32,3,20
547,1,1,1.7732064168515755,0.8548559672708742,12,16,11,2,14,9,3
548,0,0,7.976332936346193,0.00034337879068990773,33,50,31,13,37,9,24
549,0,0,5.028773175970368,0.006504255161903227,18,23,16,2,21,3,15
550,0,0,7.614402630185387,0.0004930520537334004,21,27,15,5,22,7,14
551,0,0,5.7515476798673335,0.003167791885718474,27,36,22,4,32,5,22
552,0,0,2.156558182523302,0.10371997406013966,7,8,4,0,8,0,7
553,0,0,6.004694732209113,0.0024610705613040684,25,33,20,4,29,5,20
554,0,0,1.9769010463261814,0.12164957600447535,15,17,8,4,13,5,10
555,0,0,1.0134332363754666,0.26630849862483374,24,33,18,5,28,8,16
556,0,0,2.876163765985237,0.05334453035022224,20,29,18,5,24,5,15
557,1,1,1.332350707246162,0.7912292034918189,16,21,12,4,17,9,7
558,1,1,3.3250647809650205,0.9652787417109898,13,18,9,2,16,11,2
559,1,1,1.116470259127648,0.7533333989396342,23,32,19,8,24,12,11
560,1,1,3.981592818842346,0.9816857682887254,17,25,17,1,24,13,4
561,1,1,3.138632869918695,0.9584584813963807,7,7,2,0,7,7,0
562,1,1,0.42873961679391415,0.6055726604330272,15,19,9,5,14,7,8
563,1,1,7.326867325831163,0.9993428016879448,22,34,26,2,32,20,2
564,0,0,0.4846836397251333,0.381146763527931,24,36,23,6,30,9,15
565,1,1,1.6224188769900594,0.8351284524109696,42,66,41,16,50,20,22
566,1,1,0.5636480603019702,0.6372962101397632,10,13,8,2,11,5,5
567,1,1,3.3911510312443576,0.9674268356876146,13,15,6,4,11,8,5
568,1,1,2.8297079107379863,0.9442602305765129,8,10,5,1,9,7,1
569,1,1,0.2790789341912394,0.5693203979354031,12,15,8,4,11,5,7
570,0,0,7.3260637320686826,0.0006577262972753406,27,39,24,5,34,5,22
571,1,1,2.2750695273542236,0.9067911536029261,6,7,4,0,7,6,0
572,0,0,3.737453968181254,0.023260712945121886,31,42,26,8,34,12,19
573,1,1,2.34100062570528,0.9122162460998557,10,12,7,3,9,7,3
574,0,0,1.5734232845137974,0.1717289229245461,16,19,11,3,16,4,12
575,1,1,3.0545852259979682,0.9549800715244429,9,11,6,1,10,7,2
576,0,0,2.6492060325838094,0.06603796211030677,14,17,11,2,15,3,11
577,1,0,0.26999757794472434,0.4329076896456814,11,13,7,3,10,4,7
578,0,0,0.338664530341247,0.4161339150409802,6,6,3,1,5,1,5
579,1,1,3.0842658232867826,0.9562390398060651,25,38,29,5,33,17,8
580,0,0,0.20234406473604216,0.44958587585047805,9,10,3,3,7,2,7
581,0,0,4.918813550761529,0.0072547795849281504,21,30,19,5,25,5,16
582,1,1,1.1422769312575718,0.7580974410104001,26,39,25,8,31,11,15
583,1,1,2.190060778049074,0.8993534080073116,8,8,3,2,6,6,2
584,1,1,0.3942773278012441,0.5973119534366056,7,8,5,1,7,6,1
585,1,1,2.420451284106175,0.9183735807835547,16,24,17,3,21,14,2
586,0,0,0.367760311639296,0.40908231988903554,7,7,3,3,4,3,4
587,1,1,2.541644095275669,0.9270101480280717,14,18,8,3,15,10,4
588,1,1,1.0229403299064161,0.7355449442445188,6,6,3,4,2,4,2
589,1,1,1.3799790226448347,0.7989876311731823,4,4,2,0,4,4,0
590,1,1,0.6186836074304347,0.6499190964634541,7,7,3,2,5,4,3
591,0,1,0.47661124885621176,0.6169473518765164,10,11,6,3,8,4,6
592,1,1,4.163308342089656,0.9846822745625153,6,7,5,0,7,6,0
593,0,0,0.9705606647521234,0.274768763938566,18,23,11,6,17,6,12
594,1,1,1.627989242154605,0.835893998884255,5,6,3,0,6,5,0
595,1,1,1.2089615171977421,0.7701151499039413,14,17,9,4,13,10,4
596,1,1,2.437977681148948,0.919677824808987,11,14,8,2,12,8,3
597,0,0,6.147464865245953,0.0021343321781395197,25,37,23,6,31,5,20
598,0,0,3.2200783145905185,0.03841709236051494,19,25,13,5,20,6,13
599,1,1,2.211950342634295,0.9013175343873063,17,22,14,5,17,9,8
600,0,0,1.4355457160022367,0.19223606782066904,12,14,8,2,12,3,9
601,0,0,7.897696622148,0.0003714604530313803,23,28,15,4,24,5,18
602,0,0,0.6041838857427368,0.3533870710227025,26,38,23,7,31,9,17
603,0,0,1.3067328653835322,0.2130340675101291,13,14,6,2,12,3,10
604,1,0,0.18117113174010174,0.4548306987821952,8,8,4,2,6,2,6
605,0,0,4.753657953265815,0.008546434352492027,17,21,12,3,18,4,13
606,0,0,3.199632306252709,0.03917956210776685,32,50,31,10,40,10,22
607,1,0,3.233107656166071,0.03793865673338781,15,19,10,4,15,4,11
608,1,1,0.09927050530388293,0.5247972656733355,14,19,10,6,13,8,6
609,0,0,4.54054065398899,0.010555040151304929,16,21,12,1,20,1,15
610,1,1,3.053740313001682,0.9549437320989512,9,10,3,2,8,7,2
611,1,1,2.3913610440580033,0.9161661633061386,16,22,14,3,19,12,4
612,1,0,0.39732464081311847,0.4019552930530871,4,3,1,1,2,1,3
613,0,0,2.8923029555141495,0.05253536969590478,24,37,23,7,30,9,15
614,0,1,0.6811906948889959,0.6640043963339473,13,15,6,4,11,7,6
615,0,0,5.865838016017315,0.0028266340620825003,19,25,15,2,23,2,17
616,0,0,2.5537256431314472,0.07217659170791646,16,19,10,3,16,4,12
617,1,1,1.9158443585685805,0.8716743086060348,6,5,2,1,4,4,2
618,0,0,1.8179290618389135,0.13968255471868052,13,15,9,3,12,4,9
619,1,1,1.5753237769412216,0.8285412308833324,22,30,15,7,23,13,9
620,0,0,6.538237165197381,0.0014449462484884545,11,11,5,0,11,0,11
621,0,1,1.379217928241304,0.798865366727379,14,20,15,4,16,12,2
622,0,0,0.6422457408750004,0.3447390631798609,29,42,26,10,32,12,17
623,1,0,0.5443395739148373,0.3671786654641679,22,33,19,7,26,9,13
624,1,1,2.0143058857493537,0.8822909407119168,21,31,16,7,24,12,9
625,0,0,2.9162497970914045,0.05135609864019919,6,7,3,0,7,0,6
626,0,0,1.0867278623671623,0.25223494388274204,15,18,8,6,12,6,9
627,0,0,4.6740849645196825,0.009247743218692595,23,31,20,4,27,4,19
628,1,1,0.6178594006329285,0.6497315462541424,14,17,12,3,14,8,6
629,0,1,3.3337152110864556,0.9655675028428844,11,14,6,1,13,9,2
630,1,1,2.2896864859365134,0.9080192686370888,11,15,10,2,13,9,2
631,1,1,2.573781739972601,0.9291550369297625,8,10,6,1,9,7,1
632,1,1,2.5422416760857645,0.9270505714239612,14,18,11,3,15,10,4
633,1,1,0.08882938660808093,0.5221927556135151,19,25,14,5,20,11,8
634,1,0,0.3493932881975148,0.4135295548419483,29,44,24,13,31,12,17
635,1,1,3.3645418829994753,0.9665778142400793,15,21,16,1,20,13,2
636,0,0,8.833984551039135,0.00014567532164522223,22,32,18,2,30,3,19
637,0,0,4.841371834916454,0.007834352588559912,22,30,18,2,28,2,20
638,0,0,3.631883346136327,0.02578388832838563,15,18,13,2,16,3,12
639,0,0,5.811521772991964,0.002983941577556104,20,25,13,2,23,2,18
640,0,0,0.8399444029892884,0.30154649349970986,12,13,6,3,10,4,8
641,1,1,2.89540566511923,0.9476188546885468,13,17,11,3,14,9,4
642,0,0,1.3790241867632782,0.20116576535753206,12,14,8,2,12,3,9
643,0,0,3.0285690875545357,0.04615177747393506,24,33,19,5,28,6,18
644,1,1,3.284877485248969,0.9639063601676384,12,16,9,2,14,9,3
645,0,1,0.2309156347604049,0.5574737506065948,11,13,8,4,9,7,4
646,0,0,1.4515202587665652,0.18976770697270295,19,27,16,6,21,8,11
647,1,0,1.0558630768458004,0.2581008194822523,49,81,50,22,59,25,24
648,0,0,3.6858343147011325,0.02446280913072907,19,26,14,6,20,5,14
649,1,1,3.040063238627111,0.9543515842626049,11,15,9,2,13,9,2
650,1,1,3.443496324902255,0.9690365941382951,13,17,7,3,14,10,3
651,1,1,0.8209018554811307,0.6944277454528951,15,21,12,5,16,10,5
652,0,1,0.45354541370037804,0.6114818564117837,4,3,1,1,2,2,2
653,1,0,1.802434924972391,0.1415549214927997,15,17,8,3,14,4,11
654,1,1,4.405337997149714,0.987935355076222,12,16,11,1,15,11,1
655,0,0,0.9247925215916963,0.2839823922045993,4,4,2,0,4,0,4
656,1,1,4.55519121896056,0.9895968729153862,25,38,22,7,31,19,6
657,1,1,2.084553460303849,0.8893927669497382,9,11,5,1,10,8,1
658,1,1,4.070373148169173,0.9832155110020506,16,25,14,1,24,15,1
659,1,1,3.619617451857935,0.9739062049547886,11,13,7,2,11,9,2
660,1,1,3.6405123256486203,0.9744319790245021,9,12,9,0,12,9,0
661,1,1,1.7598313260643867,0.8531885337210968,8,10,6,2,8,6,2
662,0,0,1.1192595386906934,0.24614865735026115,7,6,1,2,4,2,5
663,1,1,4.252772931041072,0.985974770215205,9,11,7,0,11,9,0
664,1,1,3.922141080517891,0.9805857179380097,23,34,19,5,29,17,6
665,0,0,1.9548778151938202,0.12402245542720303,7,7,4,0,7,0,7
666,0,1,0.7222494512662105,0.6731021691105662,14,18,9,6,12,7,7
667,0,1,0.2261036469490021,0.5562863226585508,27,38,22,9,29,13,14
668,0,1,0.610096078841319,0.6479627186517141,10,12,7,5,7,6,4
669,1,1,3.2459806888330185,0.9625284154849975,7,9,4,1,8,6,1
670,0,0,3.0614841349075963,0.04472425201831809,24,33,21,4,29,6,18
671,1,1,1.370200736652393,0.7974125836589725,8,10,5,1,9,7,1
672,1,0,3.0634627197447952,0.04463979507949656,19,25,13,7,18,7,12
673,1,1,0.38362026480555467,0.5947459691917973,8,9,4,3,6,4,4
674,1,1,6.772065802659666,0.9988559840839172,14,22,10,1,21,13,1
675,1,1,2.374824889852923,0.9148873204171035,12,16,9,2,14,9,3
676,0,0,4.69344040447397,0.009072078447560417,32,49,33,10,39,14,18
677,0,0,2.3175218869758245,0.0896821650752242,15,18,12,4,14,4,11
678,0,0,2.020529592424555,0.11706424099250101,14,18,11,3,15,6,8
679,0,0,2.0539234062205924,0.11365654281055415,9,8,2,2,6,2,7
680,1,1,7.679510923977996,0.9995380126360854,21,34,20,6,28,17,4
681,1,1,1.658922651371674,0.8400933288049829,22,33,21,5,28,14,8
682,1,1,4.6630060591240605,0.990650195522505,16,24,13,2,22,13,3
683,1,1,1.0260952798410916,0.7361581843960292,14,19,13,3,16,9,5
684,1,1,3.3748725157643236,0.9669099429825516,18,27,18,4,23,13,5
685,1,1,1.1073239681811258,0.7516298798528847,13,17,12,2,15,7,6
686,1,1,2.4377238985974907,0.9196590757622878,28,43,27,8,35,15,13
687,1,1,2.412343636582843,0.9177637375048169,7,9,4,0,9,7,0
688,1,1,0.7728497860780006,0.6841370370361117,9,10,5,2,8,5,4
689,1,1,1.390973790744569,0.8007476577920503,13,17,11,4,13,9,4
690,0,0,3.1450029210632158,0.04128862918293952,12,13,6,3,10,2,10
691,0,0,3.379727733730051,0.03293506547062375,25,37,21,6,31,5,20
692,1,1,3.4937103738388195,0.9705082795868045,13,16,9,4,12,9,4
693,1,1,1.640601920146682,0.8376168241542696,9,10,4,3,7,5,4
694,0,0,0.24541402753235708,0.4389525832088822,20,26,12,7,19,7,13
695,1,0,0.17697645869139755,0.45587100437832107,9,9,6,1,8,2,7
696,1,1,0.4111135909658252,0.601354866989251,8,8,3,3,5,4,4
697,0,1,1.1774784356445995,0.7644941169220241,10,12,6,3,9,5,5
698,1,1,4.093469649505034,0.9835924437032199,7,10,5,0,10,7,0
699,0,0,4.76319416730356,0.00846600780208695,12,13,7,1,12,1,11
700,0,0,4.907498564381815,0.007336727808981314,13,13,7,1,12,2,11
701,0,0,0.18401425340192956,0.4541258100884613,23,31,17,11,20,11,12
702,1,1,2.6505264655462684,0.9340434315152416,11,13,7,3,10,7,4
703,1,1,3.1255620708087095,0.9579349268969617,7,9,5,0,9,7,0
704,1,0,1.223298254074579,0.227356540020498,6,5,2,1,4,2,4
705,0,0,0.3626607177362733,0.41031563414140226,8,8,3,1,7,1,7
706,0,1,1.7541379544438107,0.8524739592175322,27,39,23,9,30,12,15
707,0,0,1.0683193431917228,0.2557228299921851,10,9,2,2,7,3,7
708,0,0,5.647603585780857,0.0035135676244627545,27,38,23,7,31,6,21
709,0,1,1.100442596384108,0.7503430256403685,20,26,14,8,18,9,11
710,0,0,5.6951106399810705,0.003351097532977576,17,23,14,0,23,0,17
711,0,0,3.9057526985169218,0.01972874338265118,35,56,35,10,46,11,24
712,1,1,3.011592675696903,0.9530951060124311,16,24,16,2,22,14,2
713,0,0,0.8369975785258927,0.3021675052102283,2,1,0,0,1,0,2
714,1,1,1.7144502076792967,0.8474126061057982,11,14,8,3,11,7,4
715,0,0,2.7738308673918857,0.058754797804104086,12,13,7,1,12,2,10
716,0,1,0.189840799097591,0.5473181746670592,10,11,5,4,7,4,6
717,0,0,2.093946287805459,0.10968660383482709,17,19,12,4,15,7,10
718,1,0,0.644346245826281,0.34426472649533213,35,56,37,14,42,18,17
719,0,0,4.804309910482949,0.00812775222323725,30,44,25,9,35,9,21
720,1,1,3.514013753212314,0.9710838836100479,19,28,17,6,22,13,6
721,1,1,0.6120304295478052,0.6484038312646987,18,23,11,6,17,8,10
722,0,0,3.2522645752384394,0.03724559823018336,13,16,9,2,14,3,10
723,1,1,1.8331462395964417,0.8621361070590918,7,8,4,1,7,6,1
724,1,1,2.7544297987024393,0.940163041232397,31,48,29,10,38,18,13
725,1,1,3.729960358117463,0.9765684252366597,25,37,23,8,29,15,10
726,0,0,0.24693828745926094,0.4385772338191176,15,18,10,2,16,6,9
727,1,1,3.577126097241389,0.9728043539274781,12,17,13,1,16,11,1
728,1,1,5.9584294400441875,0.9974226926153831,37,58,37,14,44,22,15
729,0,0,1.4147033258393025,0.19549327813462203,6,7,5,0,7,0,6
730,0,0,2.7277980960481,0.06135284513931438,13,18,11,0,18,0,13
731,0,0,2.1901057485720985,0.10064252147545705,3,2,0,1,1,1,2
732,1,1,1.7939572212117985,0.8574117584587128,8,9,6,1,8,6,2
733,1,0,3.0666083919581792,0.044505833332224576,10,11,6,4,7,4,6
734,0,0,2.611438333717808,0.06840588679991755,13,15,8,3,12,4,9
735,1,1,3.5839220294517653,0.9729835708616386,33,51,32,12,39,20,13
736,0,0,4.95295163886715,0.007013002534106416,19,22,12,2,20,3,16
737,0,0,5.920573998998661,0.002676476565736996,18,22,12,2,20,3,15
738,1,1,1.5759777922438727,0.8286341207659695,8,9,4,1,8,7,1
739,0,0,2.220845176129658,0.09789414068155633,4,4,2,0,4,0,4
740,0,0,1.564207788290556,0.17304368568793782,9,9,4,2,7,4,5
741,1,1,1.5206175996473197,0.8206294072765248,7,8,3,1,7,6,1
742,0,0,0.2597033974641521,0.4354366210672628,1,0,0,0,0,0,1
743,1,1,0.8939234105101168,0.7096991627119997,3,2,1,0,2,3,0
744,0,0,0.5673576494643909,0.36184675673073363,9,10,6,3,7,4,5
745,0,0,0.16875657876706673,0.45791069560913245,8,8,4,2,6,2,6
746,0,0,4.377138735124701,0.012405420739908801,27,39,24,8,31,7,20
747,0,1,0.6192778906267913,0.650054298260917,13,15,7,5,10,7,6
748,0,0,5.390435406430577,0.004539288357604532,12,13,7,2,11,3,9
749,0,0,1.8212043076642126,0.13928942833449054,13,14,5,2,12,3,10
750,0,0,0.9703953302065746,0.2748017115274991,12,13,7,1,12,4,8
751,0,0,0.8568134012404376,0.29800554712941607,6,7,4,2,5,1,5
752,0,0,0.8640459793667263,0.29649471832463836,17,22,10,5,17,6,11
753,0,0,2.3386575517780384,0.08797156333727973,16,18,10,5,13,5,11
754,0,1,1.6278775059515156,0.8358786708705774,23,32,18,9,23,11,12
755,1,1,6.418550241337024,0.9983716367858572,12,18,9,0,18,12,0
756,0,0,2.6262991694229125,0.06746491003504695,10,11,8,2,9,3,7
757,1,1,3.3014814724154284,0.9644795989883582,12,16,8,2,14,10,2
758,1,1,0.35683666718638285,0.5882744652794852,4,3,1,1,2,3,1
759,0,0,1.364580396558833,0.20349687624792023,16,23,13,7,16,7,9
760,0,0,4.336561925943628,0.012912511822940509,19,25,12,3,22,4,15
761,0,1,1.3736036750690053,0.7979617575788948,21,29,17,8,21,11,10
762,1,0,0.2457013946005091,0.43888181363972467,7,6,2,2,4,3,4
763,0,0,2.1799289654247245,0.10156740972366818,10,11,5,4,7,4,6
764,0,0,2.7872150125932054,0.05801897534173994,23,33,18,5,28,5,18
765,1,1,1.4058889010941527,0.8031167055525074,26,39,26,6,33,17,9
766,0,0,1.3314736886353353,0.2089157043127885,18,25,15,5,20,5,13
767,0,0,5.405225829583047,0.004472942517366962,26,34,19,4,30,4,22
768,0,0,4.743915927625315,0.008629378824194678,19,23,15,3,20,4,15
769,0,0,7.628283416634952,0.00048625868909546455,24,34,20,4,30,2,22
770,1,0,5.41693562857702,0.004421100944293377,15,16,9,1,15,2,13
771,0,0,4.355126475602102,0.01267801932541368,34,47,27,9,38,9,25
772,0,0,3.985341947832026,0.018246948379576966,14,18,10,2,16,3,11
773,1,1,4.607213233852633,0.9901190177777326,13,20,12,1,19,12,1
774,1,1,3.8610171092012795,0.9793872460546272,12,16,9,1,15,11,1
775,1,0,0.14257685590742852,0.4644160453033377,16,19,9,5,14,7,9
776,1,1,2.3513068462078843,0.9130380466137524,8,11,7,0,11,8,0
777,1,1,2.900722427247971,0.9478821375267461,12,16,9,2,14,10,2
778,1,0,1.6159313579225332,0.16576675025251075,14,17,10,1,16,2,12
779,1,1,1.5193962637557075,0.8204495601569923,7,6,1,2,4,5,2
780,1,1,5.888373669285284,0.9972361794969425,21,30,18,5,25,14,7
781,0,0,3.41084644257625,0.031958200825231264,14,18,11,1,17,1,13
782,0,1,0.6604450589034263,0.6593603576729874,5,5,2,1,4,4,1
783,0,0,0.9245280505647464,0.28403617186144436,11,13,7,2,11,3,8
784,1,1,3.5355518453051378,0.9716825750732001,8,11,7,0,11,8,0
785,1,1,0.7246179103200183,0.6736231006941712,19,26,13,9,17,9,10
786,1,1,1.169057370447953,0.7629745887428071,5,4,1,2,2,3,2
787,1,1,5.573444840569762,0.9962169889987313,9,13,6,0,13,9,0
788,0,0,4.575028423154258,0.010200875953356503,25,36,21,7,29,6,19
789,1,1,1.4112767722767294,0.8039672460389755,17,24,14,4,20,11,6
790,0,1,0.2056269163398301,0.5512263582517398,18,24,15,6,18,11,7
791,0,0,2.3741255684995766,0.08516715049758927,19,25,13,4,21,5,14
792,1,1,0.6837470766321003,0.6645744923123353,3,2,1,0,2,3,0
793,0,1,1.0157210522311881,0.7341382747260006,15,19,13,5,14,7,8
794,1,0,3.368719278978458,0.033287497099250385,26,35,19,10,25,9,17
795,1,1,2.0079547067220744,0.8816297445123161,11,14,8,5,9,5,6
796,1,1,4.745562771997838,0.9913846983909346,16,23,14,3,20,13,3
797,0,0,9.81767187821276,5.447730543794993e-05,32,44,24,9,35,9,23
798,0,1,1.6005035001498524,0.8320887444605597,17,23,12,7,16,11,6
799,1,1,2.0945957566857536,0.8903768042667861,7,9,6,0,9,7,0
800,0,1,0.10886099586100728,0.5271884040947493,6,5,1,2,3,3,3
801,1,1,1.5341914051825811,0.8226187393489061,28,41,27,10,31,13,15
802,0,0,5.360773675844715,0.004675309343807332,25,34,23,6,28,6,19
803,0,0,1.4069357474405477,0.19671781935118315,9,10,6,1,9,2,7
804,0,0,1.3095341018728293,0.21256481618092082,12,15,8,1,14,1,11
805,0,1,0.09785206341050667,0.5244435150228013,19,25,15,6,19,11,8
806,0,0,0.8741779312665356,0.2943857056822897,15,20,12,4,16,4,11
807,1,1,5.633354482759027,0.9964361884963773,16,23,13,2,21,14,2
808,1,0,0.12149083140698913,0.4696645955759128,10,11,4,3,8,3,7
809,0,1,1.8557571536194244,0.8648016428366807,29,44,31,9,35,17,12
810,1,1,1.8339231515552539,0.8622284228480994,28,45,29,10,35,17,11
811,1,1,0.9782948789590371,0.7267697520686787,28,42,27,11,31,12,16
812,1,1,3.356353056476692,0.966312259900026,13,18,9,2,16,11,2
813,0,0,3.7485940470905748,0.02300895390114266,34,50,34,10,40,15,19
814,1,1,4.905406293393897,0.9926480186726164,15,21,11,3,18,11,4
815,0,1,2.2368127627233223,0.9035069452432435,7,8,3,1,7,6,1
816,0,0,11.946098139431342,6.484443068166534e-06,23,30,19,2,28,3,20
817,0,1,3.1902898335334675,0.9604672268777139,13,17,10,2,15,11,2
818,1,1,1.688052335339018,0.8439678512701403,3,2,1,0,2,3,0
819,1,1,1.8488965322397128,0.8639974911727748,8,9,4,2,7,5,3
820,0,0,1.4680173224595772,0.1872441582529376,12,14,7,3,11,3,9
821,1,1,2.8393498287629377,0.9447655437436109,18,26,15,3,23,14,4
822,1,0,1.167108977632954,0.23737794764019826,24,33,18,7,26,10,14
823,0,0,1.613623087844608,0.16608620293221388,14,17,10,3,14,2,12
824,1,1,0.4877591664549381,0.6195784073336552,11,13,7,5,8,6,5
825,0,0,1.4774893695729203,0.18580693471748322,18,24,14,3,21,4,14
826,0,0,4.070485351779979,0.016782637427966596,21,28,16,5,23,4,17
827,1,0,2.6080779947120973,0.06862034033635622,20,28,17,8,20,8,12
828,0,0,4.264276842999447,0.013867033833629416,28,41,22,10,31,11,17
829,0,1,0.33811625234453224,0.5837328656618667,22,35,21,9,26,13,9
830,0,0,3.1809730433721155,0.03988805262655737,10,10,6,1,9,2,8
831,0,0,6.88397849005978,0.0010230140809102117,21,27,15,5,22,4,17
832,1,0,2.872405311984707,0.05353464704231037,39,59,41,11,48,14,25
833,1,1,3.251618002103896,0.9627312097768945,11,14,9,1,13,10,1
834,0,0,2.455262776158072,0.07905454335567619,13,14,8,2,12,3,10
835,1,1,3.9019964951520922,0.9801984822478543,10,13,8,1,12,8,2
836,1,1,0.7644481806385977,0.6823187019241328,12,16,9,2,14,9,3
837,0,0,5.665009033798797,0.003453150899360935,26,36,20,5,31,6,20
838,0,0,2.7951801691602816,0.057585186864493876,12,13,8,5,8,5,7
839,0,0,2.3993301401285274,0.08322379092225185,12,14,8,3,11,3,9
840,1,1,0.6430630663658539,0.6554455423420057,17,19,8,8,11,6,11
841,1,0,1.2618771829671314,0.22065091489099076,16,21,13,4,17,4,12
842,0,0,0.7875195387969675,0.31270152052326017,5,4,1,1,3,1,4
843,0,0,0.401950971457374,0.4008436884115901,4,3,1,1,2,1,3
844,1,0,0.5964565190567943,0.3551548041603432,22,32,18,5,27,8,14
845,1,1,5.303937337665972,0.9950526193157654,23,35,22,4,31,17,6
846,0,0,5.034970800435232,0.006464328666604291,21,29,17,4,25,4,17
847,1,1,4.515518327511107,0.9891804097415461,15,20,11,3,17,12,3
848,1,1,1.2558008531477547,0.7783024011504129,9,11,7,1,10,7,2
849,1,1,1.0455987406682268,0.7399288413725102,34,51,34,12,39,18,16
850,1,1,1.119105491117334,0.7538227565418831,7,7,3,2,5,5,2
851,0,0,4.103757262701868,0.016242354548564264,23,30,15,6,24,6,17
852,1,1,1.516551895978768,0.8200301684423099,15,20,13,3,17,8,7
853,0,0,0.03794453308525281,0.49051500473291954,15,21,12,7,14,8,7
854,0,0,4.440908040053165,0.011647958303507067,18,24,14,5,19,8,10
855,0,0,2.3057089428491717,0.09065125121254725,15,20,12,4,16,4,11
856,0,0,2.396679468967914,0.0834262542979628,31,46,31,7,39,10,21
857,1,1,1.297196870687934,0.7853628429847828,11,13,4,4,9,7,4
858,0,0,2.437064538988487,0.08038965533573617,9,10,5,0,10,0,9
859,1,1,1.251079039992048,0.7774865922713149,15,18,10,4,14,9,6
860,0,0,0.9295178320367574,0.2830225461714012,28,40,24,9,31,12,16
861,0,0,6.642786635167721,0.0013016934913780975,22,27,15,3,24,3,19
862,1,0,0.2440836035956444,0.43928025755133127,42,67,40,18,49,18,24
863,1,0,0.9663681290077615,0.27560500269596666,17,22,15,4,18,6,11
864,0,0,4.976336841185855,0.006852015478748474,18,21,13,1,20,2,16
865,1,0,0.861055045884147,0.2971189634750624,25,37,19,7,30,8,17
866,0,0,2.05998459099342,0.1130473750879929,7,6,1,1,5,1,6
867,0,0,5.276097173214347,0.00508634137324615,20,23,13,5,18,5,15
868,0,0,2.7369748668473237,0.06082648954856407,30,43,28,9,34,11,19
869,0,0,5.1855264995916714,0.005565837097824877,26,39,24,8,31,8,18
870,1,1,0.6656220919366784,0.6605221803166783,13,14,5,5,9,6,7
871,1,1,2.5620477487357616,0.9283787354437661,21,31,22,4,27,15,6
872,1,1,3.276737698035942,0.9636220979012907,22,31,19,4,27,15,7
873,0,0,3.2527038778142474,0.03722984876062119,5,4,2,0,4,0,5
874,0,0,0.17166931442799682,0.45718776077224854,21,27,17,6,21,8,13
875,0,0,4.855301964997441,0.0077268130513010735,39,62,39,14,48,17,22
876,1,1,0.095478535938188,0.5238515172345755,18,21,11,7,14,7,11
877,1,1,3.271372487970954,0.9634335543383674,17,24,15,2,22,14,3
878,0,0,1.9707978983605616,0.12230321050047332,3,2,1,0,2,0,3
879,1,0,1.0516626226380414,0.25890595946728256,8,9,4,1,8,2,6
880,1,0,0.06799607843558819,0.48300752689776394,16,21,11,5,16,8,8
881,1,1,2.767207454977243,0.9408778374963547,11,13,6,3,10,8,3
882,0,0,3.254263553639691,0.03717398440497466,14,16,8,3,13,4,10
883,1,0,0.41994608784971854,0.3965296509112959,17,23,15,3,20,4,13
884,0,1,0.05275682154054717,0.5131861471295968,12,13,6,3,10,6,6
885,1,1,3.621410993163013,0.9739517453364106,15,20,11,2,18,11,4
886,1,1,1.6504114563012346,0.8389466521637947,20,29,16,8,21,11,9
887,0,1,3.599418577741356,0.9733879494932491,47,79,55,14,65,28,19
888,0,0,0.7906509552225187,0.3120289138008727,23,28,13,8,20,8,15
889,0,1,0.5076370239561256,0.6242523745682103,12,14,8,3,11,6,6
890,1,1,3.4153497617253494,0.9681808245284083,6,8,4,0,8,6,0
891,0,0,1.657026069172059,0.16016161582889654,5,4,2,0,4,0,5
892,1,1,2.1997228132115367,0.9002246166538027,5,6,3,0,6,5,0
893,1,1,5.104993641193592,0.9939702015436639,23,33,21,7,26,13,10
894,1,1,1.4627589116697204,0.8119542804985188,19,29,20,6,23,13,6
895,1,0,0.83577452185874,0.30242546414067073,15,18,9,4,14,5,10
896,0,0,6.445160526669369,0.0015856712552251295,33,45,25,8,37,8,25
897,1,1,1.688052335339018,0.8439678512701403,3,2,1,0,2,3,0
898,0,0,7.029532863775904,0.0008845621179754959,17,21,14,2,19,3,14
899,0,0,6.376609016565649,0.001697992764055578,18,25,14,2,23,1,17
900,0,0,4.05580441721711,0.017026613648475353,14,16,8,2,14,2,12
901,1,1,4.48765133918028,0.9888780604999324,18,28,23,1,27,17,1
902,1,1,5.359314930174277,0.9953178975477727,17,25,16,2,23,15,2
903,1,1,4.6471060385286105,0.9905017685970149,14,20,13,2,18,12,2
904,1,1,1.5466422923543122,0.8244282453456722,17,24,12,5,19,11,6
905,0,0,0.1625956352558613,0.4594404091478187,13,19,11,6,13,6,7
906,1,1,1.477994731335278,0.814269505644446,5,5,4,0,5,5,0
907,0,0,1.7439375382036904,0.14881348431918195,16,20,13,5,15,6,10
908,1,1,1.6420984408653172,0.8378202704109972,14,20,12,4,16,8,6
909,1,1,4.170086149804767,0.9847841697405332,9,11,4,2,9,7,2
910,1,1,7.0173711128903005,0.9991046240660187,13,19,12,0,19,13,0
911,0,0,5.351786371852315,0.004717318045585506,17,21,12,2,19,3,14
912,0,0,1.3635764393024277,0.20365965200182046,13,17,11,4,13,4,9
913,1,1,5.136746201510407,0.9941575542738832,14,22,13,0,22,14,0
914,0,0,1.0432037767381095,0.26053229623714325,4,3,1,0,3,0,4
915,1,1,3.586037385556527,0.973039120658207,11,14,10,1,13,10,1
916,0,0,1.3399499263020704,0.20751829328154536,24,31,18,6,25,9,15
917,1,1,3.5763162339116192,0.9727829199424273,22,32,21,5,27,16,6
918,1,1,4.0197760004378615,0.9823597783813464,24,33,21,7,26,13,11
919,1,1,0.3570892474095897,0.5883356407695814,16,20,11,5,15,9,7
920,1,1,2.9306117763776065,0.9493391061563334,5,5,2,0,5,5,0
921,0,1,1.830077413340404,0.8617709487007252,14,18,10,4,14,10,4
922,0,1,0.839279145339501,0.698313373962731,12,13,8,3,10,4,8
923,1,1,2.3148579798964866,0.91010011763708,5,5,2,0,5,5,0
924,0,0,5.5167995365908125,0.004002603829458828,21,27,15,3,24,3,18
925,1,1,3.3748946514366245,0.9669106512083945,17,23,10,7,16,11,6
926,0,0,0.2597033974641521,0.4354366210672628,1,0,0,0,0,0,1
927,0,0,0.8381774866016047,0.3019187651656625,19,27,17,6,21,6,13
928,1,1,3.2643909166549383,0.9631868008163981,14,19,11,2,17,11,3
929,0,0,6.269850907453641,0.0018889358899957243,21,29,17,5,24,4,17
930,0,0,0.5398457227771707,0.3682234718076858,20,29,16,6,23,6,14
931,1,0,0.293248064185337,0.42720887378478645,12,12,7,4,8,5,7
932,0,1,0.5885833820573929,0.6430400417855464,6,5,2,2,3,3,3
933,0,0,3.2656767506278657,0.03676763324310062,14,17,8,3,14,3,11
934,1,1,4.364019677396288,0.9874328183504744,11,16,9,1,15,10,1
935,1,1,0.08568459791074079,0.521408053186608,18,23,14,6,17,8,10
936,0,0,4.042195263856561,0.017255889534827706,19,27,18,3,24,3,16
937,1,1,0.4994113153198534,0.6223209781468371,7,7,5,1,6,5,2
938,0,0,5.790046199312371,0.003048519016869422,16,18,9,3,15,3,13
939,1,1,4.880266523073733,0.9924622595419184,9,12,5,1,11,8,1
940,0,0,3.264354980385498,0.03681447343260624,13,16,9,7,9,5,8
941,0,0,5.399475904470419,0.004498619651551183,14,16,10,2,14,2,12
942,0,0,2.8192790060990243,0.05629122233587425,19,23,10,5,18,5,14
943,1,1,1.5244242335458857,0.8211890478136061,5,5,2,1,4,4,1
944,0,0,4.5140109319132495,0.010835735102088462,21,30,20,7,23,6,15
945,1,1,2.6633634727077906,0.9348298792797733,47,78,52,17,61,25,22
946,0,0,1.0624569583917602,0.2568402067959815,3,2,0,0,2,0,3
947,1,1,0.3605586459253509,0.5891756597540698,9,9,5,3,6,5,4
948,1,1,1.6681244686332424,0.8413256039131904,21,29,21,4,25,14,7
949,1,1,1.123569007449101,0.7546501304182341,14,17,9,4,13,9,5
950,0,0,2.8611783238535446,0.054106363509390465,11,11,5,3,8,3,8
951,1,0,1.429609035803854,0.19315960829261714,5,5,2,0,5,0,5
952,1,1,2.598341166931738,0.9307547436476351,7,8,4,1,7,6,1
953,0,0,5.928597038529411,0.0026551457869207207,24,33,20,4,29,4,20
954,1,1,3.891889253963811,0.9800013514899891,22,31,19,6,25,15,7
955,0,0,0.5957032773144917,0.3553273303007126,2,1,0,0,1,0,2
956,1,1,3.7371468331522033,0.9767323080320094,9,12,6,0,12,9,0
957,1,1,3.4459094918877646,0.9691089185290118,8,11,7,0,11,8,0
958,1,0,0.23141879006027333,0.44240212619917074,8,7,2,1,6,2,6
959,0,1,0.9791778098615065,0.7269450453870727,6,6,3,1,5,4,2
960,1,1,2.348914355703866,0.9128478960775197,12,15,9,3,12,7,5
961,1,1,2.5507624893527683,0.9276247226541651,10,14,9,1,13,9,1
962,1,1,1.8202934257257481,0.860601332073073,17,22,11,6,16,9,8
963,1,1,2.2668095220896047,0.90609066030752,9,10,5,2,8,5,4
964,0,0,4.808079664210983,0.008097417913197957,23,32,21,6,26,7,16
965,1,0,1.1462074575290868,0.24118248804423525,20,26,14,5,21,7,13
966,0,0,2.844637453265393,0.05495917694609054,24,36,23,5,31,7,17
967,0,0,1.8045922300800312,0.14129297463552581,30,45,28,8,37,9,21
968,0,0,9.363660322778566,8.577816211918776e-05,26,33,18,1,32,1,25
969,0,1,0.1429188530444807,0.5356690199020123,12,15,6,4,11,7,5
970,1,1,3.7746122046347335,0.9775687205874272,12,15,10,1,14,11,1
971,1,1,3.691505629549015,0.9756721688955933,10,14,8,1,13,9,1
972,1,1,3.0018648471141134,0.9526583033181533,20,27,16,5,22,14,6
973,0,0,3.2166450401334026,0.0385441228910961,9,9,4,2,7,3,6
974,1,0,0.42803420599093434,0.39459584259228886,13,17,10,6,11,7,6
975,0,0,4.197527594227145,0.014810062644631028,9,9,5,0,9,0,9
976,0,0,6.096818775384119,0.0022449629482609312,17,23,15,7,16,5,12
977,0,0,6.507457252108125,0.001490045818020258,21,27,14,5,22,4,17
978,1,1,3.1654745103680106,0.9595141491497565,8,9,5,1,8,7,1
979,1,1,2.5294690995373563,0.9261820645561553,7,9,6,0,9,7,0
980,1,1,0.08717323240536201,0.521779517655304,18,26,19,4,22,13,5
981,0,0,1.3029225940075533,0.21367356007468374,5,5,3,0,5,0,5
982,1,1,0.7523845393685276,0.679698056220337,15,18,9,7,11,6,9
983,1,1,1.4662870647924386,0.8124923820839366,13,18,9,3,15,10,3
984,0,1,2.2813993779229413,0.9073247827948075,18,24,13,6,18,10,8
985,1,1,3.0956364634515934,0.9567123941810398,15,19,11,3,16,10,5
986,0,0,5.178110852072052,0.0056070325141893695,33,48,29,10,38,15,18
987,0,0,3.2070861879313326,0.03889992609660897,6,5,2,1,4,1,5
988,0,0,0.9639241027783481,0.2760932124244855,37,56,38,13,43,20,17
989,1,1,3.4426797176632773,0.9690120827178572,15,21,12,2,19,12,3
990,0,0,2.7239775237647965,0.061573235910344803,13,15,9,2,13,3,10
991,0,0,0.936681957990348,0.28157105859091547,27,42,25,8,34,9,18
992,0,0,3.5077634549941337,0.02909214232548607,23,32,18,9,23,7,16
993,0,0,2.040134756066203,0.11505301103500853,34,50,32,10,40,15,19
994,1,1,1.0003240447159485,0.731122284917606,29,44,27,11,33,15,14
995,0,1,0.1827895805576052,0.545570581933555,4,3,1,1,2,3,1
996,1,1,2.7788837014154106,0.9415240151986406,7,8,4,1,7,6,1
997,0,0,5.418761701274034,0.004413070654576301,40,62,38,14,48,12,28
998,1,0,2.2157478688393772,0.09834521192802748,19,25,13,7,18,7,12
999,0,0,1.4543643892339975,0.1893307908672388,12,15,11,2,13,3,9
1000,0,0,4.4553195697014125,0.011483211016690364,18,23,14,3,20,4,14
1001,1,1,2.436116796502982,0.9195402528861473,7,10,5,0,10,7,0
1002,0,0,3.2777024028195423,0.03634409992724019,26,38,26,8,30,10,16
1003,1,0,0.49712550152739743,0.3782164240166529,26,37,25,7,30,11,15
1004,0,0,2.0077261928624344,0.11839410498547087,21,28,18,5,23,6,15
1005,1,1,2.7826078825150167,0.941728718905175,7,7,3,1,6,6,1
1006,0,0,3.881501196036249,0.02020325937504197,8,10,6,0,10,0,8
1007,1,1,1.519698026980201,0.8204940092265199,4,4,2,0,4,4,0
1008,0,0,2.7406171523562515,0.06061875058818067,24,37,23,9,28,7,17
1009,1,1,7.343212365532282,0.9993534494193942,27,41,27,6,35,20,7
1010,0,0,0.03942178986364153,0.49014582867987677,10,13,7,4,9,5,5
1011,0,0,0.32481878398107744,0.4195018242683317,15,19,11,5,14,6,9
1012,0,0,2.4973638914333924,0.07604318777603247,10,11,5,0,11,0,10
1013,0,0,3.657113651934557,0.025157652168913414,10,13,6,0,13,0,10
1014,0,0,6.102452778365812,0.002232378539312574,22,25,13,3,22,4,18
1015,1,1,2.490580978170834,0.9234788679495585,9,11,5,1,10,7,2
1016,0,0,6.988976895342889,0.0009211400595630082,31,46,26,7,39,6,25
1017,1,1,1.819907143013139,0.8605549845634111,4,3,1,0,3,4,0
1018,0,0,3.181458298736853,0.03986947295253285,19,24,14,3,21,4,15
1019,1,1,3.529884137412595,0.9715262073741007,9,11,8,1,10,7,2
1020,1,1,3.091327233340241,0.9565335809927098,7,7,2,1,6,6,1
1021,1,1,0.31538687779140506,0.5781995893599163,5,4,1,1,3,4,1
1022,0,0,1.0840114020905602,0.252747646940501,26,38,24,5,33,12,14
1023,1,1,1.2016720382146626,0.7688220962441121,12,17,10,4,13,7,5
1024,1,1,1.4669419730058466,0.8125921359566051,4,3,2,0,3,4,0
1025,0,0,5.78424193804288,0.003066210456171503,23,31,19,4,27,4,19
1026,1,1,0.3308525089962773,0.5819667909434834,19,29,18,10,19,10,9
1027,0,0,3.0365367008190227,0.04580229447855866,24,33,20,3,30,5,19
1028,0,0,4.590066526571566,0.010050151979297706,20,27,16,6,21,6,14
1029,0,0,5.284492818757606,0.00504403150768451,23,30,19,4,26,5,18
1030,1,1,6.848695904371699,0.9989402859594358,24,33,22,5,28,16,8
1031,0,0,2.0575792579699264,0.11328877678461191,23,33,20,8,25,9,14
1032,0,0,5.672710376176936,0.003426749924598238,18,21,14,1,20,4,14
1033,1,1,3.628826446702857,0.9741392137582179,12,14,9,2,12,9,3
1034,0,0,0.4326907740495267,0.39348398295212417,28,40,20,11,29,11,17
1035,1,1,2.362250650439702,0.9139030613071051,14,19,10,3,16,10,4
1036,1,1,1.1568740666695152,0.7607642525450464,19,26,14,7,19,11,8
1037,1,1,0.15358356961528297,0.5383205967585432,9,11,6,4,7,5,4
1038,0,0,5.866400387090869,0.002825049381228628,16,20,11,1,19,2,14
1039,0,0,2.7905139073153853,0.05783894425195557,17,20,11,2,18,5,12
1040,0,1,0.016789658071378333,0.5041973159189433,4,3,1,1,2,2,2
1041,0,0,1.3291306027228096,0.20930321007951513,34,53,34,13,40,14,20
1042,0,0,2.4755219145498177,0.07759210007868111,13,18,11,0,18,0,13
1043,0,0,1.0669146847138142,0.2559902684850879,9,12,5,3,9,2,7
1044,0,0,1.2419959410965236,0.22408875438957065,20,26,17,4,22,5,15
1045,1,1,2.348124353556171,0.9127850256790837,12,16,10,2,14,10,2
1046,0,0,1.8577513896641729,0.13496536114278435,6,5,2,0,5,0,6
1047,1,1,3.941025640486992,0.9809419862955719,15,22,13,2,20,9,6
1048,0,0,3.0768912162909334,0.04407059794396606,12,15,9,2,13,3,9
1049,1,1,4.224638186500176,0.9855803413412404,22,37,27,5,32,19,3
1050,0,0,0.06882511774167632,0.48280050937968666,16,23,14,5,18,6,10
1051,1,0,1.8831996407347233,0.13202178830443267,20,27,15,3,24,4,16
1052,0,0,1.638756681070177,0.16263431219999247,8,10,6,0,10,0,8
1053,1,1,2.3084789946445987,0.9095768353571668,22,33,19,9,24,14,8
1054,0,0,1.0612374447309714,0.25707304842829604,10,10,5,2,8,3,7
1055,1,0,2.691748915809093,0.06346199288526144,21,27,17,5,22,8,13
1056,0,0,4.23113380249134,0.01432763528293779,11,14,8,0,14,0,11
1057,0,0,0.11712313090575521,0.47075264381494697,4,3,1,1,2,1,3
1058,1,1,1.1656905710019945,0.762365183051041,7,7,3,1,6,5,2
1059,1,1,2.8520046150216314,0.9454222114280038,13,19,12,3,16,11,2
1060,0,0,3.5007871457710964,0.02928984236998322,10,10,5,1,9,2,8
1061,0,0,3.923281133175693,0.019392590347418803,13,14,7,0,14,0,13
1062,1,1,0.9636084148344897,0.7238436879080432,12,16,11,3,13,9,3
1063,1,1,5.113637179033861,0.9940217855023723,13,17,10,1,16,12,1
1064,1,1,1.2289498708013442,0.7736347242506267,8,9,3,3,6,5,3
1065,0,1,1.4575458375455508,0.8111570300265665,9,11,5,5,6,6,3
1066,0,0,2.048865930912489,0.11416702281598656,9,10,6,0,10,0,9
1067,1,1,3.437079221645135,0.9688434704393029,7,8,3,1,7,6,1
1068,0,0,0.8479417012798605,0.29986481082527594,9,9,4,3,6,3,6
1069,1,0,0.8193277927971017,0.30590636945127847,8,8,4,3,5,4,4
1070,0,0,3.339611760756648,0.03423699243236267,21,28,17,5,23,6,15
1071,1,1,1.8396847093677375,0.8629114142903993,6,7,5,0,7,6,0
1072,1,1,2.5466253882735836,0.9273464778460125,7,9,6,0,9,7,0
1073,1,1,1.4634739921445372,0.8120634378678471,17,23,13,7,16,7,10
1074,1,1,5.317760001281245,0.9951202034128714,20,31,21,4,27,16,4
1075,0,1,0.1601748013915203,0.5399583061071463,13,18,11,4,14,7,6
1076,0,0,3.2594723984026026,0.03698799781513595,13,16,9,2,14,3,10
1077,0,0,5.030635747197404,0.006492230376395569,16,21,13,1,20,1,15
1078,1,1,0.37747181467762614,0.5932631909510483,16,20,9,5,15,10,6
1079,1,1,2.0617269068627944,0.8871272051127571,9,12,7,3,9,8,1
1080,1,1,0.6352434017548083,0.6536774350397478,8,9,4,3,6,5,3
1081,1,1,2.2735929769804297,0.9066662791689116,12,14,7,4,10,7,5
1082,1,0,1.826785178618503,0.13862169545999248,8,7,4,2,5,2,6
1083,1,0,0.5699052626556651,0.36125868528631233,21,30,16,7,23,8,13
1084,1,1,3.3657815882772324,0.9666178399399254,13,17,10,3,14,10,3
1085,1,1,2.744959950546047,0.939628074856496,15,19,12,4,15,10,5
1086,1,1,2.088139540733683,0.8897450491168761,10,14,9,3,11,8,2
1087,0,0,3.3834157230728574,0.0328178038501965,16,17,8,2,15,4,12
1088,1,0,0.8013680194085278,0.30973296233366265,23,32,20,8,24,11,12
1089,0,0,0.6706528249868038,0.33835067777666283,22,34,24,5,29,9,13
1090,1,1,5.546419245782861,0.9961137595628166,18,29,22,1,28,17,1
1091,1,1,3.7033185766442998,0.975950990894685,10,14,9,0,14,10,0
1092,0,0,3.8578344122907664,0.020677103938821606,25,34,23,3,31,7,18
1093,1,1,3.4800101570728725,0.9701136146837064,14,22,16,1,21,13,1
1094,0,0,1.357994415504042,0.20456645566884402,17,21,11,6,15,6,11
1095,0,0,3.802610021427442,0.021825479655950608,15,17,7,2,15,2,13
1096,1,1,4.717573963323849,0.991142326199048,14,20,13,2,18,12,2
1097,1,1,3.047981592103424,0.9546953060548921,12,14,7,2,12,9,3
1098,1,1,0.8220591844317895,0.6946732728948298,13,15,9,5,10,7,6
1099,0,0,3.126347309590292,0.04203344280855714,9,11,5,2,9,1,8
1100,0,1,0.18007294412729546,0.5448969814283191,12,15,9,5,10,7,5
1101,1,0,0.2597033974641521,0.4354366210672628,1,0,0,0,0,0,1
1102,1,1,0.661273034671281,0.659546300026137,22,32,16,9,23,11,11
1103,1,1,2.395754756169362,0.9165030090789709,5,6,3,0,6,5,0
1104,0,0,0.24912251396101426,0.4380394901059186,16,23,14,6,17,6,10
1105,0,0,0.46536287648807295,0.38571437414011545,5,4,1,1,3,1,4
1106,1,1,1.8447051420647484,0.8635042265766981,9,11,7,1,10,7,2
1107,0,0,5.86963399433882,0.00281595471731233,32,49,29,8,41,7,25
1108,1,1,0.8298924209548031,0.6963321823199391,11,13,7,3,10,6,5
1109,1,1,1.41031342101187,0.803815373649091,14,18,9,5,13,9,5
1110,1,1,3.7741829474197717,0.9775593058550706,11,15,10,1,14,10,1
1111,1,0,2.5185899471055655,0.07456518782647081,16,20,11,3,17,4,12
1112,0,1,2.6349597267514113,0.9330779182125197,14,19,12,2,17,11,3
1113,0,0,5.196773612325975,0.0055039308303441725,31,47,30,6,41,9,22
1114,0,0,4.066886470646179,0.0168421258841166,6,5,3,0,5,0,6
1115,0,0,3.176872861196218,0.04004537385931184,16,20,10,1,19,1,15
1116,1,1,2.0242585573830048,0.8833206355560796,8,10,6,1,9,7,1
1117,0,1,0.5444536949652798,0.6328478511291835,29,44,26,9,35,16,13
1118,1,1,2.8496073437583953,0.9452983823345393,8,11,5,1,10,7,1
1119,0,0,6.736781083025634,0.0011850541136964043,18,21,12,2,19,2,16
1120,0,1,4.08783186623288,0.9835012106975605,7,9,7,0,9,7,0
1121,0,0,5.520555573563665,0.0039876579378818056,19,21,10,2,19,3,16
1122,1,1,3.610427189943249,0.973671633683488,28,42,25,8,34,17,11
1123,1,1,1.143554220954332,0.7583316004634629,3,2,1,0,2,3,0
1124,1,1,9.405090481577773,0.9999177027431729,28,44,29,6,38,22,6
1125,1,1,2.0461769111853263,0.8855607465052713,10,13,8,1,12,9,1
1126,1,1,1.7753639536521606,0.8551234635847618,4,3,0,0,3,4,0
1127,1,1,2.032304379932734,0.8841473265114392,8,9,6,1,8,7,1
1128,0,1,1.348888882456823,0.7939479147112443,18,23,15,4,19,10,8
1129,0,0,2.583517239054185,0.07020678592202079,21,30,18,5,25,5,16
1130,0,0,2.7304855985978156,0.06119825776310617,9,9,4,1,8,1,8
1131,1,1,1.450709309824916,0.810107573452729,16,20,13,4,16,10,6
1132,0,0,3.5295140039352493,0.02848403342870509,16,18,10,4,14,4,12
1133,1,1,1.6330599695688262,0.8365883928421912,9,12,7,1,11,8,1
1134,1,1,0.8104700044240123,0.6922096503512838,14,18,12,3,15,7,7
1135,0,0,1.4007239276178975,0.19770126019136858,4,3,0,0,3,0,4
1136,0,0,1.700095934174099,0.1544527359443998,33,50,31,11,39,16,17
1137,1,1,3.65672465705518,0.9748328060686273,12,17,8,2,15,10,2
1138,1,0,0.24220069752424278,0.4397440949003204,13,17,10,3,14,4,9
1139,1,1,2.4955760821454924,0.9238311043852436,19,28,20,4,24,15,4
1140,1,1,3.202142095461536,0.9609148085173608,9,12,7,1,11,8,1
1141,1,1,2.403751266995914,0.9171129094502066,9,13,6,1,12,8,1
1142,1,1,1.333528299922445,0.7914236580763938,9,10,4,2,8,6,3
1143,0,0,3.5586800381117674,0.027687935285515608,13,16,9,0,16,0,13
1144,0,0,3.653691847006054,0.02524170755389732,12,15,9,0,15,0,12
1145,1,1,1.3364457248400745,0.7919048345354578,29,42,27,9,33,16,13
1146,0,0,3.941396578827904,0.0190510803211682,13,15,7,1,14,1,12
1147,0,1,0.5172580054814011,0.626506373074809,16,21,12,5,16,8,8
1148,1,1,4.597286095014653,0.9900214230761968,10,12,6,1,11,9,1
1149,1,1,5.427622407043743,0.9956256892440866,13,17,12,1,16,12,1
1150,0,0,2.3975509169388523,0.08335964206938407,7,6,1,1,5,1,6
1151,1,1,2.35444915035999,0.9132872206129158,12,14,9,3,11,8,4
1152,0,0,4.468747893940401,0.011331777126297848,14,17,6,3,14,2,12
1153,1,1,3.8096345119662476,0.9783239844379795,18,27,16,3,24,15,3
1154,0,0,0.5559596894916856,0.3644828240131045,27,38,20,7,31,10,17
1155,1,0,2.0250426761608638,0.11659857330185086,15,19,13,2,17,5,10
1156,1,1,1.4905403226108398,0.8161593581963242,13,16,10,4,12,8,5
1157,0,1,0.2617733274081502,0.5650721648842014,13,16,10,6,10,9,4
1158,0,0,2.382644859659811,0.08450572248367105,14,17,11,5,12,5,9
1159,1,1,5.239733674803212,0.9947262908425258,10,15,9,0,15,10,0
1160,0,0,0.7675329637612789,0.31701301720288466,24,33,20,6,27,10,14
1161,1,1,2.0559134791343237,0.8865437805284829,9,11,5,2,9,7,2
1162,1,1,2.57798076303519,0.9294309440310999,24,40,27,9,31,16,8
1163,1,1,3.707604933334106,0.9760513895141032,16,22,16,2,20,14,2
1164,1,1,0.2873510421023125,0.5713475008553833,6,5,2,2,3,2,4
1165,0,0,1.5281532538324842,0.1782640474864079,17,23,15,7,16,7,10
1166,1,1,3.965494099576353,0.9813940766728285,7,9,4,0,9,7,0
1167,1,1,0.6149853763433217,0.6490771933339514,15,19,11,5,14,9,6
1168,1,1,2.4135796629496804,0.9178569765334834,7,10,5,0,10,7,0
1169,0,0,3.8040119938224883,0.021795568824451106,24,35,20,7,28,7,17
1170,0,0,1.1160728446147334,0.24674045692980506,17,20,11,5,15,8,9
1171,0,0,4.640021763981017,0.00956511248618086,32,49,31,15,34,12,20
1172,0,0,5.943216905623325,0.0026167111229994378,24,34,20,5,29,5,19
1173,1,1,7.4638722023332305,0.9994268972107168,12,20,13,0,20,12,0
1174,0,0,4.116939029858444,0.016033066761393155,32,44,27,5,39,8,24
1175,1,1,0.6347344512008555,0.6535622081514176,15,20,10,4,16,10,5
1176,1,1,1.3158466477470965,0.7884898669855939,14,17,11,3,14,8,6
1177,0,0,2.551983579267303,0.07229333970972818,17,22,13,6,16,6,11
1178,1,1,4.674319472778951,0.9907544051508925,15,23,17,3,20,13,2
1179,1,0,0.06683481825920534,0.4832975123243889,16,20,10,5,15,6,10
1180,0,0,1.5904186193762584,0.16932500827248564,27,42,26,14,28,11,16
1181,0,1,0.43302495545154396,0.606595768049651,5,4,2,1,3,3,2
1182,0,0,2.330724526378521,0.08861013423657094,12,13,6,3,10,3,9
1183,1,1,3.8197726706793524,0.9785379365578977,10,13,6,2,11,8,2
1184,1,1,3.0346132744166834,0.9541135697629829,12,16,8,4,12,8,4
1185,1,1,1.3330824979742377,0.7913500589845027,6,6,4,1,5,5,1
1186,0,0,9.159922809719644,0.00010515995613735729,26,37,23,5,32,6,20
1187,1,1,0.5309174620975805,0.6296970700034318,12,16,11,3,13,6,6
1188,0,0,3.55452269240782,0.027800076527693562,11,11,6,2,9,2,9
1189,1,0,0.5951682514480389,0.3554498980631745,6,6,2,1,5,1,5
1190,1,1,2.8764373028646038,0.9466692812714064,14,17,8,3,14,8,6
1191,1,1,0.8580686059377933,0.7022569728904328,7,6,3,1,5,4,3
1192,1,1,1.7704582734119576,0.854514652577306,24,32,19,9,23,10,14
1193,1,1,2.260467506810344,0.9055496242565072,12,16,11,2,14,8,4
1194,1,0,6.731152887453469,0.0011917346635654802,35,52,31,9,43,11,24
1195,1,0,2.090740560607165,0.11000005250638545,7,6,3,1,5,2,5
1196,0,0,1.4243040713704505,0.19398772760851524,7,8,3,2,6,1,6
1197,0,0,6.507728683834639,0.001489642029593563,22,27,15,3,24,4,18
1198,0,0,1.6789826782131603,0.15723022605572035,7,8,4,0,8,0,7
1199,1,1,3.0713860964788813,0.9556968972875574,15,21,15,3,18,12,3
1200,1,1,2.6979869985002134,0.9369077567801878,5,6,3,0,6,5,0
1201,0,0,2.3156430447981857,0.08983567068297404,13,15,11,2,13,3,10
1202,1,0,1.3418140927380504,0.2072118899637223,3,2,0,0,2,0,3
1203,1,1,3.637005875605322,0.9743444728024848,13,16,10,2,14,10,3
1204,0,0,4.156019522944152,0.01542805264376712,19,29,19,3,26,3,16
1205,1,1,1.5966676887746936,0.8315521332568667,21,29,19,7,22,12,9
1206,1,1,1.8344014278835796,0.8622852277233468,20,29,15,6,23,12,8
1207,1,1,5.713382719679191,0.9967093783061984,25,39,27,3,36,19,6
1208,0,0,2.9821907157946637,0.0482369530335921,21,27,15,6,21,6,15
1209,1,1,2.6044006535426187,0.9311442617918888,16,19,11,4,15,9,7
1210,0,0,3.915569857241212,0.019539776720915558,26,40,23,6,34,8,18
1211,1,1,1.1327490634792963,0.7563458721396893,11,12,6,2,10,7,4
1212,0,0,3.9615799294378204,0.018677529901602985,22,30,20,6,24,5,17
1213,0,0,1.141902223417779,0.24197128169864368,6,6,3,1,5,1,5
1214,1,1,2.8128718790778944,0.9433674457224169,6,7,3,0,7,6,0
1215,1,0,1.5453540210455907,0.1757583051204753,9,9,4,1,8,2,7
1216,1,1,3.403299819271785,0.967807503787757,18,25,16,4,21,14,4
1217,1,1,1.1111997360198087,0.7523527116556136,14,18,8,6,12,6,8
1218,1,1,1.9469362374830481,0.8751121852449475,7,8,5,1,7,6,1
1219,1,1,4.031407805579096,0.9825602195684476,20,32,23,2,30,18,2
1220,1,1,0.10703004905493396,0.5267319982535517,4,3,1,1,2,2,2
1221,1,1,0.8812602564729795,0.7070833091109383,18,21,10,7,14,9,9
1222,0,0,3.2867969279538016,0.0360269201447585,46,72,46,14,58,18,28
1223,1,1,4.180215619430937,0.9849352098510576,13,17,10,1,16,11,2
1224,0,0,0.5957032773144917,0.3553273303007126,2,1,0,0,1,0,2
1225,1,0,2.578232987571794,0.07055251458928291,11,11,5,1,10,1,10
1226,1,1,2.9149204119654115,0.9485790968702503,10,13,7,2,11,8,2
1227,1,1,3.541288219952195,0.9718399882153412,13,18,9,2,16,11,2
1228,0,0,3.663398432547114,0.0250039786395152,31,43,22,9,34,11,20
1229,0,0,1.0078144327903544,0.2674077875527574,5,4,1,1,3,1,4
1230,1,1,2.0006527993669385,0.8808656006878774,16,20,9,6,14,8,8
1231,1,1,2.7497697110220907,0.9399003426516741,11,14,7,4,10,9,2
1232,0,0,1.759915866565931,0.1468008772328081,8,9,6,0,9,0,8
1233,0,0,4.559306024316992,0.010360850795876564,9,9,3,1,8,1,8
1234,0,0,2.640469539045102,0.0665788496125912,23,31,16,8,23,8,15
1235,1,1,2.16811639378086,0.8973495911807465,14,21,14,3,18,11,3
1236,0,0,3.897203493955754,0.019894761544798745,17,20,10,2,18,3,14
1237,0,0,0.9513587597334165,0.27861164653413506,24,34,17,10,24,9,15
1238,1,1,1.4242805433192909,0.8060085936015224,11,15,8,2,13,7,4
1239,0,0,4.829340685296938,0.007928426325700011,27,36,20,5,31,6,21
1240,1,1,4.444579488397639,0.9883942327559708,16,25,16,3,22,14,2
1241,1,0,2.1819500877316025,0.10138312780154468,36,55,31,15,40,15,21
1242,1,1,4.132455010199585,0.9842098842145598,13,17,11,1,16,11,2
1243,1,1,5.264028980021838,0.9948522216914811,10,15,9,0,15,10,0
1244,1,1,0.4401198728813416,0.6082875936838494,23,31,14,11,20,11,12
1245,0,0,3.352248054854007,0.033821625807569644,13,14,7,2,12,3,10
1246,1,1,4.714449839276855,0.9911148567145058,21,33,17,5,28,13,8
1247,1,0,2.9969206728447895,0.047565180925171036,25,35,21,6,29,5,20
1248,1,1,2.217132665086679,0.9017775144255171,20,27,16,6,21,13,7
1249,0,0,2.217634899567933,0.09817800921690145,19,23,12,2,21,4,15
1250,1,1,6.158928135227869,0.9978899432187589,18,28,17,1,27,17,1
1251,0,0,5.374071124700908,0.004613836121995951,29,43,26,7,36,7,22
1252,1,0,1.0715976112329435,0.25509938143469,10,11,5,5,6,4,6
1253,1,1,3.993574228220407,0.9818999412855628,16,24,16,2,22,14,2
1254,1,1,1.7236257064083655,0.8485952609807559,9,10,5,2,8,6,3
1255,1,1,4.51460161823521,0.9891705942350804,34,51,35,8,43,20,14
1256,0,1,0.2589443454544348,0.5643767708492644,3,2,0,1,1,2,1
1257,1,1,0.08074571437324551,0.5201754679979173,6,6,2,2,4,3,3
1258,0,0,1.7668524971500532,0.1459341884913381,19,28,18,7,21,7,12
1259,0,1,0.4904285646512838,0.6202073860249528,6,7,4,3,4,5,1
1260,1,1,0.1093651297676832,0.5273140631859174,15,22,14,7,15,9,6
1261,0,0,3.8596721383226944,0.020639923554196637,17,20,10,3,17,4,13
1262,1,1,3.335653363192847,0.9656318822803897,18,26,16,5,21,13,5
1263,1,1,5.126309272103669,0.9940966196196338,11,15,8,1,14,10,1
1264,0,0,3.1906154074353155,0.03952041295615283,5,4,1,0,4,0,5
1265,1,1,2.905420228159242,0.948113728657607,15,20,12,5,15,10,5
1266,1,1,2.1977795660360337,0.9000499378957144,8,9,6,1,8,6,2
1267,0,1,0.3559831464338401,0.5880677204859861,12,16,9,4,12,7,5
1268,0,0,1.3146971929737512,0.21170189528955718,11,12,7,2,10,3,8
1269,1,1,4.801445113401276,0.9918491200916973,13,20,14,0,20,13,0
1270,0,0,4.45039888533906,0.011539201891738404,34,53,32,13,40,10,24
1271,1,1,0.9582421210109546,0.7227697104560804,16,22,12,6,16,9,7
1272,1,1,1.8411827536847951,0.8630885295771993,6,7,3,1,6,5,1
1273,1,1,0.26834600230549266,0.5666868059699726,15,18,10,5,13,9,6
1274,0,0,6.043441336063693,0.002367757672826376,23,32,20,4,28,7,16
1275,1,1,3.8704073684484297,0.9795759644558931,15,22,16,2,20,13,2
1276,0,0,2.0149762633989043,0.11763945597174474,39,64,42,14,50,18,21
1277,0,0,1.1584073609534613,0.23895679640882594,31,45,25,10,35,11,20
1278,0,0,3.50633588306877,0.029132492340340765,14,15,9,3,12,4,10
1279,1,1,1.1621186870672777,0.7617174781454189,6,6,3,1,5,4,2
1280,1,1,2.2197899909490046,0.90201263544291,8,9,3,2,7,6,2
1281,0,0,4.017386183571949,0.017681682635270368,32,48,30,9,39,8,24
1282,0,0,2.328744078460825,0.08877020235978206,6,5,2,0,5,0,6
1283,1,1,2.2862439301913664,0.9077313412828829,20,27,18,6,21,14,6
1284,1,1,1.4008803922691084,0.8023235563492707,3,2,1,0,2,3,0
1285,0,1,1.1795872120153876,0.7648735752684728,11,13,8,2,11,8,3
1286,1,1,5.249185307584757,0.9947756420039872,17,25,15,4,21,14,3
1287,0,0,4.745286242604811,0.008617663789195928,10,9,3,1,8,1,9
1288,1,1,2.038569916204814,0.8847875675182629,22,30,19,5,25,14,8
1289,0,1,1.0860230673905789,0.7476320997791642,8,9,4,2,7,5,3
1290,1,1,1.851458416405729,0.8642982468638807,18,23,12,5,18,8,10
1291,0,0,2.2876288320503755,0.09215273152845083,20,27,15,6,21,7,13
1292,0,0,3.300580824229733,0.03555126896053973,15,15,6,2,13,3,12
1293,1,1,3.8799165495888372,0.9797653485484967,18,28,17,3,25,13,5
1294,1,1,1.1819336341637614,0.7652952981984684,24,37,23,11,26,14,10
1295,1,1,0.6205004816953079,0.6503323667623235,8,8,4,3,5,3,5
1296,0,0,1.3511109309610232,0.20568880753079666,23,30,17,4,26,5,18
1297,1,1,1.1161065531215704,0.753265808066437,9,9,4,3,6,5,4
1298,1,1,2.6059101745305533,0.9312409811993333,10,13,8,1,12,9,1
1299,0,0,0.00422043780099246,0.49894489211589155,8,9,5,1,8,2,6
1300,1,0,0.5654673474263078,0.36228336722467,7,7,3,1,6,1,6
1301,1,1,2.855317218000702,0.9455928866180644,15,20,12,4,16,9,6
1302,0,1,0.6532114928008039,0.657733799880875,16,20,11,7,13,8,8
1303,0,0,11.02745851658801,1.6249071881691002e-05,35,50,28,8,42,7,28
1304,0,0,0.053136424086197065,0.48671901871301515,8,8,4,3,5,5,3
1305,1,1,2.401252346652699,0.9169227513614645,8,8,2,2,6,6,2
1306,0,0,5.534036919819461,0.003934469783149597,18,20,10,3,17,3,15
1307,0,0,4.700705219318753,0.009007001772790568,18,20,9,2,18,3,15
1308,1,1,1.3836189312569012,0.7995715876212854,14,17,7,4,13,8,6
1309,0,0,1.90912435262068,0.12907925853303626,16,19,10,2,17,3,13
1310,0,0,3.199905755999848,0.03916926951923805,13,14,7,2,12,3,10
1311,0,0,1.4208521403985843,0.194528029618511,12,15,8,2,13,2,10
1312,1,1,1.4588887966395856,0.8113626602921531,10,13,5,3,10,7,3
1313,1,0,0.26693084462290617,0.43366072279946755,13,15,8,6,9,6,7
1314,0,0,3.8059529017273457,0.021754226040073044,26,36,24,2,34,7,19
1315,0,0,3.114438848089265,0.042515580175210066,29,44,27,12,32,11,18
1316,0,0,2.1502963527773384,0.10430353331950892,21,29,18,7,22,8,13
1317,1,0,1.574416247029517,0.17158773185734755,49,78,47,16,62,22,27
1318,0,1,0.08231238258298079,0.5205664848994824,16,21,13,6,15,9,7
1319,1,1,0.6982452137208408,0.6677985987018986,3,2,0,0,2,3,0
1320,1,0,1.7964212040760348,0.1422872680015812,12,14,6,3,11,4,8
1321,1,1,2.4325666290736305,0.9192771987566181,10,12,7,3,9,6,4
1322,1,1,0.09805744718790299,0.5244947379960017,11,13,7,5,8,5,6
1323,0,0,0.8459423274914336,0.300284739059144,14,18,10,2,16,3,11
1324,1,0,0.6797760744756283,0.3363112822848987,26,37,23,8,29,9,17
1325,0,0,0.4638130852702014,0.3860816447819445,9,11,6,5,6,4,5
1326,0,0,5.422340835393228,0.004397373247532199,14,13,6,1,12,2,12
1327,0,0,8.441459507788203,0.00021568852182873854,26,33,19,4,29,4,22
1328,0,0,3.6350056983774524,0.025705573736100606,12,14,8,1,13,1,11
1329,0,0,0.5816306548315402,0.3585574663843507,33,50,30,11,39,12,21
1330,1,0,0.5671457150978103,0.3618956967082816,13,15,9,3,12,6,7
1331,1,1,0.6729888961141328,0.6621720996394855,8,9,4,2,7,5,3
1332,1,1,2.5870088219408656,0.9300207951506537,5,5,2,0,5,5,0
1333,1,1,2.4527636729960776,0.9207633181198149,19,28,20,5,23,16,3
1334,0,0,1.6858594159441012,0.15632114364176208,16,22,14,3,19,3,13
1335,0,1,1.1389501080302167,0.7574868254290972,4,3,1,1,2,3,1
1336,1,0,0.8054726940302634,0.3088560753099687,8,9,4,3,6,4,4
1337,0,0,3.8652279908155314,0.020527916603491736,12,12,6,1,11,1,11
1338,0,0,6.986976814875564,0.000922982555298657,17,19,11,1,18,1,16
1339,1,1,0.08317346845935103,0.5207813883270987,11,14,7,4,10,5,6
1340,1,1,4.538438976917605,0.989422988115043,15,21,13,3,18,12,3
1341,0,0,4.5016160006818735,0.010969396665389874,17,22,12,1,21,1,16
1342,1,1,2.054098379020245,0.8863610825360964,16,22,11,5,17,10,6
1343,0,0,3.7979850397433834,0.02192443765636576,30,42,26,8,34,11,19
1344,1,1,1.7476630877461834,0.85165780654199,13,18,14,1,17,11,2
1345,0,0,2.76494694294796,0.05924803279134061,15,17,9,3,14,4,11
1346,0,0,0.6453187962037084,0.34404520989301746,21,30,21,6,24,13,8
1347,1,1,2.7988852984464057,0.9426155579985049,7,6,2,1,5,5,2
1348,1,1,1.2336355188797847,0.7744542416127765,10,12,5,2,10,7,3
1349,0,0,2.9498691090953004,0.04974269819262922,4,3,1,0,3,0,4
1350,1,1,5.6833788871741096,0.996609490782414,20,30,21,5,25,17,3
1351,0,0,0.2597033974641521,0.4354366210672628,1,0,0,0,0,0,1
1352,1,0,2.2078554453536623,0.09904728213819747,25,36,18,9,27,8,17
1353,0,1,1.9263164286036554,0.8728411433806662,12,13,5,4,9,6,6
1354,1,1,0.893508040305111,0.7096135780882376,35,55,38,14,41,18,17
1355,0,0,2.211126158595591,0.09875579628349407,19,24,12,7,17,7,12
1356,0,0,2.543219207336879,0.07288334786986217,20,26,16,4,22,7,13
1357,0,0,3.877207799479462,0.020288422838663278,28,40,26,4,36,4,24
1358,0,1,2.2097215992898875,0.9011191231283732,35,52,34,11,41,19,16
1359,1,1,1.3070184518467498,0.78701380729469,5,5,2,1,4,4,1
1360,1,1,1.1307675658718754,0.7559805228394485,14,19,13,4,15,9,5
1361,1,1,1.2605938904867442,0.7791283257781882,12,13,7,4,9,6,6
1362,0,0,6.508447675043011,0.001488572968759816,13,13,5,2,11,2,11
1363,0,0,2.089100056178637,0.11016076074167225,18,23,10,6,17,6,12
1364,1,1,5.074162043694667,0.9937825714922234,16,21,12,3,18,13,3
1365,1,1,1.1420209043504856,0.7580504862315132,21,29,17,8,21,11,10
1366,1,1,3.4026705746717987,0.967787893183248,14,22,16,2,20,13,1
1367,0,0,1.982918938537152,0.12100802113915521,19,27,16,7,20,7,12
1368,0,0,3.2749090290096334,0.036442059644761216,12,13,7,3,10,4,8
1369,1,1,0.02766935147657179,0.5069168965808002,16,20,11,3,17,10,6
1370,0,0,0.8482580758665601,0.29979839348196535,12,14,7,2,12,3,9
1371,0,0,0.039704699781967,0.4900751288697476,13,16,7,5,11,6,7
1372,0,0,0.7457932927540664,0.32173861134590587,8,8,5,1,7,1,7
1373,1,1,5.799700679801719,0.9969806827953712,15,22,12,1,21,14,1
1374,1,1,3.7405490915400263,0.9768095035158979,13,17,10,3,14,9,4
1375,1,1,1.2834677165386281,0.7830394803172375,9,11,6,2,9,5,4
1376,0,0,1.9090161342472842,0.12909142469322032,3,2,1,0,2,0,3
1377,0,1,0.08506520755619129,0.5212534874229153,9,11,5,5,6,6,3
1378,0,0,2.3811824183243164,0.08461893230438289,12,14,7,4,10,5,7
1379,0,0,3.53876534694543,0.028229137564757423,21,29,18,6,23,7,14
1380,0,0,4.362938695764808,0.012580602888659698,26,37,23,6,31,8,18
1381,0,0,2.5484477775937844,0.07253083427788909,12,13,7,2,11,4,8
1382,0,0,2.199128052458808,0.09982881762720808,10,11,6,1,10,1,9
1383,0,1,0.24415407830410607,0.5607371012192002,14,16,6,6,10,6,8
1384,1,1,1.2978892906730914,0.785479539807072,24,33,16,12,21,13,11
1385,0,0,2.156558182523302,0.10371997406013966,7,8,4,0,8,0,7
1386,1,1,3.0342247837966694,0.9540965583063723,12,15,9,2,13,8,4
1387,0,1,0.18891328959486797,0.5470883639246371,25,33,21,9,24,12,13
1388,0,0,3.5155709625205964,0.028872422054078806,8,9,4,0,9,0,8
1389,1,1,0.7285883044809156,0.674495409303741,15,20,11,6,14,8,7
1390,0,0,2.063581776062251,0.11268719547357808,13,17,9,5,12,5,8
1391,1,1,2.2490372359106567,0.904567456690041,9,12,7,1,11,8,1
1392,0,0,3.167461015303446,0.04040875199941274,8,7,2,1,6,2,6
1393,1,1,3.1416186538464252,0.9585772002368736,13,19,14,1,18,12,1
1394,1,1,2.60215404001091,0.9310000814120383,26,40,25,6,34,15,11
1395,0,0,4.292045441047625,0.013492387014838347,27,39,24,10,29,10,17
1396,1,0,2.456626314222017,0.07895532803506411,11,11,5,2,9,2,9
1397,1,1,3.0566031759374046,0.9550667499064576,11,17,11,0,17,11,0
1398,0,0,5.2393890219629515,0.0052755174791433435,23,32,20,7,25,6,17
1399,0,0,1.206217306797516,0.2303710391678484,19,23,14,6,17,9,10
1400,1,1,1.301739559815678,0.7861276025388346,6,7,3,1,6,5,1
1401,1,1,6.158023631515981,0.9978880378337782,31,48,29,12,36,18,13
1402,0,0,3.907595608475784,0.01969313391641858,18,24,14,2,22,3,15
1403,1,1,3.290231269477796,0.9640921611711425,10,17,12,0,17,10,0
1404,1,1,3.313025058989324,0.9648729538397295,21,35,25,4,31,18,3
1405,0,0,5.806515824756374,0.0029988715773405783,32,44,23,6,38,6,26
1406,0,0,1.9079144799090948,0.1292153308139823,17,22,13,4,18,4,13
1407,0,0,2.4580002241276975,0.07885547318442965,16,20,12,1,19,3,13
1408,1,1,2.3418450827427053,0.9122838447982267,8,11,5,1,10,7,1
1409,1,1,0.9062467036865036,0.712231508634301,19,27,13,8,19,10,9
1410,0,0,4.376233805661384,0.012416512400319712,7,6,2,0,6,0,7
1411,1,1,2.5225426775565203,0.9257071129467819,7,8,4,1,7,6,1
1412,0,0,3.678113666717316,0.024647735639640178,32,50,33,10,40,10,22
1413,0,0,4.906017972523387,0.007347518681023124,28,38,21,5,33,7,21
1414,1,1,0.23241489657240955,0.5578435817130334,13,15,8,3,12,6,7
1415,1,1,1.2030977423805977,0.7690753961957901,3,2,1,0,2,3,0
1416,1,1,2.8166509047446473,0.9435690033837619,7,9,5,0,9,7,0
1417,0,1,0.26785785930306805,0.5665669371551277,12,13,7,3,10,5,7
1418,1,0,0.020915907825150182,0.4947712136643516,36,54,36,8,46,14,22
1419,1,0,1.791241755958847,0.1429205480407284,14,17,11,1,16,1,13
1420,0,0,0.2513524219929888,0.43749065000712084,7,7,3,1,6,2,5
1421,0,0,0.6137047204816162,0.35121456498497095,19,27,16,6,21,6,13
1422,0,0,3.393819245308505,0.032489187926552754,18,21,10,3,18,4,14
1423,1,1,2.955427607296002,0.9505193863055071,19,27,15,4,23,13,6
1424,1,1,0.6837470766321003,0.6645744923123353,3,2,1,0,2,3,0
1425,0,0,4.110212831656299,0.01613952546401687,19,25,14,6,19,5,14
1426,0,0,1.3632332218628243,0.20371532149081295,9,8,3,1,7,3,6
1427,0,1,2.3688577468809457,0.9144215160708957,24,35,19,11,24,12,12
1428,1,0,1.2726248486806666,0.21880825240772805,22,30,16,6,24,9,13
1429,0,0,3.9130175741568936,0.01958873330092814,10,11,5,0,11,0,10
1430,0,0,3.059857512261977,0.04479379932207539,31,47,30,10,37,11,20
1431,1,1,1.9350270842725932,0.8738047987915446,28,44,27,8,36,17,11
1432,1,1,2.9944428025245395,0.9523224388444675,11,14,7,2,12,8,3
1433,1,1,5.247850836570822,0.9947687020914727,13,17,11,1,16,11,2
1434,1,1,3.751157590779526,0.9770486029753888,7,9,4,0,9,7,0
1435,1,0,0.877674433929144,0.293659925017557,29,39,24,9,30,13,16
1436,0,0,5.159143723472029,0.005713783342094492,17,26,17,0,26,0,17
1437,1,1,1.4989204433264212,0.8174134089413738,13,17,10,5,12,10,3
1438,1,1,4.1876490819431025,0.9850451097277766,18,29,18,2,27,16,2
1439,0,0,3.8844508832531437,0.020144952618868617,22,28,17,4,24,5,17
1440,0,1,1.2231849029880022,0.7726235474838831,22,29,19,5,24,13,9
1441,0,0,2.948224705855724,0.049820484015960176,9,8,5,1,7,2,7
1442,1,1,1.6489711053023306,0.8387519438747149,8,10,6,1,9,7,1
1443,0,0,1.6377907328882184,0.16276590213853181,17,20,11,3,17,6,11
1444,0,1,0.36382475966763805,0.5899659841881464,13,17,11,5,12,6,7
1445,0,0,0.1138484562968416,0.47156858870327134,27,39,21,8,31,12,15
1446,1,1,1.1082313884635748,0.7517992405698154,5,5,2,1,4,4,1
1447,0,0,2.2148540435043476,0.09842449894688743,6,6,4,0,6,0,6
1448,1,1,1.0424431870756954,0.7393211455084202,11,13,8,3,10,6,5
1449,0,0,1.822703488811935,0.13910979185547567,17,24,14,8,16,7,10
1450,1,1,3.6759698437590913,0.9753006738199128,11,14,9,1,13,10,1
1451,0,0,1.925879379935725,0.1272073723293592,13,14,7,2,12,2,11
1452,0,0,3.357813336297379,0.03364023614774214,7,6,1,2,4,2,5
1453,1,1,0.2964594651737862,0.5735767763699011,8,7,3,3,4,4,4
1454,0,0,3.1841614555756164,0.03976612499189236,15,18,9,3,15,4,11
1455,1,0,0.2597033974641521,0.4354366210672628,1,0,0,0,0,0,1
1456,0,0,1.3208692100325414,0.21067371592947626,9,10,4,2,8,3,6
1457,0,0,5.463724796733901,0.00421985891322052,14,15,6,1,14,1,13
1458,1,1,2.865631446681258,0.9461210902499486,15,22,15,3,19,12,3
1459,0,0,2.7356460263078435,0.060902446043751945,14,20,11,2,18,1,13
1460,1,1,0.08455946295132222,0.5211272783680512,12,14,7,5,9,5,7
1461,0,0,5.4041819095122285,0.004477593431355342,15,16,7,1,15,2,13
1462,1,0,0.24100750085004297,0.4400380829433116,15,19,11,4,15,6,9
1463,1,1,6.073217390023549,0.997701545847626,20,31,22,2,29,19,1
1464,0,0,2.617624234859922,0.06801273173658062,15,17,8,5,12,5,10
1465,0,0,3.640363199933657,0.02557173660076606,15,17,12,2,15,3,12
1466,1,1,4.570368155064575,0.9897519626023905,23,37,27,4,33,20,3
1467,1,1,2.3985505946870354,0.9167167123108129,8,9,5,1,8,7,1
1468,1,1,5.373833343189119,0.9953850717262025,18,25,13,6,19,13,5
1469,0,0,2.6383689551037026,0.06670951163727201,14,18,12,1,17,2,12
1470,1,1,2.014163737118986,0.8822761772574557,7,8,5,0,8,7,0
1471,0,0,2.55508063867616,0.07208590412869653,13,15,7,2,13,3,10
1472,1,0,1.269423942556986,0.21935587957033598,20,30,18,8,22,9,11
1473,1,0,1.8547144245302818,0.13532031918160392,15,18,9,3,15,4,11
1474,0,0,0.6578144375976935,0.3412307385784523,20,28,19,8,20,13,7
1475,1,1,2.588630031795734,0.9301262333882861,8,9,4,1,8,7,1
1476,0,1,1.4102402590706842,0.8038038360311609,16,19,10,4,15,10,6
1477,1,0,3.0215832176119335,0.04646028485547549,23,32,17,7,25,8,15
1478,0,1,1.159763953600533,0.7612898213360599,17,22,13,6,16,7,10
1479,0,0,1.3696890060475742,0.20267009682974402,14,18,7,5,13,6,8
1480,0,0,3.526271126340536,0.028573909934265895,15,17,10,2,15,3,12
1481,0,0,0.946379988964754,0.27961341784011595,19,23,13,5,18,5,14
1482,1,1,0.9263719758150843,0.7163386587142049,5,5,2,1,4,4,1
1483,0,0,2.2906217082212987,0.091902651139394,22,33,20,7,26,7,15
1484,1,1,3.7177711792522903,0.976287879702392,20,29,19,3,26,13,7
1485,1,1,1.9823531505247447,0.8789317858681405,8,9,5,1,8,7,1
1486,1,1,0.9814842477683676,0.727402624246669,10,10,4,3,7,6,4
1487,0,0,3.6755707332014125,0.02470894228588172,16,19,11,4,15,6,10
1488,0,0,2.315759710396221,0.08982613195079825,10,12,5,1,11,2,8
1489,1,1,5.2135034578759925,0.9945868888258845,12,18,12,0,18,12,0
1490,0,1,0.9751151728336738,0.7261378853178141,4,3,1,1,2,3,1
1491,1,1,3.7114035101613023,0.9761400211498552,12,18,10,1,17,11,1
1492,0,0,1.303323316368716,0.21360623956276759,14,16,9,4,12,4,10
1493,0,0,0.3639749452860581,0.4099976854823171,21,26,13,7,19,8,13
1494,1,1,0.7472730633457709,0.6785842232322431,16,19,9,6,13,8,8
1495,1,1,4.042567741967726,0.9827504258594443,11,16,9,1,15,10,1
1496,1,1,0.676221965956519,0.6628949584080628,23,31,16,10,21,11,12
1497,1,1,0.17482199902380446,0.5435945256236043,18,27,17,7,20,11,7
1498,1,1,1.0467398854871481,0.7401483764758765,18,22,11,6,16,8,10
1499,0,0,2.3800747363934183,0.08470477124780285,18,26,16,3,23,4,14
1500,0,0,3.5389646439791598,0.028223670912041476,10,9,4,1,8,1,9
1501,1,1,1.5304868440791515,0.8220775341460066,15,19,12,3,16,10,5
1502,1,1,1.4662838345967102,0.8124918899679299,12,12,8,4,8,6,6
1503,1,1,3.512346858387267,0.971037040473095,12,17,10,2,15,10,2
1504,0,0,1.5869033581273744,0.16982001889846732,16,23,14,9,14,7,9
1505,0,0,2.507260830381093,0.07535073379814661,11,11,4,2,9,2,9
1506,1,0,0.7882643165681928,0.3125414757541791,15,20,11,8,12,7,8
1507,1,0,0.9632412112863555,0.27622971991226886,31,43,24,11,32,11,20
1508,1,0,0.15077536393347502,0.46237740555614815,6,5,2,1,4,2,4
1509,0,0,2.1976719382323577,0.09995974472347346,11,13,9,0,13,0,11
1510,1,1,2.5189328651026526,0.9254584718536378,31,48,26,15,33,17,14
1511,1,1,0.09287192662444399,0.5232013077364105,9,10,5,4,6,5,4
1512,1,1,2.8976630530450214,0.9477307923129328,11,14,9,2,12,9,2
1513,1,1,2.1640308190754425,0.896972643990195,13,17,10,3,14,9,4
1514,1,1,3.0566952125737092,0.9550706994245455,21,29,17,5,24,11,10
1515,1,1,0.2561709354545396,0.5636947910569754,11,13,7,3,10,5,6
1516,0,0,1.8102358485404721,0.14060962372098273,10,10,3,1,9,1,9
1517,1,1,1.9705763259076023,0.8776730027840604,8,9,4,2,7,6,2
1518,0,0,4.026657651143978,0.017521364197529588,26,34,18,5,29,6,20
1519,1,0,1.7437771772714077,0.14883379806671382,18,25,15,8,17,6,12
1520,0,0,4.015611051155201,0.01771254139504108,10,11,7,0,11,0,10
1521,0,0,3.820776914578574,0.021440983003191638,7,8,4,1,7,1,6
1522,1,1,2.864623295110458,0.9460696756230943,19,26,15,5,21,10,9
1523,0,0,0.23651741483655542,0.4411447567451111,14,16,9,3,13,4,10
1524,0,0,3.683179914532417,0.024526234768078137,24,35,21,5,30,5,19
1525,1,1,1.0604472860133973,0.7427760129618516,10,11,6,3,8,4,6
1526,0,0,2.9045674612258163,0.05192823846704442,31,48,28,10,38,10,21
1527,0,0,4.9994274520554525,0.006696658330734406,19,24,12,5,19,6,13
1528,1,1,3.061097787032785,0.9552592387539849,10,10,6,1,9,7,3
1529,1,1,1.5438841713124825,0.8240286601919172,22,30,18,8,22,12,10
1530,0,0,0.2649907950539738,0.4341372584095119,11,11,4,3,8,4,7
1531,1,1,2.6398957343113896,0.9333854817876063,11,13,8,3,10,8,3
1532,0,0,6.253718193273172,0.001919597719897026,27,38,23,6,32,5,22
1533,0,0,1.9076961731990663,0.12923989639590594,14,16,9,3,13,4,10
1534,0,0,5.650725029823267,0.0035026556741570847,36,58,37,10,48,11,25
1535,0,0,3.542403684082418,0.028129500911003746,20,28,17,6,22,5,15
1536,0,0,4.518473379691969,0.010788009408308152,14,16,6,3,13,2,12
1537,0,0,0.7960684202822517,0.3108671494262506,28,44,25,12,32,12,16
1538,0,1,0.09075111630818,0.5226722209552752,7,8,5,2,6,3,4
1539,0,0,4.171737088124696,0.015191111878862018,22,31,17,9,22,8,14
1540,1,1,5.854731316302554,0.997141886599267,42,69,45,15,54,23,19
1541,1,1,3.8074899832320357,0.9782784605257899,12,19,12,0,19,12,0
1542,1,1,3.9698872547068724,0.9814741251378786,12,19,12,0,19,12,0
1543,1,1,0.09439435024092324,0.5235810806310877,15,21,11,9,12,8,7
1544,0,0,2.399315918376847,0.08322487601408413,6,5,1,0,5,0,6
1545,1,1,1.8450933760518566,0.8635499791928917,6,6,4,0,6,6,0
1546,1,1,3.338227547288783,0.9657172092778474,8,11,7,0,11,8,0
1547,1,1,0.9410423723034131,0.7193101636691464,16,23,13,6,17,8,8
1548,1,1,5.459895031339071,0.995764017620309,18,25,15,2,23,16,2
1549,0,0,4.023009492419865,0.01758427560128828,29,43,26,11,32,10,19
1550,0,0,4.034783247543237,0.017382034206810615,22,29,16,5,24,5,17
1551,0,0,4.88450455364163,0.007506102156748851,13,16,11,0,16,0,13
1552,0,1,0.1377060072285854,0.5343722024523387,18,25,17,5,20,9,9
1553,1,1,3.393605551758203,0.9675040942360762,9,11,5,1,10,8,1
1554,0,0,3.706862772308428,0.02396596468575407,40,62,41,9,53,14,26
1555,1,1,7.0659615391727275,0.9991470544522575,25,39,24,7,32,17,8
1556,1,0,0.8201976337092634,0.30572170935149745,8,8,3,1,7,1,7
1557,1,0,0.29041430500972676,0.4279024413693302,13,17,9,4,13,7,6
1558,1,0,0.7801288241582189,0.31429212217033675,18,23,12,4,19,6,12
1559,1,0,1.47963887209374,0.1854819717261016,13,16,8,3,13,4,9
1560,1,1,0.8577417407311185,0.7021886234343961,10,12,7,2,10,7,3
1561,0,1,0.44931373972805755,0.6104760570375565,5,4,1,2,2,3,2
1562,1,1,1.1721115780741844,0.7635264812861036,6,7,3,1,6,5,1
1563,0,1,1.3906615531893727,0.8006978353477043,17,23,15,7,16,11,6
1564,0,0,3.432183057055893,0.031304663958600654,6,5,2,0,5,0,6
1565,0,1,1.3743398548367156,0.798080417557188,11,15,8,5,10,8,3
1566,0,0,1.506594460199839,0.18144404247088708,9,8,4,2,6,2,7
1567,1,1,0.669568625953193,0.661406560608812,4,3,1,1,2,3,1
1568,1,0,0.2869161155955555,0.42875902009652755,33,50,33,12,38,19,14
1569,0,0,2.8555591017335185,0.054394670535688694,25,36,21,6,30,8,17
1570,1,1,2.3371773320696363,0.9119096023807739,15,21,12,4,17,11,4
1571,0,0,5.1532659203082645,0.005747273143451914,19,23,12,2,21,3,16
1572,0,0,0.4600931238979009,0.3869637325161237,20,28,17,6,22,10,10
1573,0,0,5.174810898595894,0.005625461764117268,25,35,22,7,28,7,18
1574,1,1,0.9530416380206272,0.7217264644059468,24,35,23,9,26,10,14
1575,1,0,0.5957032773144917,0.3553273303007126,2,1,0,0,1,0,2
1576,1,1,0.8578015951501083,0.7022011400246853,11,14,6,5,9,5,6
1577,1,0,1.5126713785850343,0.18054323237418257,24,31,19,7,24,7,17
1578,0,0,1.3669716452753393,0.2031095633476354,10,10,4,1,9,2,8
1579,1,1,3.2616761000064605,0.9630904177421161,14,20,10,2,18,11,3
1580,0,0,3.970683565118411,0.018511401365165825,9,9,5,0,9,0,9
1581,0,0,0.20655597523191394,0.44854382595962883,18,24,15,7,17,9,9
1582,0,0,2.9055345648504316,0.05188064694152916,18,24,14,5,19,6,12
1583,0,0,3.2412746323528436,0.037641689993847316,24,35,20,6,29,6,18
1584,1,1,0.9891988825407987,0.7289296576138418,44,69,41,20,49,20,24
1585,0,0,8.879700014304195,0.0001391665430602318,25,30,15,3,27,4,21
1586,0,0,2.962536595172577,0.04914733058964116,12,13,7,3,10,4,8
1587,1,1,2.9932450415899505,0.9522680257412257,7,9,4,1,8,6,1
1588,0,0,5.90667638211008,0.002713831235450437,18,24,15,0,24,0,18
1589,1,1,1.468019081164654,0.8127561093933078,28,43,26,13,30,14,14
1590,1,1,4.16453857281887,0.984700819186716,23,31,14,7,24,14,9
1591,1,1,0.08653223273349564,0.5216195695663535,27,37,22,8,29,11,16
1592,0,0,2.3535910140150023,0.08678076246290445,17,23,14,9,14,7,10
1593,0,0,3.27711441381505,0.036364698802628936,20,27,14,7,20,7,13
1594,1,1,4.585633442703741,0.9899056466877785,16,24,18,1,23,15,1
1595,1,1,2.898067723678299,0.9477508349061213,9,11,8,1,10,8,1
1596,0,0,3.2628149774512796,0.036869119624052926,13,16,8,5,11,5,8
1597,1,1,2.9846693539160825,0.9518767142748886,16,24,17,2,22,13,3
1598,0,0,1.5184916195608273,0.1796837434951507,8,8,4,3,5,3,5
1599,1,1,6.024974052794464,0.9975882164654684,20,28,18,3,25,15,5
1600,0,0,2.8318587480467645,0.05562667284229972,20,25,15,5,20,7,13
1601,0,0,2.726126395284326,0.06144918679246825,29,42,22,8,34,9,20
1602,1,1,2.573781739972601,0.9291550369297625,8,10,6,1,9,7,1
1603,0,0,0.7738499209528777,0.3156468800789459,12,14,9,1,13,2,10
1604,0,1,1.6647862170435332,0.8408794499539567,13,18,11,2,16,9,4
1605,1,1,0.47565430189747504,0.6167211777027032,5,5,2,1,4,4,1
1606,1,1,0.998397148532344,0.7307433222157178,6,6,3,2,4,3,3
1607,1,0,0.7189824232755413,0.32761709960916885,11,12,6,4,8,5,6
1608,1,1,3.563977433406422,0.9724543212920769,11,14,6,3,11,8,3
1609,1,0,0.25519420249277314,0.4365454444786738,26,38,23,10,28,12,14
1610,0,1,0.4249286748219807,0.6046620348528849,7,8,4,4,4,5,2
1611,0,0,2.6377889156746033,0.06674563359402352,30,41,24,6,35,9,21
1612,1,0,2.119682851273383,0.10719842003285096,24,33,22,7,26,11,13
1613,1,1,3.9034064589191813,0.9802258303026048,12,18,14,0,18,12,0
1614,0,0,5.057242186790944,0.006322850706418248,21,27,16,3,24,3,18
1615,1,1,4.5996575152198025,0.9900448231451469,11,15,8,1,14,10,1
1616,0,0,3.0242565257637306,0.04634199617783963,22,34,21,10,24,8,14
1617,0,1,0.6276912560559189,0.6519657773775549,9,10,5,2,8,5,4
1618,0,0,0.9202099194945965,0.2849151236859462,6,6,3,1,5,2,4
1619,0,0,0.5947373465700496,0.3555486267887641,6,5,2,1,4,2,4
1620,0,1,1.7339710104237218,0.8499196515516015,20,28,17,5,23,12,8
1621,1,1,5.565135013725381,0.9961855422667978,12,17,8,1,16,11,1
1622,0,0,3.042179637259013,0.04555630420521506,7,9,4,0,9,0,7
1623,1,1,2.6255518385882586,0.9324880576433887,8,9,3,2,7,6,2
1624,0,0,0.2597033974641521,0.4354366210672628,1,0,0,0,0,0,1
1625,0,0,2.636566325610375,0.06682182987979501,18,22,10,6,16,5,13
1626,1,0,0.0761921467221991,0.48096117284695206,26,36,24,8,28,12,14
1627,1,1,1.0741937797674181,0.7453936383418651,11,12,7,3,9,5,6
1628,1,1,1.8355635659724931,0.8624231728461947,11,14,6,2,12,8,3
1629,0,0,1.004696719160208,0.2680189930667902,5,4,2,0,4,0,5
1630,1,1,2.2666210733056356,0.9060746239025333,10,13,7,3,10,7,3
1631,1,1,2.5077639711778317,0.9246843140419403,22,28,16,6,22,13,9
1632,1,1,1.4645521202037464,0.8122279225466951,25,37,23,9,28,12,13
1633,1,1,1.8954224032724445,0.8693725542290314,5,5,2,0,5,5,0
1634,1,1,1.7242183533650237,0.8486713893283958,12,16,11,1,15,9,3
1635,0,1,1.0594423288050885,0.7425839591900354,10,12,5,3,9,6,4
1636,1,0,0.10023168943215066,0.4749630350625562,4,3,1,1,2,1,3
1637,1,1,6.8773718020651895,0.9989702117916753,26,40,25,7,33,20,6
1638,0,0,4.560584223906,0.010347752970974455,18,24,16,6,18,7,11
1639,0,0,0.903400393370452,0.288352217049477,11,12,6,4,8,5,6
1640,1,1,1.8889124111077937,0.8686314746325292,13,16,10,5,11,8,5
1641,1,1,1.1251717631255582,0.754946764806144,23,33,21,5,28,14,9
1642,1,0,2.4246970656454514,0.08130870521280209,28,42,26,6,36,9,19
1643,1,1,1.1927838453114346,0.7672385829866226,18,23,12,7,16,9,9
1644,1,1,1.8709667821469145,0.8665701025886188,10,12,5,2,10,7,3
1645,0,0,5.172440513840305,0.005638736810408496,13,14,7,3,11,3,10
1646,1,1,0.9719069572506984,0.7254994316015613,22,29,17,9,20,11,11
1647,1,1,1.749997801310669,0.8519525246491142,12,16,10,3,13,9,3
1648,0,1,1.521799996544819,0.8208033863186142,35,55,34,13,42,21,14
1649,0,0,4.2378190154284185,0.014233530231212987,19,25,15,4,21,4,15
1650,0,1,1.0731914435793595,0.7452033662285336,18,26,14,7,19,11,7
1651,1,1,1.9655607929927703,0.8771334987928581,21,35,24,4,31,16,5
1652,0,0,1.9804746758548342,0.12126824626633848,15,21,13,8,13,6,9
1653,1,1,1.278963259946805,0.7822732486531454,20,28,18,8,20,9,11
1654,0,1,1.2505466935932745,0.777394482105999,9,10,4,2,8,6,3
1655,0,0,5.978974689638857,0.00252502854480674,16,22,14,1,21,1,15
1656,0,0,3.52242600105902,0.028680834464273497,29,38,21,8,30,8,21
1657,0,0,3.0074447410837886,0.047090675571363594,17,22,13,7,15,6,11
1658,0,0,1.5947164953920212,0.1687213534486507,18,22,11,2,20,3,15
1659,0,0,5.353971888255948,0.004707068003329984,22,26,13,2,24,2,20
1660,1,0,3.753439297335361,0.022900286253894953,8,9,4,0,9,0,8
1661,1,1,1.2779825336353936,0.7821061633283297,8,9,4,3,6,4,4
1662,1,1,4.828437489955601,0.9920644663731244,22,33,20,5,28,15,7
1663,1,1,2.123698631770659,0.8931853121283331,21,31,20,3,28,13,8
1664,1,1,4.100917029279611,0.9837122002563122,14,21,13,2,19,12,2
1665,1,1,3.253408331274871,0.9627953932893056,12,14,8,2,12,8,4
1666,0,1,1.073935956697563,0.7453447050781061,9,9,4,3,6,4,5
1667,0,1,2.2152526760590248,0.9016108688945484,14,18,8,3,15,9,5
1668,1,1,3.089164390798116,0.9564435674497158,7,10,5,0,10,7,0
1669,1,0,1.2783079361010286,0.21783838793901666,31,47,28,9,38,13,18
1670,0,0,8.177062509532336,0.0002809472871917462,39,59,36,7,52,9,30
1671,0,0,7.632356721995135,0.0004842829947153682,19,26,14,3,23,2,17
1672,0,1,2.5870088219408656,0.9300207951506537,5,5,2,0,5,5,0
1673,1,1,1.536689163120583,0.8229829114184128,7,8,4,1,7,6,1
1674,0,0,1.7030764512497663,0.15406388985682495,26,37,24,10,27,14,12
1675,1,1,1.952546338734871,0.8757240287919287,6,7,3,1,6,5,1
1676,1,1,2.259242513657776,0.9054447991383496,18,26,18,4,22,14,4
1677,0,0,0.7046342382599834,0.33078555959711853,9,9,6,1,8,2,7
1678,1,0,1.7453906315502776,0.1486295177575696,17,23,14,5,18,4,13
1679,1,1,2.8969788170399355,0.9476968868340475,20,27,16,5,22,13,7
1680,0,1,0.47012726166969787,0.6154138770793323,8,8,4,3,5,3,5
1681,1,1,1.645963930269434,0.8383448176835103,9,10,4,2,8,7,2
1682,1,1,1.4275763550244065,0.806523402893908,14,18,12,4,14,8,6
1683,1,1,1.8932556987070972,0.8691262977854679,13,17,10,2,15,11,2
1684,1,1,4.461048239424423,0.9885816354470045,18,27,16,3,24,14,4
1685,0,0,5.532652699858755,0.003939898253628171,16,17,8,1,16,2,14
1686,0,1,0.8322119908983763,0.6968224404206294,13,17,12,4,13,9,4
1687,1,1,5.322111590523784,0.9951412891975012,16,25,18,1,24,15,1
1688,0,0,0.011799387624284563,0.4970501873179568,14,20,9,7,13,7,7
1689,0,0,2.075668636640498,0.1114842908094077,11,12,5,2,10,4,7
1690,1,1,2.0262107359499195,0.8835216868942636,11,14,8,5,9,8,3
1691,1,1,3.305810007739432,0.9646275912187878,20,27,19,4,23,14,6
1692,1,1,1.8975113123198624,0.8696095959368246,12,15,7,3,12,8,4
1693,1,1,0.9892936235125811,0.7289483771912463,3,2,1,0,2,3,0
1694,1,1,3.612910413678784,0.9737352167583185,24,35,22,7,28,14,10
1695,1,1,7.45188607353063,0.9994199906020536,25,42,27,3,39,20,5
1696,0,0,4.360322373379025,0.012613145193064557,16,17,8,1,16,1,15
1697,1,1,0.43163840487330996,0.6062648364459756,6,6,2,2,4,4,2
1698,0,0,1.6965950636497855,0.15491049272969082,17,22,12,4,18,5,12
1699,1,1,1.294911832619213,0.7849774074169715,21,30,18,7,23,10,11
1700,0,0,1.5741694176027958,0.17162282036469045,17,22,11,6,16,6,11
1701,1,0,0.22919128342254735,0.44295168335252744,7,6,1,1,5,2,5
1702,0,0,0.1113384237686037,0.4721941121740123,18,25,16,7,18,9,9
1703,0,0,5.019329928648722,0.006565562199913777,22,28,17,7,21,6,16
1704,1,1,0.6804683377139895,0.6638432175126194,18,25,14,8,17,8,10
1705,0,0,2.1976988682737857,0.0999573219131511,6,5,1,0,5,0,6
1706,0,0,4.056875701041317,0.017008693157647192,19,24,15,5,19,4,15
1707,1,1,2.808903506420937,0.9431550607893014,5,5,4,0,5,5,0
1708,1,0,7.474923184371308,0.0005668078769895946,17,19,11,3,16,3,14
1709,0,0,2.7485050917191707,0.06017113252220019,22,33,22,9,24,8,14
1710,0,0,9.064558850619758,0.00011568095566949488,18,22,12,0,22,0,18
1711,1,1,3.6417274267231425,0.9744622349681427,12,16,10,2,14,10,2
1712,1,0,3.8272427390192716,0.021305740760948377,14,16,10,4,12,7,7
1713,1,1,4.978197338528444,0.9931606337179817,10,15,9,0,15,10,0
1714,0,0,2.5641286738753113,0.07148302367254689,12,13,7,3,10,4,8
1715,0,0,2.7749799402607844,0.058691283214999834,23,33,19,10,23,9,14
1716,0,0,1.7550193061742405,0.14741523456041183,23,35,20,13,22,10,13
1717,0,1,1.6516645400228733,0.839115890877437,8,11,6,3,8,7,1
1718,0,0,1.8386325820691627,0.13721309495943934,17,22,12,3,19,4,13
1719,0,0,0.6517443719146603,0.3425965548336183,28,40,27,8,32,14,14
1720,1,1,0.4659690780028007,0.6144292485621526,13,16,10,3,13,7,6
1721,0,0,7.4495513431615406,0.0005813643573555627,29,42,25,4,38,4,25
1722,0,0,2.2053694443377894,0.09926934643951102,6,6,3,0,6,0,6
1723,1,1,2.9432446333697824,0.9499432380743908,9,11,6,1,10,8,1
1724,1,1,3.9999128439961957,0.9820122505623455,9,12,8,1,11,8,1
1725,1,1,1.6628908296186289,0.8406256809570766,16,21,12,5,16,10,6
1726,0,1,3.5012834378321083,0.9707242648839609,24,35,21,6,29,15,9
1727,1,0,1.005626006284038,0.26783672035363026,12,15,10,2,13,3,9
1728,0,0,2.7710519072738453,0.05890867030259872,25,36,24,9,27,9,16
1729,0,0,3.0244483208479243,0.046333520643661585,18,24,15,2,22,3,15
1730,0,1,0.709610253072716,0.670315034266447,9,11,5,5,6,6,3
1731,1,1,0.6738476884449882,0.662364184900395,17,23,14,5,18,7,10
1732,0,1,1.0648805124187688,0.7436221123191777,4,3,1,1,2,3,1
1733,0,0,1.9875567646241388,0.12051558483398994,7,7,3,0,7,0,7
1734,1,1,0.9606959210522126,0.7232611184756161,6,6,2,2,4,4,2
1735,1,1,0.17103044303513937,0.5426536880279138,6,5,1,2,3,3,3
1736,0,0,3.848066892728391,0.02087582069646632,21,28,16,4,24,4,17
1737,0,0,5.5324285941936555,0.003940777826177855,23,30,15,4,26,5,18
1738,1,1,0.6453228843703029,0.655955712716078,11,12,7,3,9,5,6
1739,0,0,2.804957650970132,0.05705686099224405,11,13,7,4,9,4,7
1740,0,0,1.9545569041196549,0.12405732369736455,12,13,5,3,10,4,8
1741,0,0,2.5362089978819675,0.07335845791294426,14,17,9,2,15,3,11
1742,0,1,0.12136870681849743,0.5303049855478452,18,26,16,7,19,7,11
1743,0,0,7.210456463256308,0.0007382743826167548,23,30,17,4,26,4,19
1744,0,0,4.808766193647169,0.008091905673657696,17,22,12,4,18,5,12
1745,0,0,2.395072368542501,0.0835492256442304,16,20,11,5,15,5,11
1746,0,1,1.585552834779594,0.8299894978156876,10,11,8,2,9,7,3
1747,1,1,1.3182139117332106,0.7888843944951959,11,13,6,3,10,7,4
1748,1,1,1.2650414945860273,0.7798927520460545,39,59,38,13,46,21,18
1749,0,0,5.530217760218433,0.003949465422218079,16,20,12,5,15,4,12
1750,0,0,5.977636969063143,0.0025284000416171404,22,30,18,6,24,5,17
1751,0,0,4.839727049355617,0.007847147821385625,18,27,16,2,25,1,17
1752,0,0,2.1863037994133347,0.10098717247851496,8,8,3,0,8,0,8
1753,0,0,1.7509123518557603,0.1479321607460281,13,16,8,4,12,4,9
1754,0,0,1.6358035406942277,0.16303688461422383,5,4,1,0,4,0,5
1755,1,1,1.8806936070554485,0.8676907752810843,49,79,50,19,60,24,25
1756,1,1,3.0978626616727123,0.9568044958037105,7,9,4,0,9,7,0
1757,1,1,1.6214573008136417,0.8349960113562426,19,29,19,5,24,12,7
1758,0,0,3.5791990644813176,0.02714085728082649,20,25,14,4,21,4,16
1759,1,1,2.5692060505951315,0.9288532457151444,21,26,15,7,19,13,8
1760,0,1,2.3016250833800806,0.909011538288096,19,27,16,7,20,11,8
1761,0,0,7.344187334263207,0.0006459209281693967,21,27,17,2,25,3,18
1762,1,1,2.929314251270361,0.9492766661111707,14,19,11,3,16,11,3
1763,0,0,5.068393066969885,0.006253175430417701,16,21,10,1,20,1,15
1764,0,0,1.0579058207718455,0.25770985842246963,16,20,11,7,13,6,10
1765,1,1,0.05574242200059809,0.5139319982077744,4,3,0,2,1,2,2
1766,0,0,1.683376600483718,0.15664886884734663,8,8,4,1,7,2,6
1767,1,1,2.005810528431037,0.8814057976056238,12,15,9,2,13,6,6
1768,1,1,3.5811907886665657,0.9729116831647189,14,19,12,2,17,11,3
1769,0,1,1.0983106240733616,0.7499434336228954,26,35,22,10,25,13,13
1770,0,0,0.26292353106700217,0.4346451757952454,16,24,14,6,18,6,10
1771,0,0,2.5483109644366757,0.07254003825260502,17,20,12,3,17,5,12
1772,1,1,0.9683087046191226,0.7247822584238086,3,2,1,0,2,3,0
1773,1,1,3.4464194807100856,0.9691241823218462,12,15,9,2,13,10,2
1774,1,0,1.0341247994019374,0.2622852076050274,11,12,6,4,8,5,6
1775,0,0,1.2294878441148132,0.226271077559568,15,20,11,3,17,4,11
1776,1,1,1.7719145764432664,0.854695605785097,4,4,2,0,4,4,0
1777,1,1,2.1655785138303596,0.8971155828230318,27,40,22,12,28,13,14
1778,0,0,3.506987723856899,0.029114061469877273,22,28,15,4,24,5,17
1779,1,1,0.628713373480476,0.6521976663265272,24,35,25,7,28,14,10
1780,1,1,4.53991323294477,0.9894384052820386,15,20,13,2,18,13,2
1781,1,1,4.41364035087393,0.9880339117510029,7,8,3,1,7,6,1
1782,1,0,0.5957032773144917,0.3553273303007126,2,1,0,0,1,0,2
1783,0,1,4.143193830026583,0.9843759090386748,14,22,13,1,21,13,1
1784,1,1,2.493607095757312,0.9236924366603343,4,4,2,0,4,4,0
1785,0,1,1.158649539586731,0.7610872425523653,28,39,23,10,29,13,15
1786,1,1,3.0974235021672945,0.9567863418523366,17,26,19,2,24,15,2
1787,1,1,1.1395200492641617,0.7575915085732057,42,67,42,18,49,20,22
1788,1,1,2.962270158261574,0.9508402168193625,10,12,7,2,10,7,3
1789,0,0,2.2695428551884875,0.09367701737044154,22,30,18,6,24,8,14
1790,0,0,0.2597033974641521,0.4354366210672628,1,0,0,0,0,0,1
1791,0,0,5.35222202230468,0.004715273079688442,22,29,18,1,28,2,20
1792,0,0,3.38723928246296,0.032696657584159294,9,10,5,0,10,0,9
1793,1,0,0.951681014667785,0.2785468820392588,29,43,24,9,34,10,19
1794,1,1,1.5586399412933551,0.8261581067801089,18,23,11,5,18,12,6
1795,0,0,4.229968345549302,0.01434410359832028,27,39,26,5,34,8,19
1796,0,0,4.296786568610527,0.01342942632583044,13,15,6,3,12,2,11
1797,0,0,3.6758365105860222,0.024702538282378894,8,8,3,0,8,0,8
1798,1,0,0.06479437285663536,0.4838070716349141,15,21,12,7,14,6,9
1799,0,0,9.041552145675087,0.00011837292618865902,28,41,24,10,31,8,20
1800,0,0,1.0627495627223578,0.25678436041127295,21,28,17,7,21,8,13
1801,1,0,0.6079575429429678,0.35252525064794926,22,30,19,5,25,10,12
1802,0,0,3.681047777276679,0.02457729725579083,9,11,5,0,11,0,9
1803,0,1,0.049167812904774344,0.5122894775350844,16,22,12,7,15,7,9
1804,0,0,1.1298599789647845,0.2441869422169235,14,20,12,4,16,4,10
1805,1,1,3.083012174779132,0.956186549692093,5,6,3,0,6,5,0
1806,0,0,0.4032236129403395,0.400538079225187,13,15,9,3,12,4,9
1807,0,1,0.43161345960256003,0.606258881799876,7,7,3,2,5,4,3
1808,1,1,2.630361054252948,0.9327901883984202,16,20,12,4,16,11,5
1809,0,0,5.971508673741833,0.002543902860950964,20,29,18,3,26,2,18
1810,1,1,0.7973255264851846,0.6894020948318749,16,21,13,4,17,8,8
1811,0,0,1.493356319691183,0.18341849653746645,6,5,2,0,5,0,6
1812,0,0,5.4713125730080305,0.004188094331588732,18,24,11,4,20,4,14
1813,1,1,2.673938571580588,0.9354711908118332,20,29,18,7,22,15,5
1814,0,1,0.2759641354061627,0.56855650151425,21,29,18,8,21,9,12
1815,0,0,0.3516014582459479,0.41299412557497006,9,10,5,2,8,3,6
1816,1,1,5.082559911550623,0.993834245422702,12,19,12,0,19,12,0
1817,1,1,1.0124177224366193,0.7334930347686808,8,9,4,3,6,4,4
1818,0,0,3.8919912598784174,0.01999664942431323,14,17,9,4,13,4,10
1819,0,0,8.052755275786648,0.00031812268455999604,25,31,17,5,26,5,20
1820,0,0,1.756412881566097,0.14724017050096383,14,17,8,3,14,4,10
1821,0,1,2.5569784114636027,0.9280409339533537,28,41,22,11,30,16,12
1822,1,1,4.428107245519012,0.9882037503344373,15,21,13,2,19,12,3
1823,0,0,3.593258201988193,0.026772094172558436,20,27,15,5,22,5,15
1824,1,1,1.3591027002377392,0.7956138242913572,10,11,5,3,8,7,3
1825,1,0,0.14604576982702655,0.4635533165824557,16,21,12,4,17,5,11
1826,1,1,3.374903735350716,0.9669109418419406,15,24,19,0,24,15,0
1827,0,0,8.872966994071701,0.00014010658403518228,27,40,25,4,36,4,23
1828,1,1,1.2670620477835097,0.7802394041406739,4,3,1,0,3,4,0
1829,1,0,1.3152217850643004,0.2116143623971064,20,28,14,6,22,6,14
1830,1,1,0.5091167875674754,0.6245994060447734,19,31,19,7,24,12,7
1831,0,0,5.247973216584714,0.005230661089886568,14,15,7,3,12,3,11
1832,0,0,4.746656134352579,0.008605968131155106,13,15,6,1,14,2,11
1833,0,0,4.658992033468402,0.009387057249723996,25,34,21,6,28,7,18
1834,1,1,7.020274919728834,0.9991072179756179,21,35,28,1,34,20,1
1835,0,0,0.5395336139680003,0.36829608220962184,10,10,4,3,7,4,6
1836,0,0,2.2480878452279356,0.09551453110962427,18,23,13,2,21,6,12
1837,1,1,1.2336922316588612,0.7744641477558547,26,37,25,10,27,17,9
1838,0,0,2.0352126285321925,0.11555511181063327,10,11,7,2,9,3,7
1839,1,1,2.53272372098062,0.9264042708645089,18,26,17,7,19,12,6
1840,1,1,1.0933795304687952,0.749017574881064,13,15,10,2,13,7,6
1841,0,0,1.9636004740241795,0.12307792165354725,14,18,11,4,14,4,10
1842,1,1,3.6855268118728444,0.9755298514317139,11,14,6,2,12,9,2
1843,0,0,3.2935783380613306,0.03579214826484689,13,15,7,1,14,2,11
1844,1,1,1.535037281160328,0.8227421334789511,19,24,14,4,20,11,8
1845,0,0,0.9929362082711193,0.2703325118013403,17,21,15,3,18,8,9
1846,1,0,0.3389591899724438,0.4160623243973134,7,7,3,1,6,2,5
1847,0,0,1.8949590484902012,0.13068007516122904,21,27,14,4,23,5,16
1848,1,1,1.3763742792246614,0.7984080623060066,15,21,13,4,17,8,7
1849,1,1,0.6450941125050298,0.6559040821393711,6,5,2,1,4,4,2
1850,0,0,2.363106921211002,0.08602958753870305,20,28,17,6,22,6,14
1851,1,0,0.5058342666466493,0.37617057724069825,10,12,6,3,9,2,8
1852,1,1,1.0906798946120446,0.7485097285737757,16,23,13,8,15,10,6
1853,1,1,2.562904972010293,0.9284357127149726,8,9,3,2,7,6,2
1854,1,0,1.2235511293384094,0.22731212161243564,22,31,18,6,25,9,13
1855,1,1,1.1512211148475817,0.7597338878774844,8,10,7,3,7,7,1
1856,1,0,0.2597033974641521,0.4354366210672628,1,0,0,0,0,0,1
1857,1,1,4.196245549897595,0.9851712197590808,16,21,13,3,18,12,4
1858,1,1,0.5302390263760146,0.6295388593491094,8,9,6,4,5,6,2
1859,1,1,1.4449475270493686,0.809219635348591,19,28,16,7,21,12,7
1860,0,0,2.0122222648536665,0.11792562332109757,8,9,6,0,9,0,8
1861,1,1,4.484273784325973,0.9888408519305243,18,27,17,2,25,14,4
1862,1,1,3.169148703077604,0.9596566388515234,17,21,11,5,16,10,7
1863,1,1,6.563086943563247,0.9985904678948653,19,27,15,2,25,17,2
1864,0,0,3.002879252361976,0.047295967539879524,25,35,22,4,31,9,16
1865,0,0,4.378517185859497,0.012388543960490717,23,33,20,4,29,4,19
1866,1,1,3.350119146988554,0.9661087372450401,12,16,8,3,13,7,5
1867,1,1,1.9466946994551453,0.875085784957098,15,19,10,4,15,10,5
1868,1,1,2.0807013650126516,0.8890132549374542,34,55,31,13,42,18,16
1869,0,1,1.5223638941201205,0.8208863122955828,16,23,15,6,17,9,7
1870,0,1,0.6309821547940659,0.6527121294440134,19,26,15,7,19,10,9
1871,1,1,1.7401384572096945,0.8507046512537064,36,58,37,15,43,18,18
1872,0,1,0.5366243671782567,0.631026810698482,17,20,12,5,15,9,8
1873,0,0,4.725742210974798,0.008786249928674716,32,48,30,10,38,8,24
1874,1,0,3.5353761476777,0.028322259744032352,27,42,27,9,33,8,19
1875,0,0,1.6957454367796165,0.15502175274367969,11,14,10,4,10,4,7
1876,1,1,1.4822564718315971,0.814913165544882,13,16,10,5,11,8,5
1877,0,0,0.2660790071708342,0.4338699451218594,4,3,0,1,2,1,3
1878,1,1,2.5570898709316934,0.9280483769683987,24,37,24,6,31,14,10
1879,1,1,1.933221459641481,0.8736055581897644,28,41,22,10,31,14,14
1880,0,0,3.3181924934346885,0.034952325700135844,20,27,16,3,24,4,16
1881,0,0,4.141584761875315,0.01564885769298241,18,24,12,4,20,3,15
1882,1,1,0.6519264044398017,0.657444442113341,26,39,24,12,27,12,14
1883,0,0,0.8267117159636062,0.3043408091357409,21,32,22,6,26,7,14
1884,1,1,3.4645896256001674,0.9696632684792545,13,20,12,1,19,12,1
1885,1,1,3.2857816898772185,0.9639378050582759,22,31,21,5,26,17,5
1886,0,0,10.371814643659325,3.130145594743006e-05,42,63,37,13,50,10,32
1887,1,1,0.7341166686595006,0.6757079962945407,18,24,15,5,19,11,7
1888,1,1,3.566172964375773,0.972513071827149,10,14,7,1,13,9,1
1889,0,0,0.36633522562727516,0.4094268561777823,5,5,2,3,2,2,3
1890,0,0,2.1812135638692576,0.1014502482083608,17,20,10,3,17,4,13
1891,1,1,2.2191256527851344,0.9019539016716197,25,38,24,8,30,13,12
1892,0,0,0.8176511262844368,0.30626248794115607,3,2,1,0,2,0,3
1893,1,0,0.5530232118005154,0.36516328559817435,30,43,24,10,33,12,18
1894,0,0,0.03942178986364153,0.49014582867987677,10,13,7,4,9,5,5
1895,1,1,0.2560245117673521,0.5636587788441433,20,27,17,6,21,10,10
1896,0,1,0.12663037953457534,0.5316153594792243,6,5,2,2,3,3,3
1897,1,1,2.603167907300924,0.9310651827083928,26,40,24,11,29,15,11
1898,0,0,7.803910357386574,0.0004079693903530357,14,16,7,1,15,1,13
1899,0,0,2.480075745973449,0.07726680153011223,31,50,31,12,38,14,17
1900,1,1,5.0774810118170635,0.9938030450679423,18,24,13,4,20,13,5
1901,1,0,2.205924009178097,0.09921977107422042,20,28,16,2,26,5,15
1902,1,1,3.362712618533526,0.9665186691259281,18,26,19,3,23,14,4
1903,0,0,1.7104947458732767,0.1530995559643421,28,41,23,10,31,10,18
1904,1,1,3.439984141836367,0.9689310384547806,17,24,15,4,20,14,3
1905,0,0,1.3586104506554446,0.204466233275567,7,8,5,0,8,0,7
1906,0,1,2.4426772536861447,0.9200243006976011,9,10,5,2,8,7,2
1907,0,0,7.198431363205751,0.0007471991253475974,27,36,20,5,31,5,22
1908,0,0,0.492398930409224,0.379328604009586,14,14,6,3,11,5,9
1909,0,0,2.8929513615764693,0.052503104384338806,18,26,16,6,20,6,12
1910,0,1,0.1457130297693081,0.5363639393992456,42,69,47,21,48,20,22
1911,1,1,2.393922671449743,0.9163627013245971,24,35,22,7,28,15,9
1912,1,1,0.8202607936832602,0.6942916965640157,18,27,15,8,19,10,8
1913,1,1,5.410644459700688,0.9955511216190164,14,21,14,1,20,12,2
1914,0,1,0.574737386891663,0.6398555822866918,2,1,0,0,1,2,0
1915,0,0,1.6524275581082033,0.16078112801777467,5,4,2,0,4,0,5
1916,1,1,3.4981706147914577,0.9706356728635539,7,8,3,1,7,6,1
1917,0,0,1.002758823387495,0.268399349657632,21,28,16,6,22,9,12
1918,0,1,0.45145197267524817,0.610984397952747,11,14,8,5,9,5,6
1919,0,0,3.444431756173651,0.030935350863175115,19,21,14,3,18,6,13
1920,1,1,1.304204028565024,0.7865416639359555,6,6,3,1,5,5,1
1921,1,1,3.0332797372145572,0.9540551509813214,5,6,3,0,6,5,0
1922,0,1,0.6574491294976184,0.658687138203414,10,11,5,4,7,6,4
1923,0,0,5.295017995819209,0.004991484197454765,15,18,9,2,16,3,12
1924,0,0,0.7567253048857299,0.31935765980850883,21,26,14,5,21,8,13
1925,1,0,0.14296631599260756,0.4643191747670553,12,13,4,4,9,5,7
1926,1,1,1.6531994606865246,0.8393229979570602,17,23,14,5,18,7,10
1927,0,0,6.290460325329587,0.0018504757416243356,12,14,8,0,14,0,12
1928,1,1,2.412660904156179,0.9177876796126467,15,21,11,5,16,10,5
1929,1,1,3.9646168099564982,0.9813780508228407,14,21,14,2,19,13,1
1930,1,0,0.37050549539690847,0.4084188817073353,29,43,28,8,35,16,13
1931,1,1,1.4570326198509036,0.8110784021170829,10,12,4,3,9,7,3
1932,1,1,3.8903946814929893,0.9799720387852833,19,28,19,4,24,12,7
1933,1,1,1.5302912861721707,0.8220489288594526,15,19,11,6,13,8,7
1934,1,0,0.045568438347722395,0.48860986129690576,8,8,5,2,6,3,5
1935,0,0,0.9577075808612907,0.27733741006133317,18,24,13,6,18,6,12
1936,0,0,3.214043293094871,0.03864065550651019,25,36,24,5,31,5,20
1937,1,1,0.387971801868656,0.5957943566907655,6,5,1,2,3,4,2
1938,1,1,2.3043155825115074,0.9092338235447687,8,9,3,3,6,5,3
1939,1,1,7.812047381517932,0.9995953354590194,33,47,27,10,37,19,14
1940,1,1,2.4570977625761543,0.9210789495370713,5,5,2,0,5,5,0
1941,0,1,0.1055831127628859,0.5263712842715217,8,8,2,3,5,5,3
1942,1,1,1.5339176578175575,0.8225787913860538,29,41,25,11,30,17,12
1943,1,1,1.665002975405706,0.8409084503401475,8,10,6,1,9,7,1
1944,1,0,0.4379353374126649,0.3922330468317472,17,23,13,6,17,8,9
1945,0,0,3.1070051498726454,0.042819222432631365,14,17,7,3,14,3,11
1946,1,1,2.247147769707076,0.9044042234635485,18,23,11,7,16,8,10
1947,0,0,2.9559264990870284,0.04945715494789338,24,29,15,6,23,7,17
1948,1,1,5.213369014065073,0.9945861649578994,23,33,21,5,28,16,7
1949,1,0,3.6630299494270235,0.025012963380799724,17,19,10,4,15,6,11
1950,0,0,4.496853912091381,0.0110211813918768,11,13,6,0,13,0,11
1951,1,1,2.3064472156465947,0.9094095888839915,18,25,15,6,19,13,5
1952,0,1,3.781914240014787,0.9777282833344515,8,12,6,0,12,8,0
1953,0,0,1.6761500432968666,0.1576059398867693,9,11,8,0,11,0,9
1954,0,0,0.2579701541403294,0.4358627545743081,17,25,16,5,20,5,12
1955,0,0,11.830117879666778,7.281853244833769e-06,43,64,37,9,55,9,34
1956,0,0,0.3268293727848066,0.4190122849912,23,33,17,7,26,9,14
1957,0,0,1.891214368388723,0.1311060699266492,8,9,4,2,7,1,7
1958,0,0,0.9083607948060367,0.28733538641429723,6,6,3,2,4,1,5
1959,1,1,0.8723152124914366,0.7052272170896898,13,16,8,6,10,6,7
1960,1,0,2.7756562317500233,0.05865393154761178,26,36,24,5,31,8,18
1961,1,1,1.812711264497073,0.8596892359419508,14,19,12,3,16,10,4
1962,1,1,4.614347897737672,0.9901885751546355,13,18,13,1,17,12,1
1963,0,0,0.6481898634318357,0.343397563319082,24,37,21,8,29,8,16
1964,0,0,0.5520859350873315,0.365380591652287,17,21,11,6,15,7,10
1965,0,0,0.44750560364308445,0.3899539945446886,19,26,16,5,21,6,13
1966,1,1,0.09098996269541892,0.5227318094550057,16,22,12,6,16,8,8
1967,0,0,0.1507177100605288,0.4623917374487392,11,14,7,3,11,3,8
1968,1,1,0.8264704113775347,0.6956081000532088,24,37,24,9,28,13,11
1969,1,1,1.627989242154605,0.835893998884255,5,6,3,0,6,5,0
1970,1,0,1.260836813319376,0.22082987310314817,10,11,8,2,9,2,8
1971,1,1,3.4184987475074933,0.9682776915470672,16,23,11,5,18,10,6
1972,1,0,1.0069398253195263,0.2675791587614117,12,14,7,2,12,3,9
1973,0,0,4.321435978442405,0.013106731042988096,36,54,34,15,39,14,22
1974,0,0,2.03576677897496,0.11549848852067268,14,19,10,3,16,3,11
1975,1,1,0.015386351770967366,0.5038465120578266,12,14,8,4,10,6,6
1976,0,0,0.6940530652172123,0.3331320560344857,11,14,7,3,11,4,7
1977,0,0,6.930479983481181,0.0009765769220150267,38,58,37,16,42,14,24
1978,0,0,2.880315174148422,0.05313527714820032,15,19,11,2,17,1,14
1979,1,1,5.627079002744372,0.9964138340025518,13,18,13,1,17,12,1
1980,1,1,3.670879339424441,0.9751777501383985,18,27,17,3,24,15,3
1981,1,1,0.4918218436952744,0.6205355181511608,11,12,5,4,8,6,5
1982,0,0,3.731940518562184,0.02338630640426942,16,20,11,5,15,5,11
1983,1,0,0.6237556410038174,0.3489277721352335,8,8,4,1,7,2,6
1984,0,0,0.5594510979075731,0.363674474581252,13,15,10,5,10,5,8
1985,1,1,1.7733550769512907,0.8548744116330875,17,25,15,4,21,12,5
1986,1,1,1.6819184378998202,0.8431583968320645,7,8,4,1,7,6,1
1987,1,1,1.8180282160893997,0.8603293603546313,8,9,5,2,7,5,3
1988,1,1,0.7487508841951289,0.6789064621995764,10,12,4,4,8,6,4
1989,1,1,0.0060887310643116255,0.5015221780634835,21,28,19,4,24,9,12
1990,1,1,6.025584630899378,0.997589685049913,15,22,16,0,22,15,0
1991,0,0,1.120941872314798,0.24583661770521936,34,53,34,7,46,16,18
1992,0,0,1.4938354266561324,0.18334674862385802,7,7,4,1,6,1,6
1993,1,1,5.123529472268504,0.9940802838530837,14,22,13,0,22,14,0
1994,0,0,1.2053535220445581,0.23052422406503714,13,15,8,4,11,5,8
1995,1,1,3.6321566881409835,0.9742229768812081,11,14,8,1,13,10,1
1996,0,0,1.1037035604661376,0.24904660209925278,15,18,11,4,14,6,9
1997,0,0,4.75586128668997,0.008527784844796993,32,45,25,7,38,11,21
1998,0,0,5.42967223845565,0.0043653924426887425,25,35,20,7,28,7,18
1999,0,0,1.1172964755202341,0.24651310385867864,13,16,10,2,14,3,10
2000,0,0,7.791366998326461,0.00041311679826017134,21,26,15,2,24,3,18
2001,0,0,1.875964004678817,0.13285314447540097,10,11,5,4,7,3,7
2002,0,0,2.2863016831090084,0.09226382172654579,12,18,10,3,15,2,10
2003,0,0,3.016167663379562,0.04670079340128497,23,31,15,7,24,9,14
2004,1,1,2.740559522271943,0.9393779676344186,20,29,21,3,26,15,5
2005,1,1,0.31259875926342584,0.5775194617153487,24,34,23,9,25,10,14
2006,1,1,1.6427559973906174,0.8379095976786692,7,8,5,1,7,6,1
2007,0,0,1.8474829084776108,0.13616870334426512,9,10,6,2,8,1,8
2008,1,1,5.644687160009683,0.9964762065206636,21,34,22,4,30,18,3
2009,1,1,2.4598756053919737,0.921280641879235,10,13,10,1,12,9,1
2010,1,1,1.2013200666053976,0.7687595327635999,6,6,2,2,4,4,2
2011,1,1,0.6036719607228977,0.6464959429524848,5,4,2,1,3,3,2
2012,1,1,0.5944935704072596,0.6443955138857742,12,15,6,5,10,6,6
2013,1,1,1.313628875024229,0.7881197644102902,26,37,25,11,26,15,11
2014,1,1,1.4715129344761364,0.8132872357094081,8,9,4,2,7,6,2
2015,0,0,0.80204038116407,0.30958923082228484,16,19,9,6,13,8,8
2016,1,1,3.126774886256888,0.9579837708929626,13,15,8,1,14,10,3
2017,1,0,0.5884696490230894,0.35698606486824824,14,21,13,8,13,7,7
2018,0,0,4.176657486888798,0.015117676355732024,12,13,8,1,12,2,10
2019,0,0,1.2350947467648357,0.22529097003290643,14,18,12,7,11,6,8
2020,1,1,2.3868110511279346,0.9158160354208869,21,31,19,5,26,14,7
2021,0,0,0.2130075410286698,0.4469485516864845,8,8,4,2,6,3,5
2022,0,1,0.3350276257627087,0.582982170425149,8,8,5,2,6,5,3
2023,0,1,1.6414476541834404,0.8377318237246854,9,9,5,1,8,6,3
2024,0,1,2.291081694342419,0.9081357305114486,31,47,29,12,35,17,14
2025,0,0,4.583128023602525,0.010119419359147286,11,11,6,1,10,1,10
2026,0,0,2.110879911942379,0.10804384007355572,9,10,5,1,9,1,8
2027,1,1,3.4585425095026663,0.9694848779022136,11,14,6,2,12,8,3
2028,1,1,3.3439877651530816,0.9659074048305645,15,22,13,2,20,13,2
2029,0,0,1.6584996658332425,0.15996350177800955,16,21,11,4,17,5,11
2030,0,0,0.028415654195418805,0.49289656441678176,23,32,19,8,24,10,13
2031,0,0,1.0040953201608667,0.268136994875914,31,47,33,7,40,14,17
2032,1,1,0.7911580678559613,0.6880799361030887,4,3,1,1,2,2,2
2033,1,1,3.267072848592184,0.9632817786838319,18,25,19,3,22,13,5
2034,0,0,8.091295584603964,0.0003060990760309634,23,29,16,2,27,3,20
2035,0,0,0.7403231753726464,0.32293347824823937,4,4,2,0,4,0,4
2036,1,1,3.055090790824784,0.9550018023420213,12,16,10,2,14,8,4
2037,1,1,2.995862271380524,0.9523868476272933,17,23,11,5,18,11,6
2038,0,0,2.6792464099603204,0.0642091419958275,13,15,9,2,13,3,10
2039,0,0,0.8710526417974486,0.2950353163565592,9,8,2,1,7,1,8
2040,0,0,3.5266002878783835,0.028564774669750714,16,20,12,5,15,5,11
2041,1,1,1.7876190990622665,0.8566351229778969,12,12,5,3,9,7,5
2042,0,0,4.043355513264166,0.01723622489816068,26,36,21,10,26,8,18
2043,1,0,0.14228430420639526,0.4644888135514246,13,16,8,6,10,6,7
2044,0,0,6.707588216563517,0.0012201163232757883,30,43,27,8,35,7,23
2045,1,1,3.523063991307633,0.9713369334804978,29,46,31,11,35,20,9
2046,0,0,4.589608839401124,0.010054706597238283,26,39,24,6,33,8,18
2047,0,0,0.5208324676422962,0.3726575955227107,3,2,1,0,2,0,3
2048,1,1,5.405620016119326,0.9955288124269601,13,16,11,2,14,10,3
2049,1,0,2.0935485813436454,0.1097254480687112,36,58,35,13,45,14,22
2050,1,0,0.9467906165843146,0.27953071270526997,8,7,1,2,5,2,6
2051,0,0,3.519063862547937,0.02877464630960702,33,50,26,14,36,11,22
2052,0,0,6.550093304853109,0.001427940238728942,23,30,18,3,27,4,19
2053,0,0,1.6526218708811733,0.16075491101527128,14,17,10,3,14,4,10
2054,1,1,1.7255835980973027,0.8488466418856724,25,36,22,6,30,14,11
2055,0,0,3.7751388475770633,0.02241973402848041,25,33,19,5,28,7,18
2056,0,0,9.004471391383069,0.00012284412986829363,22,31,18,3,28,2,20
2057,1,1,4.910627513998322,0.9926860249265858,14,19,11,3,16,11,3
2058,1,1,3.8200387833359652,0.9785435245961186,14,20,13,4,16,11,3
2059,1,1,2.564765798305126,0.9285592527716076,6,7,3,1,6,5,1
2060,1,1,0.7438511905580671,0.6778374308831407,11,12,6,3,9,6,5
2061,0,1,1.831429312781868,0.8619319106220471,28,40,24,11,29,16,12
2062,1,1,2.947784377810271,0.9501586674249974,24,37,23,7,30,14,10
2063,1,1,2.1026138200241853,0.8911569688154625,7,7,3,1,6,5,2
2064,0,1,2.252393816949712,0.9048568209111663,17,22,14,5,17,9,8
2065,1,1,3.7994148266353083,0.9781062013974353,23,33,22,6,27,18,5
2066,1,1,3.3693993495539263,0.9667343802461247,13,19,13,3,16,10,3
2067,1,1,2.348124353556171,0.9127850256790837,12,16,10,2,14,10,2
2068,1,1,1.7318782446712389,0.8496525106966214,9,12,8,3,9,8,1
2069,0,0,3.4882356030004225,0.029648823371826727,22,31,18,2,29,3,19
2070,1,1,0.25148328750682314,0.5625415547614727,28,41,24,11,30,12,16
2071,1,1,1.5039197645401996,0.8181583675821369,22,28,18,5,23,12,10
2072,0,0,3.1760555745170356,0.040076803596037824,19,26,13,5,21,7,12
2073,0,0,0.7987499205624686,0.31029298646972414,17,22,15,5,17,5,12
2074,0,1,0.23873750704132346,0.5594025043085135,3,2,0,1,1,2,1
2075,0,1,2.3190474472117666,0.9104423026188974,20,30,21,6,24,13,7
2076,1,1,2.68764955361691,0.9362939268458391,11,13,9,2,11,9,2
2077,1,1,2.636854896479518,0.9331961621903292,13,18,11,2,16,11,2
2078,0,0,0.6568740173923344,0.34144216937283234,5,6,3,2,4,1,4
2079,1,1,0.15561540407272356,0.5388255322001991,10,11,5,6,5,5,5
2080,0,0,4.609478883896507,0.009858841174243405,14,18,9,2,16,1,13
2081,1,1,6.234379425730171,0.9980429917040651,17,26,17,1,25,16,1
2082,0,0,1.0363411164357696,0.2618565946950663,10,11,6,2,9,3,7
2083,1,1,2.5054607992603968,0.9245237567290157,9,12,8,1,11,8,1
2084,1,0,0.07467029035770223,0.4813410962349495,8,8,4,2,6,3,5
2085,1,1,4.00209989480774,0.9820508423458206,25,40,27,6,34,20,5
2086,0,0,1.9019741852759713,0.1298851986777355,7,8,4,0,8,0,7
2087,0,0,1.4616816546818079,0.18821025525214552,16,18,10,3,15,5,11
2088,1,0,0.489769661085969,0.37994783111969266,21,29,17,7,22,7,14
2089,0,0,1.015611916095917,0.2658830269293265,7,7,4,1,6,1,6
2090,1,1,2.4066892802247954,0.9173359743524893,9,11,5,2,9,7,2
2091,0,0,0.30453047820219337,0.4244503454230727,12,13,7,3,10,4,8
2092,0,0,3.200064802623577,0.0391632842322307,43,71,42,16,55,17,26
2093,0,0,3.212954829303021,0.03868110958630411,21,29,16,5,24,4,17
2094,0,0,1.558022716229678,0.17393055747893438,19,25,15,6,19,7,12
2095,1,1,3.74071583221819,0.9768132803417376,8,12,6,0,12,8,0
2096,1,1,5.4910224249852835,0.9958933085393248,24,36,26,3,33,20,4
2097,0,0,3.5291772920113686,0.02849335263397057,13,15,10,4,11,4,9
2098,0,0,1.332263067520449,0.20878527369406086,35,57,35,13,44,14,21
2099,0,0,2.279373925409473,0.09284567103018204,20,30,19,8,22,6,14
2100,1,1,0.3998986226783252,0.5986633028778794,22,32,23,6,26,13,9
2101,1,1,0.17893056241994265,0.5446136742449037,4,3,1,1,2,3,1
2102,1,1,3.931941668513537,0.9807714191919849,9,13,8,0,13,9,0
2103,1,1,1.963293993796244,0.8768889961916717,5,5,2,0,5,5,0
2104,0,0,3.8844663558594505,0.02014464720529474,32,47,28,12,35,14,18
2105,1,1,5.898337861126926,0.9972635069993804,20,28,19,3,25,16,4
2106,1,1,1.0036382690283132,0.7317733041125981,6,5,2,2,3,4,2
2107,1,1,0.7385338375887616,0.6766751637234608,11,13,8,3,10,7,4
2108,0,0,2.0213545004400792,0.11697900526101868,5,5,2,0,5,0,5
2109,1,1,1.143554220954332,0.7583316004634629,3,2,1,0,2,3,0
2110,0,0,1.0476119967014772,0.25968392659048445,22,30,17,7,23,10,12
2111,0,0,2.6093153460776515,0.06854130144268278,11,13,7,1,12,2,9
2112,0,0,4.74722891127902,0.008601082627781476,14,17,6,3,14,2,12
2113,0,1,0.7043744753804011,0.6691569350830116,10,11,6,3,8,6,4
2114,1,1,4.202071363241953,0.9852560882885509,19,27,18,4,23,15,4
2115,0,0,5.729682722250112,0.0032375915765419094,31,44,27,6,38,7,24
2116,0,0,5.989504853378122,0.002498645171581715,22,28,18,4,24,4,18
2117,1,1,0.6802497235410034,0.6637944308321156,10,11,6,3,8,6,4
2118,1,1,3.717882525361524,0.9762904572120524,17,25,16,4,21,12,5
2119,1,1,1.452935613303612,0.8104498166239799,21,30,18,9,21,11,10
2120,0,0,3.7603508278118136,0.0227461436908869,14,19,10,4,15,3,11
2121,0,0,6.711070262924072,0.0012158803665216489,21,25,13,3,22,4,17
2122,0,0,0.8283269111078041,0.30399895219904727,7,7,4,2,5,3,4
2123,0,0,0.7889959723112323,0.312384294277408,39,57,35,12,45,16,23
2124,0,1,1.0333368030851375,0.7375622931077612,7,8,4,1,7,5,2
2125,1,0,0.9196545794750062,0.2850282813395304,15,18,10,2,16,3,12
2126,0,0,3.251839169215491,0.037260855597362474,23,30,19,4,26,7,16
2127,1,1,4.819707670649322,0.9919954442834211,21,30,21,5,25,13,8
2128,0,0,2.7155009420820697,0.06206485360509861,15,19,11,2,17,3,12
2129,0,0,7.146826149760958,0.0007867396330507592,25,35,21,6,29,6,19
2130,0,0,0.15929164991285738,0.46026107939206773,9,11,5,4,7,4,5
2131,0,1,0.6153153719508762,0.6491523547120663,16,20,12,5,15,8,8
2132,0,0,1.7727301045858535,0.14520314223132536,23,32,18,5,27,6,17
2133,1,1,1.3227024100998235,0.7896309657757803,16,20,11,3,17,8,8
2134,1,1,4.603137197921958,0.9900790607294988,19,29,17,5,24,15,4
2135,1,1,3.4755884633439864,0.9699851488480237,20,28,17,5,23,14,6
2136,1,1,2.287373239962708,0.9078258832535753,21,29,20,4,25,16,5
2137,0,0,6.067845894963296,0.0023108048992817043,22,32,18,2,30,1,21
2138,1,1,0.3197709993473383,0.579268441921293,32,50,28,15,35,15,17
2139,0,0,1.3430510370608364,0.20700876437380977,12,13,6,4,9,4,8
2140,0,0,1.911326435466492,0.1288319073522295,16,18,8,3,15,4,12
2141,1,1,1.8162519702319524,0.8601157851248982,28,42,29,6,36,17,11
2142,1,1,1.7320104885915268,0.8496694031667106,13,14,6,5,9,8,5
2143,1,1,3.735308999266608,0.9766905042410436,15,20,12,4,16,10,5
2144,0,1,1.253693991140614,0.7779386536550958,10,11,6,1,10,7,3
2145,0,0,2.0993000827054487,0.10916486806528025,8,8,6,2,6,2,6
2146,1,1,4.820416307715018,0.9920010692424998,18,29,21,1,28,17,1
2147,0,1,0.15940749051145398,0.5397676976917111,12,13,5,7,6,6,6
2148,1,0,1.238159474301463,0.22475651834669608,14,19,12,5,14,6,8
2149,0,0,1.9735975376682822,0.12200300048306556,20,26,15,4,22,5,15
2150,1,1,1.1559568620882883,0.7605972795487181,16,21,12,4,17,9,7
2151,1,1,0.7992553659066695,0.6898151741462499,8,9,4,2,7,5,3
2152,0,0,2.531863661053526,0.07365438901229227,14,16,10,3,13,4,10
2153,1,1,0.07390225207920031,0.5184671588531303,18,24,12,8,16,7,11
2154,1,1,3.5973145181096218,0.973333391928487,10,14,6,2,12,8,2
2155,0,0,1.467945516857191,0.1872550861465917,23,33,20,10,23,8,15
2156,0,0,3.4761530583090536,0.029998417917840636,9,9,4,1,8,1,8
2157,0,0,2.2443082422747564,0.09584155626371849,18,21,9,4,17,5,13
2158,0,0,2.9296363923663504,0.05070782488606296,22,28,17,5,23,6,16
2159,1,1,2.0986214289351355,0.8907691167735281,10,13,8,1,12,8,2
2160,1,1,5.8383545632732705,0.9970948317116011,13,20,14,0,20,13,0
2161,1,1,2.944892930112274,0.9500215582656791,11,14,8,1,13,9,2
2162,0,0,4.870025604818165,0.0076147396326026184,32,47,28,9,38,9,23
2163,1,1,3.451621989637294,0.9692794750421316,13,20,15,2,18,12,1
2164,0,1,0.13487774402002017,0.5336684101478931,11,13,6,6,7,6,5
2165,0,0,2.218399042384786,0.09811037347981,14,18,12,2,16,3,11
2166,1,1,0.3018758958697847,0.5749010309845773,6,5,2,2,3,3,3
2167,0,0,2.894776946546846,0.05241236202632815,23,33,22,6,27,8,15
2168,0,1,0.5154853712664664,0.6260914905866244,17,21,11,7,14,9,8
2169,1,1,1.7978893144241057,0.857891808460005,33,51,33,11,40,19,14
2170,1,1,3.014812978846054,0.9532388592258015,10,14,6,1,13,9,1
2171,1,1,3.6857226259585874,0.975534525345097,15,23,16,1,22,14,1
2172,0,0,1.10911660767844,0.24803561687490128,12,15,7,3,12,3,9
2173,0,0,1.7753781924944634,0.14487477241206537,26,37,21,10,27,11,15
2174,1,1,2.6387955448576585,0.9333170426560491,19,25,15,4,21,11,8
2175,1,1,1.7881233455841081,0.8566970390578665,28,39,24,9,30,15,13
2176,1,1,0.3463784624533761,0.5857390908845814,8,8,3,3,5,4,4
2177,0,0,4.850506477959748,0.007763667506404337,26,36,18,3,33,4,22
2178,0,0,3.3219942085694134,0.03482431780653594,15,18,11,2,16,3,12
2179,0,0,1.285761550082651,0.21657107640775797,23,30,18,8,22,8,15
2180,1,1,3.0841005778049464,0.9562321244324411,15,23,13,4,19,12,3
2181,1,1,2.4023482814970474,0.9170061965217359,8,8,4,1,7,6,2
2182,0,0,2.5725748449253487,0.07092444924826324,9,8,2,2,6,2,7
2183,0,0,0.2597033974641521,0.4354366210672628,1,0,0,0,0,0,1
2184,0,0,1.2061144169201712,0.23038928207217568,9,9,5,1,8,1,8
2185,0,0,4.289065604525402,0.013532107213068079,15,18,12,3,15,3,12
2186,0,0,4.138887860889343,0.015690454988547375,25,35,18,12,23,9,16
2187,0,0,5.299674685621471,0.004968409655771389,29,45,29,8,37,8,21
2188,0,0,0.7337246047259188,0.3243779212990856,18,25,17,5,20,7,11
2189,0,0,3.8488903911243,0.020858995011779013,22,31,16,8,23,8,14
2190,0,0,1.78360141913767,0.1438590012135259,17,21,11,2,19,5,12
2191,1,1,3.5915389032833325,0.9731830724330919,10,14,7,1,13,9,1
2192,1,1,3.1097280596932304,0.9572922392088908,7,10,5,0,10,7,0
2193,0,0,2.4061289024785517,0.08270652941465817,16,21,13,4,17,4,12
2194,0,1,0.0859275895587448,0.5214686894186579,26,38,22,9,29,15,11
2195,1,1,2.104468771000161,0.8913367615540487,4,3,1,0,3,4,0
2196,1,1,2.4271314346054007,0.9188729510625119,9,12,6,1,11,7,2
2197,0,0,1.6919924232672972,0.15551399675162592,5,4,0,0,4,0,5
2198,0,0,1.7330673926947036,0.15019564697482335,14,16,9,5,11,5,9
2199,0,1,2.3524225945361428,0.9131265957367907,28,41,24,11,30,14,14
2200,1,1,2.7797328452672154,0.9415707486005085,16,20,8,4,16,11,5
2201,1,1,1.3782245945911296,0.7987057109961632,6,6,2,2,4,4,2
2202,1,1,2.4079989805776143,0.9174352355578663,13,17,11,3,14,9,4
2203,1,1,4.775945935855384,0.9916403666201569,13,21,15,0,21,13,0
2204,0,0,1.654056577148029,0.16056144501563496,13,17,12,5,12,5,8
2205,1,1,1.2978624904288634,0.7854750238929815,9,10,5,2,8,6,3
2206,1,1,2.3887239770758075,0.915963399058214,5,5,2,0,5,5,0
2207,1,0,1.1789653397833568,0.2352382818919463,31,47,31,11,36,12,19
2208,1,1,3.667346162386754,0.9750920819431976,28,40,25,7,33,18,10
2209,1,1,2.6156908916625774,0.9318646170404555,9,11,7,1,10,8,1
2210,1,1,3.811577853281486,0.97836515697158,8,11,6,0,11,8,0
2211,1,1,1.7958456341418239,0.8576424740585736,21,29,17,8,21,10,11
2212,0,0,2.8990619457061317,0.052199953935615495,24,33,18,7,26,7,17
2213,1,1,1.338640072137512,0.7922662128439252,13,16,10,2,14,9,4
2214,0,0,4.428061564506374,0.011796782185487076,32,46,26,8,38,11,21
2215,1,0,0.2587497194022743,0.43567107966105845,14,18,10,4,14,5,9
2216,1,1,2.2651174472306943,0.9059465820552648,18,25,15,6,19,12,6
2217,0,1,0.7855920936282366,0.686884084878348,15,19,10,5,14,9,6
2218,1,1,1.4669419730058466,0.8125921359566051,4,3,2,0,3,4,0
2219,0,0,0.5455745939427161,0.3668917451735667,29,44,27,8,36,13,16
2220,0,0,8.9339664885613,0.00013181668983053285,19,22,13,0,22,0,19
2221,1,1,3.5347554712210996,0.9716606541704516,13,17,12,2,15,11,2
2222,1,1,2.531904951422879,0.9263484281560661,7,8,4,1,7,6,1
2223,0,0,4.762882376211851,0.008468625481962921,20,27,13,2,25,3,17
2224,1,1,7.071855821384444,0.9991520629158724,18,31,20,1,30,17,1
2225,0,0,3.3143354098924926,0.03508266130110982,14,17,9,3,14,4,10
2226,0,0,0.441722871253039,0.3913305201788718,19,28,14,7,21,8,11
2227,0,0,5.813850823293917,0.002977020579877143,27,39,20,7,32,7,20
2228,1,1,1.8477263297950068,0.8638599269875606,9,10,6,2,8,6,3
2229,1,1,1.9801103817848729,0.8786929283784359,24,33,20,7,26,13,11
2230,1,1,2.400236094495373,0.9168453051199646,33,51,30,15,36,18,15
2231,1,1,0.11396257450857794,0.5284598485104635,27,40,25,10,30,16,11
2232,0,0,0.011445707420818407,0.49713860438263524,8,9,6,1,8,2,6
2233,1,1,1.471371370236472,0.81326573806938,15,18,13,3,15,10,5
2234,1,1,3.2283275498073403,0.961886486785635,18,22,11,5,17,10,8
2235,1,1,2.121541867558736,0.8929793708093355,10,12,8,2,10,8,2
2236,0,0,3.68026505467201,0.024596068647710134,29,41,23,9,32,8,21
2237,1,1,1.5008274600571392,0.8176978564964562,31,46,28,11,35,15,16
2238,0,0,0.30724008425900484,0.4237885455455025,8,9,5,1,8,3,5
2239,0,0,1.3388554164533737,0.20769834791994002,28,43,24,9,34,11,17
2240,0,0,1.6797757711589791,0.1571251627628757,8,8,4,2,6,3,5
2241,1,0,2.252612564079717,0.09512434860733054,35,53,34,15,38,16,19
2242,0,1,0.08885656147166143,0.5221995359412003,18,25,16,7,18,10,8
2243,0,0,0.4786037546110822,0.3825818824073336,9,9,3,1,8,2,7
2244,0,0,3.4009913158552076,0.032264497991776664,14,14,7,3,11,3,11
2245,0,1,1.4774315282785286,0.8141843147352801,12,15,8,4,11,7,5
2246,1,1,1.7273496862325608,0.8490731020464735,10,12,7,2,10,8,2
2247,0,0,1.6505977836967953,0.16102817376898204,9,9,5,1,8,1,8
2248,1,1,4.9666039532776045,0.9930814326757441,22,34,24,5,29,18,4
2249,1,1,1.5791453032837282,0.8290834380196292,6,7,3,1,6,5,1
2250,0,1,0.16711552927064655,0.5416819211048118,14,17,10,6,11,6,8
2251,1,1,3.24142737328034,0.9623638426239295,10,12,4,3,9,7,3
2252,0,0,2.364879003528582,0.08589035354548868,8,8,4,0,8,0,8
2253,0,0,4.850973206954,0.007760072935435014,21,30,17,5,25,6,15
2254,1,1,3.3058147557955433,0.9646277532278096,18,28,21,2,26,16,2
2255,1,1,1.779156987099798,0.8555927396792827,7,8,5,1,7,6,1
2256,1,1,0.8633517475132007,0.7033604544520742,13,18,11,4,14,10,3
2257,0,0,0.3935039934393858,0.4028740709641301,39,63,36,15,48,16,23
2258,0,0,3.3698232714061946,0.03325198954033526,16,23,14,2,21,4,12
2259,1,1,1.8581155124143565,0.8650771444333895,10,14,7,2,12,7,3
2260,0,0,0.21524903223771785,0.4463945535732635,18,23,14,6,17,6,12
2261,0,0,2.069097468813453,0.11213686508653575,22,30,18,6,24,7,15
2262,1,1,2.8396659724939486,0.9447820389455961,13,16,10,3,13,10,3
2263,0,0,2.754890671813441,0.05981103691970224,22,34,22,6,28,7,15
2264,1,1,2.7169723526123697,0.938020746158508,13,19,11,2,17,11,2
2265,0,0,5.08031040311097,0.006179554299828527,16,20,12,2,18,2,14
2266,0,0,1.8731578033151908,0.13317676102026865,18,25,16,2,23,3,15
2267,0,0,1.5707368841983533,0.17211136843741215,23,33,20,9,24,8,15
2268,1,1,1.9414114961446187,0.8745071291986146,8,10,5,1,9,7,1
2269,0,1,2.2188268086064333,0.9019274707914332,27,45,30,10,35,18,9
2270,1,0,1.370365063656421,0.20256087130847455,14,16,10,1,15,2,12
2271,0,0,0.037248585210406526,0.4906889302316596,11,13,7,3,10,3,8
2272,0,0,1.0868508410473419,0.25221174927602386,6,6,2,1,5,1,5
2273,1,1,0.3558758321493072,0.5880417239905565,8,9,3,2,7,6,2
2274,0,0,1.7848466336555373,0.14370570412721573,15,16,9,3,13,4,11
2275,0,0,0.7645199116763097,0.31766574986730123,2,1,0,0,1,0,2
2276,1,1,4.5555018181922105,0.9896000700178431,19,27,15,4,23,14,5
2277,0,0,0.7677114011722577,0.31697438395204236,13,14,6,2,12,3,10
2278,0,0,3.647001251517405,0.0254068506843389,25,34,19,8,26,8,17
2279,0,0,2.2928733707053226,0.09171490774429325,14,16,8,2,14,3,11
2280,0,1,1.5510031441813688,0.8250585698003401,9,11,5,4,7,5,4
2281,0,0,1.8059030124048965,0.14113401313734364,31,44,27,6,38,9,22
2282,0,0,1.6037775574232414,0.16745431109755748,30,46,30,12,34,15,15
2283,0,0,1.9762790181808025,0.12171605595043355,32,45,26,10,35,12,20
2284,1,1,2.182431506750298,0.8986607232644431,13,16,7,3,13,8,5
2285,1,1,0.3652149529932007,0.5903022383544307,16,19,8,6,13,7,9
2286,1,1,0.5666061612874387,0.6379796963582524,27,39,23,9,30,13,14
2287,0,0,5.645102138969422,0.003522336632198808,16,18,9,2,16,2,14
2288,0,0,1.5701671538155173,0.17219256394151927,24,35,24,8,27,10,14
2289,0,0,6.670026927503624,0.0012667578858002182,36,57,35,12,45,9,27
2290,1,1,6.934668214708886,0.9990275006853556,23,34,21,5,29,17,6
2291,1,1,2.5663338162458027,0.9286632004528258,12,16,7,3,13,8,4
2292,1,1,1.7624903344782006,0.8535212827327372,11,13,7,3,10,8,3
2293,0,1,0.8643823406671718,0.7035754369962586,18,23,12,8,15,7,11
2294,1,1,1.7225548319240496,0.8484576222200928,13,15,8,4,11,7,6
2295,0,0,3.717484517328755,0.023718757385897904,32,48,32,5,43,13,19
2296,1,1,4.000467633322156,0.9820220478463856,14,19,9,3,16,9,5
2297,1,1,4.86036087620053,0.9923118777376406,9,12,7,0,12,9,0
2298,1,1,3.8032862199444137,0.9781889519259344,12,17,10,1,16,11,1
2299,1,1,1.6033311518286886,0.8324834447573182,14,19,10,6,13,8,6
2300,0,0,4.950430175379025,0.007030583397360068,20,24,15,3,21,4,16
2301,0,0,1.1640141051953077,0.23793866663255203,10,11,5,3,8,4,6
2302,1,1,0.15988616043673864,0.5398866059052512,13,15,8,5,10,5,8
2303,0,0,0.759000253681315,0.31886336130019133,18,23,14,5,18,9,9
2304,1,1,4.999151647995879,0.9933015068225811,26,36,21,7,29,16,10
2305,0,0,3.7011867170089388,0.024099096048043944,17,21,12,0,21,0,17
2306,0,0,0.5957032773144917,0.3553273303007126,2,1,0,0,1,0,2
2307,1,1,1.214242140208248,0.7710486860717931,8,9,4,2,7,5,3
2308,1,0,0.8369975785258927,0.3021675052102283,2,1,0,0,1,0,2
2309,1,1,2.498683754805864,0.9240494947692699,21,27,16,7,20,12,9
2310,1,1,4.192617126820577,0.9851181191140226,6,7,3,0,7,6,0
2311,0,1,0.38021311416289905,0.5939245024504047,7,8,4,2,6,4,3
2312,1,1,1.8404031839337707,0.8629963842996362,6,7,5,0,7,6,0
2313,0,0,1.511404973648498,0.1807306694632832,12,14,9,2,12,4,8
2314,0,1,0.5605589362127559,0.6365818574699407,3,2,0,1,1,2,1
2315,1,1,3.7220865198939412,0.9763875741541725,8,10,7,1,9,7,1
2316,1,1,6.95951014990649,0.9990513392083878,18,27,16,3,24,15,3
2317,0,0,6.6137269773752845,0.0013400238055842895,13,18,11,0,18,0,13
2318,0,0,4.105196258681882,0.01621937749194069,21,29,18,1,28,2,19
2319,0,0,1.545637901361983,0.17571718392421265,22,30,15,7,23,8,14
2320,0,0,0.04656031994946752,0.4883620223988079,9,11,6,2,9,3,6
2321,0,0,8.075618469732863,0.00031093413517491175,23,30,19,3,27,3,20
2322,1,1,1.291681081114423,0.7844315936773728,10,11,4,2,9,7,3
2323,1,0,1.2570299205031399,0.22148559855581262,22,30,17,6,24,6,16
2324,0,0,3.354177183485878,0.03375864293683151,14,18,12,5,13,4,10
2325,0,0,3.176152300685329,0.04007308264267728,15,18,10,4,14,4,11
2326,0,0,9.384373833494008,8.401981812899972e-05,26,32,20,2,30,3,23
2327,1,1,1.6227780842685229,0.835177905319634,9,9,4,2,7,6,3
2328,1,1,2.289202901891305,0.9079788715939421,6,7,4,0,7,6,0
2329,1,1,0.2809660751454439,0.5697830542015929,23,36,25,7,29,12,11
2330,0,0,2.6433528646778908,0.0663998859249274,14,17,10,4,13,4,10
2331,0,1,0.10703004905493396,0.5267319982535517,4,3,1,1,2,2,2
2332,0,0,0.9852069218368327,0.2718598391948567,28,42,25,9,33,14,14
2333,1,1,0.5579629728965432,0.6359810806330606,26,38,24,8,30,16,10
2334,0,0,3.200834672395092,0.0391343246770125,14,17,9,1,16,2,12
2335,1,1,3.274396401643866,0.9635399356613908,14,18,11,2,16,12,2
2336,1,1,1.880924266183704,0.8677172535091101,5,6,3,0,6,5,0
2337,0,0,6.388511635913387,0.0016779357170444431,28,37,22,3,34,4,24
2338,0,0,2.0168625688322406,0.1174437978623214,21,28,14,7,21,8,13
2339,1,1,3.015786235024451,0.9532822225370982,25,39,24,7,32,15,10
2340,1,1,2.430321634830663,0.9191104484102447,17,25,13,5,20,10,7
2341,0,1,0.5451534268362481,0.6330104197242654,16,22,14,8,14,9,7
2342,0,0,0.5331328804251996,0.36978649029890054,21,26,13,6,20,9,12
2343,1,0,0.4693282364195175,0.38477525335809837,17,21,12,4,17,7,10
2344,0,1,0.26558918135529286,0.5660097366277839,26,38,19,11,27,12,14
2345,0,0,1.1801857393865762,0.23501880144371956,31,46,27,11,35,13,18
2346,1,1,0.3813229286118912,0.5941921375626256,10,13,8,2,11,7,3
2347,1,1,2.8897105101777156,0.947335440497115,19,27,15,4,23,14,5
2348,1,1,1.3654406147116824,0.7966425174215424,38,58,40,13,45,19,19
2349,1,1,2.6486374812882105,0.9339269627269107,22,33,22,6,27,15,7
2350,1,1,4.368285015094532,0.9874856380862738,12,17,11,0,17,12,0
2351,1,1,4.2479709016038365,0.9859082100408015,14,20,10,3,17,11,3
2352,0,0,1.2982949225117943,0.2144521185619691,11,13,7,1,12,2,9
2353,0,0,5.383439357774638,0.004571011115432233,34,50,31,10,40,11,23
2354,0,0,1.1809508083721192,0.23488128142936981,8,8,5,2,6,3,5
2355,1,1,3.0213597612862317,0.9535298146400961,31,50,35,12,38,16,15
2356,0,1,0.19850565280006438,0.5494640941375148,18,24,15,6,18,8,10
2357,1,1,4.785812255186172,0.9917217604641094,17,27,20,1,26,16,1
2358,0,0,5.532022100408697,0.003942373736918747,18,23,13,2,21,2,16
2359,1,0,1.6403609955003704,0.1624159478481222,13,16,7,4,12,5,8
2360,1,1,1.7856662217578319,0.8563951203263941,16,22,13,5,17,10,6
2361,1,0,0.3057488130970425,0.4241527430802843,18,24,16,7,17,9,9
2362,1,1,3.4833166761369316,0.9702093323422893,14,18,9,3,15,9,5
2363,0,0,5.822545266128227,0.0029513253002968476,14,16,10,1,15,2,12
2364,1,1,1.4182703510344494,0.8050671188062158,5,5,2,1,4,4,1
2365,0,0,6.2225860078087685,0.001980178771477825,20,24,14,3,21,3,17
2366,1,1,3.799704694092471,0.9781124078923702,20,31,21,4,27,16,4
2367,1,1,1.6988562572150077,0.8453852964934926,19,24,10,9,15,9,10
2368,1,1,0.7813953006748402,0.685980755240692,11,12,6,3,9,6,5
2369,0,0,1.8360904374672937,0.13751432608005476,26,38,26,7,31,8,18
2370,1,1,2.724486811658948,0.938456185178828,13,16,10,3,13,9,4
2371,1,1,2.1021437585465463,0.8911113662422562,30,46,28,12,34,19,11
2372,1,1,1.441025140928599,0.8086133501873911,26,38,26,8,30,17,9
2373,0,1,1.123785695375225,0.754690248691359,10,11,7,4,7,7,3
2374,0,0,0.5048377933919692,0.3764044447447664,22,31,17,7,24,7,15
2375,1,0,0.07178231289451381,0.48206212349034083,22,30,19,6,24,12,10
2376,0,0,0.4971021572455867,0.378221913878081,15,18,9,5,13,5,10
2377,1,1,0.6742450629197607,0.6624530471475998,9,10,4,3,7,5,4
2378,1,1,5.361644354809377,0.9953287405710826,15,21,11,4,17,10,5
2379,1,1,0.4502687250254098,0.610703123831837,5,5,2,1,4,4,1
2380,1,1,1.756892859201006,0.8528200855286395,18,24,10,5,19,12,6
2381,0,0,0.6110643910367171,0.35181643418445074,9,10,6,1,9,2,7
2382,0,0,1.4488058479579529,0.19018541521043375,7,7,3,1,6,2,5
2383,1,1,3.848316265024313,0.9791292758694852,12,19,13,0,19,12,0
2384,0,0,1.364104348053519,0.2035740478885173,10,11,4,2,9,3,7
2385,1,1,1.2011732522956817,0.768733432801558,16,19,11,6,13,8,8
2386,0,1,1.4974146123863226,0.8171885581595959,14,19,10,5,14,8,6
2387,0,0,2.2572936200128892,0.09472218633941465,6,5,3,0,5,0,6
2388,1,1,2.875228863004021,0.9466082383662529,14,19,13,1,18,12,2
2389,0,0,1.8908608265119002,0.1311463497043529,22,34,21,9,25,7,15
2390,0,0,0.17043721821965008,0.4574935426211343,14,19,11,4,15,6,8
2391,0,0,0.2745563541699061,0.43178886050632515,6,5,1,1,4,2,4
2392,0,0,2.431484717816268,0.0808031226600261,13,16,6,3,13,4,9
2393,1,1,4.034683990967493,0.9826162704196791,15,24,16,0,24,15,0
2394,0,0,3.30058949912833,0.035550971522226193,10,10,5,2,8,3,7
2395,1,1,4.561306755063897,0.9896596436200668,8,9,4,0,9,8,0
2396,1,1,6.402601044970849,0.998345500800386,15,22,14,1,21,14,1
2397,1,1,1.567138533582615,0.8273753009152103,15,21,12,3,18,10,5
2398,1,1,0.35408171716088876,0.5876070335021946,7,6,2,2,4,4,3
2399,0,1,1.8196016601129275,0.860518322546095,8,7,3,2,5,5,3
2400,1,1,4.597379298336509,0.9900223437902215,19,28,17,5,23,15,4
2401,0,0,4.240058751201107,0.014202138806662323,23,32,20,4,28,5,18
2402,1,1,1.6015684331175446,0.8322374811549585,4,3,2,0,3,4,0
2403,0,0,2.394377120478474,0.08360247533678733,39,56,32,10,46,13,26
2404,1,1,2.098177511974794,0.8907259163831893,4,4,2,0,4,4,0
2405,1,1,3.6501289464465687,0.9746704803894811,8,10,6,1,9,7,1
2406,1,1,4.009310594590025,0.9821775044289913,16,21,15,3,18,12,4
2407,0,0,0.7981108845757823,0.310429763936226,16,21,13,7,14,6,10
2408,0,0,0.2763000746559192,0.43136109448434234,18,25,14,5,20,8,10
2409,0,0,2.708562280741373,0.06247000205488329,10,12,8,0,12,0,10
2410,1,1,0.4467863344703198,0.6098748850632367,16,20,10,8,12,8,8
2411,0,0,4.983266910021033,0.006805016716050605,26,39,24,9,30,8,18
2412,0,0,3.865483338053416,0.02052278308736255,17,19,10,3,16,4,13
2413,0,0,2.129123406350192,0.10629823839259123,13,16,10,2,14,3,10
2414,0,0,0.2597033974641521,0.4354366210672628,1,0,0,0,0,0,1
2415,0,0,1.4714145609948717,0.1867277028730966,24,33,20,8,25,14,10
2416,0,0,0.1361955706349743,0.46600364163457086,2,1,0,1,0,1,1
2417,0,0,3.0017535843514516,0.04734671493640652,9,9,4,2,7,3,6
2418,1,1,4.049252951928913,0.9828633887303208,19,27,18,4,23,13,6
2419,1,1,3.439521484098786,0.9689171077316703,13,18,12,2,16,11,2
2420,1,1,5.586164650593152,0.996264624835132,21,33,22,4,29,19,2
2421,1,1,3.294272343879627,0.9642317949042347,10,15,10,0,15,10,0
2422,0,0,1.1258317778905373,0.24493115159247947,7,7,3,1,6,2,5
2423,1,1,1.0827965167577713,0.7470228332778017,17,20,12,6,14,9,8
2424,1,1,4.276624691002999,0.9863008101187776,21,30,16,6,24,14,7
2425,1,1,3.266803832562882,0.9632722624026546,6,8,4,0,8,6,0
2426,0,0,4.753988416397819,0.008543634663280009,24,34,20,6,28,5,19
2427,0,0,4.307105978191052,0.013293387947802215,16,18,8,2,16,2,14
2428,1,1,2.086968323465567,0.8896301016545797,10,13,8,1,12,8,2
2429,1,1,0.9120136606917062,0.7134120432148268,10,12,5,5,7,7,3
2430,1,1,4.849430636356002,0.9922280404725531,15,20,12,2,18,13,2
2431,0,0,1.6753856968336764,0.1577074459043768,37,52,32,10,42,15,22
2432,0,0,1.4194748363639327,0.19474392588348088,18,24,13,2,22,2,16
2433,0,0,3.504230882658258,0.029192088778957737,19,24,16,4,20,6,13
2434,1,1,3.444033549696088,0.9690527093316913,9,13,8,0,13,9,0
2435,0,1,0.2070774012208716,0.551585146474957,6,6,3,2,4,3,3
2436,1,0,4.57829390793114,0.010167957627472801,28,43,25,10,33,7,21
2437,0,1,0.7037786634489003,0.6690250174121537,6,5,1,2,3,4,2
2438,0,0,0.8515728193897864,0.2991030268801558,7,6,1,2,4,2,5
2439,0,0,2.3480501396640507,0.08722088256021499,15,18,9,3,15,4,11
2440,0,0,5.031431013126227,0.006487102859149219,22,31,20,4,27,4,18
2441,1,0,0.7949871466317306,0.31109883670333605,3,2,1,0,2,0,3
2442,1,1,1.8550970299879619,0.864724442751134,9,10,6,2,8,7,2
2443,1,1,0.7877880426148414,0.6873561832215547,16,21,10,8,13,8,8
2444,1,1,0.8354083518343614,0.6974972814672642,14,20,12,3,17,10,4
2445,1,1,1.9195790484527868,0.8720914847628926,18,23,15,5,18,10,8
2446,1,1,3.7873537606302037,0.9778464253378173,17,22,13,3,19,12,5
2447,0,0,3.2766326539359154,0.036381584551736346,20,26,17,2,24,3,17
2448,1,1,1.601538572612055,0.8322333120418948,7,8,5,1,7,6,1
2449,1,0,2.379179863704405,0.0847741764025588,16,21,12,3,18,3,13
2450,1,1,3.1078402561471967,0.9572149919483374,28,41,22,10,31,16,12
2451,0,1,2.317883203745551,0.9103473281908275,15,21,10,6,15,9,6
2452,1,1,2.217608786266574,0.9018196787109585,18,27,15,6,21,11,7
2453,1,1,4.480895420108158,0.9888035113283123,13,19,13,2,17,11,2
2454,1,0,0.08152281278197004,0.47963057676808085,13,14,6,3,11,4,9
2455,1,1,5.068507068260825,0.9937475329420786,13,18,10,2,16,11,2
2456,1,1,2.3906703693159557,0.9161131002820835,17,22,12,5,17,11,6
2457,0,0,1.1835363581392637,0.23441694549197134,18,21,10,3,18,4,14
2458,0,0,3.1493069652138637,0.04111859438771848,6,5,1,1,4,1,5
2459,1,1,0.2368469473443237,0.5589364833247452,11,13,7,3,10,7,4
2460,1,0,0.33212362886875857,0.4177240014347964,14,17,9,4,13,5,9
2461,0,0,1.3782987818118495,0.20128236182529002,30,46,28,15,31,15,15
2462,1,1,2.1486325155620216,0.8955409214718099,15,21,14,3,18,12,3
2463,1,1,6.550382298948397,0.9985724717789375,20,31,21,2,29,17,3
2464,1,1,2.564535738542898,0.9285439898000102,10,14,9,1,13,9,1
2465,0,0,1.2816784218184867,0.21726465449705046,17,24,16,7,17,6,11
2466,1,1,1.472266385640463,0.8134016210977939,31,48,31,15,33,18,13
2467,1,1,3.259506177321808,0.9630132053672916,16,20,12,4,16,12,4
2468,1,1,0.9859393296629904,0.7282851182205865,21,30,16,8,22,11,10
2469,1,0,0.3021295376663504,0.42503698271641943,35,55,34,13,42,14,21
2470,1,1,3.371662934871394,0.9668070980708355,18,24,15,3,21,14,4
2471,0,0,3.1496998539793215,0.04110310641872883,23,29,15,4,25,6,17
2472,0,0,0.4720297509943274,0.3841359414217489,9,10,4,2,8,2,7
2473,0,0,2.843208636788533,0.05503343497427893,25,37,23,9,28,9,16
2474,0,0,3.6205337932868087,0.026070518253758834,13,14,6,1,13,2,11
2475,0,0,4.78450861120679,0.008288948938810603,25,35,21,5,30,5,20
2476,0,1,0.47599976230135144,0.6168028330153477,6,6,2,2,4,4,2
2477,1,1,4.118207027478438,0.9839869249076654,17,22,14,5,17,14,3
2478,0,0,4.579221480149896,0.010158626252123382,9,9,5,1,8,1,8
2479,0,0,2.073133187588023,0.11173568860153738,14,17,9,5,12,5,9
2480,1,0,1.7818692126348754,0.14407247762557251,26,35,22,7,28,10,16
2481,0,0,2.6693031046358286,0.06480919390373141,10,12,7,2,10,3,7
2482,0,0,1.7331094389676382,0.1501902803972076,8,9,6,0,9,0,8
2483,1,1,0.4666905712988114,0.614600160496859,11,13,6,3,10,6,5
2484,0,0,0.05671460900584835,0.48582514705144453,18,26,13,7,19,7,11
2485,0,0,0.9812053432526089,0.27265268269232446,3,2,1,0,2,0,3
2486,1,1,1.1477053663704049,0.759091543199711,41,67,46,19,48,23,18
2487,1,0,2.2774615942151333,0.09300686325632135,11,12,8,2,10,3,8
2488,0,0,1.063410262306662,0.2566582887009057,30,42,24,7,35,11,19
2489,0,1,2.2677589685589177,0.9061714179211358,15,21,15,3,18,13,2
2490,0,0,1.2339965598536147,0.22548269985142855,13,18,12,4,14,4,9
2491,0,0,2.4630693471047795,0.0784880510130972,7,7,3,1,6,1,6
2492,1,1,2.257528668576758,0.9052979671300526,8,10,5,1,9,7,1
2493,1,1,0.030987474766592138,0.5077462488573254,17,24,17,5,19,10,7
2494,0,0,6.371666821866812,0.0017063909909245112,18,22,13,5,17,4,14
2495,0,0,1.5441757379386285,0.17592906505909678,18,23,14,2,21,4,14
2496,0,1,0.9066323165216774,0.7123105365189801,14,16,9,4,12,6,8
2497,1,0,0.002556794170077592,0.4993608018056942,3,2,0,1,1,1,2
2498,0,0,2.3953791114720646,0.08352574172086236,8,9,5,0,9,0,8
2499,0,0,6.144045000696183,0.002141628141569818,11,13,7,0,13,0,11
2500,1,1,0.14165863578414406,0.5353555548858691,32,47,30,11,36,14,18
2501,1,1,2.524015499393807,0.9258083405045997,15,21,11,4,17,8,7
2502,1,0,1.1149912054828364,0.24694154501590815,11,11,5,3,8,3,8
2503,1,0,0.28026445849673864,0.43038894172980147,6,6,2,2,4,3,3
2504,1,1,2.353115030805469,0.9131815085135182,10,13,7,3,10,7,3
2505,1,0,0.995670529276887,0.2697934980323745,9,8,4,1,7,2,7
2506,1,1,1.541379355238669,0.8236651534228993,7,7,3,1,6,6,1
2507,1,1,4.694902259245741,0.9909410538721994,18,29,21,3,26,16,2
2508,0,0,2.5744312778420433,0.07080221853678814,23,30,17,4,26,7,16
2509,0,0,4.023939744728041,0.017568212638321423,22,28,16,5,23,5,17
2510,0,0,1.7414729707995837,0.14912593649636985,22,32,21,4,28,7,15
2511,0,0,3.4647209471477023,0.030332868749953668,13,15,9,1,14,1,12
2512,1,1,0.8209713622841879,0.6944424944478647,10,10,3,3,7,6,4
2513,1,1,1.3483616013030872,0.7938616409796109,12,16,7,3,13,8,4
2514,0,0,6.253517811482475,0.0019199816722671459,23,30,19,4,26,4,19
2515,1,0,0.8881875470402185,0.29148399565909067,5,5,3,0,5,0,5
2516,0,1,0.3343083597565655,0.5828072963885027,14,16,9,4,12,7,7
2517,1,1,1.6171576132854408,0.834402756819754,14,19,11,4,15,9,5
2518,0,0,3.2567105462413597,0.03708650057363427,16,20,11,3,17,2,14
2519,0,0,4.20162372307415,0.014750415781935589,12,14,8,2,12,3,9
2520,1,1,3.014048092821281,0.9532047529636193,22,34,23,5,29,14,8
2521,0,0,3.3218156559670575,0.03483031974094741,16,22,12,2,20,4,12
2522,1,0,1.61648721697579,0.1656898958213453,19,23,13,2,21,5,14
2523,0,0,2.5567045759316556,0.07197735518964732,14,17,9,1,16,1,13
2524,1,1,0.8622012138090676,0.703120345740746,14,16,10,4,12,8,6
2525,1,1,2.1717508131590026,0.8976838864164881,16,23,14,5,18,11,5
2526,1,1,1.281902281977599,0.7827734129142068,7,8,3,2,6,5,2
2527,1,1,0.03686071829465165,0.509214136317064,14,17,11,5,12,5,9
2528,1,0,2.4465742877994363,0.0796894260908334,31,46,28,6,40,9,22
2529,0,0,0.3213446692402442,0.4203480766535568,8,8,3,3,5,4,4
2530,0,0,0.3752705405308663,0.4072680897092005,16,22,11,4,18,6,10
2531,1,1,1.2304459581919096,0.7738966178519568,17,21,13,5,16,10,7
2532,0,0,1.9988688867875177,0.11932173281585823,16,21,13,5,16,5,11
2533,0,0,5.144716493529172,0.005796333647115404,17,21,13,2,19,3,14
2534,0,0,2.572120488424344,0.0709543945309904,10,11,5,1,10,2,8
2535,0,0,1.785073248587638,0.1436778204199367,17,22,13,5,17,6,11
2536,1,1,4.153921193538799,0.9845400412439987,17,25,15,4,21,13,4
2537,0,0,4.235386487947852,0.014267701231655994,14,17,13,2,15,3,11
2538,0,0,2.683449072391892,0.06395708145745882,8,9,3,1,8,1,7
2539,0,0,0.8335235757811343,0.30290054449224224,6,7,4,0,7,0,6
2540,1,1,3.586037385556527,0.973039120658207,11,14,10,1,13,10,1
2541,1,1,0.7770324297429785,0.6850401824598539,18,24,15,5,19,10,8
2542,0,0,1.496835840626063,0.18289792124815563,9,9,5,3,6,3,6
2543,0,1,1.3025655619130214,0.7862664462708876,7,7,4,1,6,5,2
2544,1,1,1.476920403345127,0.8141069751376773,23,33,22,7,26,16,7
2545,0,0,4.840483844252491,0.007841257935691015,34,50,28,15,35,14,20
2546,1,1,0.09141217199687257,0.5228371425974696,16,20,10,5,15,9,7
2547,1,0,0.22996351177423247,0.44276114789321297,25,36,22,8,28,12,13
2548,1,1,2.4764100199810826,0.9224714391774147,17,22,15,4,18,12,5
2549,1,1,4.414197863365743,0.9880405013728812,13,20,13,0,20,13,0
2550,0,0,4.600219802314729,0.009949636439934073,19,23,14,3,20,4,15
2551,1,1,3.1023193191793905,0.9569883133863045,20,27,16,4,23,12,8
2552,1,1,3.524456932232754,0.9713756895871156,8,11,7,0,11,8,0
2553,0,0,0.5957032773144917,0.3553273303007126,2,1,0,0,1,0,2
2554,0,0,3.497456827367764,0.029384678386679797,11,11,5,2,9,2,9
2555,0,1,0.22069592294441698,0.5549511209827915,18,25,15,8,17,11,7
2556,1,1,7.372180559042135,0.9993718985486651,20,30,18,3,27,15,5
2557,0,0,3.173130932586645,0.04018946794780365,11,15,8,0,15,0,11
2558,1,1,2.4768344851263837,0.9225017905828443,16,20,9,4,16,9,7
2559,1,1,0.6354125299006153,0.6537157218231688,10,11,4,3,8,6,4
2560,1,1,4.088650383222921,0.9835144871734111,20,34,25,4,30,18,2
2561,1,1,3.629832718248215,0.9741645516658247,24,38,27,3,35,19,5
2562,0,0,2.34497018695972,0.08746640000958861,8,8,4,1,7,2,6
2563,0,0,1.8614567175177499,0.13453335000228783,6,5,2,1,4,1,5
2564,1,1,0.7045983483981713,0.669206495542501,10,11,7,3,8,5,5
2565,1,1,0.9592176075904637,0.7229651297866475,15,19,9,5,14,9,6
2566,0,0,1.349266078187966,0.20599038493697097,5,5,2,1,4,1,4
2567,0,0,2.077856060784649,0.11126779839358858,15,17,10,3,14,4,11
2568,0,1,0.33567555210160593,0.583139681888468,12,15,10,2,13,8,4
2569,0,0,4.107012246062521,0.01619042647820179,9,12,7,1,11,1,8
2570,0,1,1.66172453630276,0.8404693657251646,29,42,24,12,30,14,15
2571,0,0,7.425286519057591,0.0005956350970849345,22,28,14,2,26,3,19
2572,1,1,0.6601848400848798,0.6593019089900884,9,10,5,2,8,6,3
2573,1,1,5.3010237771904025,0.9950382554291125,15,23,15,1,22,14,1
2574,0,0,10.459925844469973,2.8661537052387942e-05,28,38,22,4,34,5,23
2575,0,0,3.318980847730807,0.03492574373583712,21,27,16,9,18,9,12
2576,1,1,1.0272660919727903,0.7363855275451446,27,40,24,10,30,17,10
2577,1,0,2.0180883418739324,0.11731680513074771,29,41,22,7,34,9,20
2578,1,1,4.12704571883867,0.98412559900711,12,19,12,0,19,12,0
2579,0,0,4.465962511840459,0.011363025299406138,15,18,10,5,13,4,11
2580,0,0,0.4845202424166426,0.3811853054380804,15,19,8,7,12,6,9
2581,1,1,4.200296716707241,0.9852302866220511,32,51,33,12,39,20,12
2582,0,0,2.7262676565709247,0.06144104030895137,15,15,6,3,12,4,11
2583,0,0,0.532517155857176,0.36992999298810314,33,50,30,12,38,15,18
2584,0,0,3.0033968906585673,0.04727264871031944,13,15,7,3,12,3,10
2585,1,1,5.155277876800689,0.9942642122377195,26,36,23,6,30,19,7
2586,1,1,0.05304986774133935,0.5132593574431206,10,11,5,2,9,6,4
2587,0,0,4.224335605987767,0.014423959483816695,22,27,17,4,23,5,17
2588,0,0,2.8505859010098114,0.05465103914899927,18,24,14,7,17,9,9
2589,0,0,0.5552359211976021,0.364650490588599,15,21,12,6,15,6,9
2590,0,0,3.296440418808011,0.035693505918335866,19,24,15,3,21,4,15
2591,0,0,3.0084394509550076,0.047046059915855976,29,44,28,6,38,7,22
2592,0,0,4.194972085404123,0.01484739563943871,14,17,11,0,17,0,14
2593,1,1,4.978872220415912,0.9931652163881017,17,27,17,1,26,16,1
2594,1,1,1.9423669735049607,0.8746119499816466,8,10,6,1,9,7,1
2595,1,1,2.710370526396943,0.9376358186240693,9,12,7,0,12,9,0
2596,1,1,0.26451948901627453,0.5657469559678512,12,14,8,3,11,7,5
2597,1,1,2.31506251970047,0.9101168512492779,7,8,5,1,7,6,1
2598,0,0,4.771301649988683,0.008398221387535099,19,22,10,3,19,4,15
2599,0,0,4.594698165522113,0.010004175540374582,30,46,29,8,38,9,21
2600,0,0,4.468785703721537,0.011331353537234023,14,18,10,3,15,4,10
2601,0,0,0.7443071593610417,0.3220630055298741,15,18,9,4,14,5,10
2602,1,1,0.7400660348378447,0.6770102960706377,20,25,14,9,16,9,11
2603,1,1,0.10688326936024684,0.5266954080751065,31,46,25,13,33,18,13
2604,1,1,3.083516540446217,0.9562076746415776,17,25,16,4,21,12,5
2605,0,1,0.42583546325567956,0.6048787782872864,14,18,10,6,12,6,8
2606,1,0,1.4639198493776457,0.18786852646885033,14,20,13,6,14,5,9
2607,1,1,3.4316305538872207,0.9686785772191547,16,23,13,3,20,13,3
2608,1,1,2.4580079397927292,0.9211450872587287,13,16,7,3,13,9,4
2609,0,0,2.6917538200420843,0.0634617014049147,32,49,30,9,40,10,22
2610,1,1,4.569926811994707,0.98974748508522,19,27,16,3,24,15,4
2611,0,0,5.652522908315918,0.003496385980579775,12,12,5,1,11,1,11
2612,1,1,1.980330798337639,0.8787164209849809,15,18,11,4,14,8,7
2613,0,1,2.1097208022362413,0.8918444053368509,23,35,25,6,29,16,7
2614,1,0,0.7660983098034948,0.3173237239151775,11,13,8,2,11,3,8
2615,1,1,2.870713578332531,0.9463795702608075,19,25,10,8,17,10,9
2616,0,0,1.1283898404430994,0.2444583725420595,4,3,1,0,3,0,4
2617,0,0,2.6863615450310325,0.06378294297358478,5,5,3,0,5,0,5
2618,0,0,1.6880047615754181,0.15603841363659,15,18,10,1,17,1,14
2619,0,0,1.9580055618172714,0.12368305366335641,9,9,6,1,8,2,7
2620,1,1,2.0096208890095824,0.8818035146587839,15,21,15,2,19,12,3
2621,0,0,1.2173643470398856,0.22840060910032,13,15,9,5,10,5,8
2622,1,1,4.731178947920589,0.9912609726657124,16,25,18,1,24,15,1
2623,1,1,1.7753999680997599,0.8551279252612948,5,4,1,1,3,4,1
2624,0,1,0.49799041397883603,0.6219869549375802,10,11,5,3,8,6,4
2625,1,1,1.23813859860428,0.7752398442295121,22,29,18,7,22,10,12
2626,1,1,2.37496383126099,0.9148981389540632,9,11,5,2,9,6,3
2627,0,0,3.7516986871815425,0.022939266269384695,14,16,8,2,14,2,12
2628,0,0,1.453825335013124,0.189413541267619,33,51,30,11,40,11,22
2629,0,0,2.784788223652756,0.058151748435414374,22,31,19,6,25,7,15
2630,0,0,0.7645199116763097,0.31766574986730123,2,1,0,0,1,0,2
2631,0,0,3.1632227227631433,0.040573416042201105,15,17,9,4,13,4,11
2632,1,1,0.1041911047812018,0.5260242376568736,9,9,5,3,6,5,4
2633,1,1,1.7719145764432664,0.854695605785097,4,4,2,0,4,4,0
2634,1,1,2.5999319856594383,0.9308572022410976,20,31,24,4,27,16,4
2635,1,1,5.427622041421764,0.9956256876517382,15,23,13,3,20,13,2
2636,0,0,0.7888170732943207,0.3124227231380464,8,9,4,1,8,1,7
2637,0,0,0.5957032773144917,0.3553273303007126,2,1,0,0,1,0,2
2638,1,1,1.688052335339018,0.8439678512701403,3,2,1,0,2,3,0
2639,1,1,2.9317139811575066,0.9493920897520589,11,14,9,1,13,10,1
2640,1,1,5.3528670659688995,0.9952877531686332,13,20,13,0,20,13,0
2641,1,1,3.3827183733681583,0.9671600545027486,12,16,10,1,15,10,2
2642,0,0,2.2472965258818225,0.09558291626419047,9,10,7,0,10,0,9
2643,0,1,0.34117291974930786,0.5844754110007695,4,3,1,1,2,2,2
2644,0,0,0.8176511262844368,0.30626248794115607,3,2,1,0,2,0,3
2645,1,1,4.339842125460371,0.9871292301443098,26,37,24,5,32,18,8
2646,1,1,4.544463633688392,0.9894858514345228,33,52,32,12,40,19,14
2647,1,1,2.64417349135233,0.9336509673972145,15,22,14,2,20,13,2
2648,1,1,0.9768917461747935,0.7264910356646717,8,8,5,1,7,4,4
2649,1,1,0.4604561941973493,0.6131223925021927,9,9,3,4,5,4,5
2650,1,1,4.066939858819738,0.9831587581194802,18,26,13,6,20,12,6
2651,0,0,3.326046992691858,0.03468835382285196,19,27,16,10,17,7,12
2652,1,1,0.5422527407241673,0.6323363068583163,24,32,18,7,25,13,11
2653,0,0,3.21096478623179,0.038755177074587754,10,10,5,1,9,2,8
2654,1,1,1.9423420575241717,0.8746092175230105,11,14,8,2,12,8,3
2655,0,0,1.1958032476250784,0.232222636611901,13,18,10,4,14,4,9
2656,1,1,8.671149295372599,0.9998285674636161,32,48,30,9,39,21,11
2657,1,1,2.86772305157778,0.946227612408708,19,25,11,7,18,9,10
2658,1,0,0.8617613639500947,0.29697147765580845,12,15,10,2,13,5,7
2659,0,1,0.9048652337438232,0.7119482826179948,8,9,6,1,8,6,2
2660,1,1,1.7608658165634201,0.8533180644486147,4,3,1,0,3,4,0
2661,1,1,3.9582455087305544,0.9812612563818949,34,53,32,11,42,19,15
2662,1,1,1.1370775521564098,0.7571426700769132,9,10,6,2,8,6,3
2663,1,1,1.2938621300898105,0.7848001773546833,7,7,3,2,5,4,3
2664,1,1,4.773096365621571,0.9916167112712893,21,32,20,3,29,18,3
2665,0,0,0.826776090362862,0.30432718012175575,8,8,4,1,7,2,6
2666,1,1,4.071163289871258,0.9832285455513871,11,15,8,1,14,10,1
2667,1,1,1.0005663528547117,0.7311699157870339,12,13,4,6,7,6,6
2668,0,0,3.8717179965862263,0.020397830420336605,10,10,4,1,9,1,9
2669,0,0,8.56546054906539,0.0001905394864913923,23,33,19,1,32,1,22
2670,1,1,5.2235577698722935,0.9946407510293535,24,36,24,6,30,19,5
2671,1,0,1.98666358141386,0.12061028682532715,7,7,3,1,6,1,6
2672,1,1,0.4249244458523491,0.6046610239347615,11,13,6,3,10,6,5
2673,0,0,3.568563426554454,0.027423099905447335,19,22,11,5,17,5,14
2674,0,0,0.21704621438629013,0.44595046522034276,12,16,10,3,13,4,8
2675,1,1,2.211728106128464,0.9012977659679393,9,13,9,0,13,9,0
2676,1,1,0.1101169754481075,0.5275014598283054,15,18,10,4,14,8,7
2677,1,1,0.574737386891663,0.6398555822866918,2,1,0,0,1,2,0
2678,1,1,0.5726595368761667,0.6393766226516904,9,9,4,4,5,3,6
2679,1,1,1.8436775760110378,0.8633830675902118,9,12,8,1,11,8,1
2680,0,0,6.151430731365789,0.002125902423802506,25,33,18,6,27,7,18
2681,1,1,4.419888691229187,0.9881075604362574,13,19,12,1,18,12,1
2682,0,0,0.7582598513299662,0.319024190492194,13,16,9,4,12,4,9
2683,1,0,1.332326940372545,0.2087747224794697,17,20,13,5,15,8,9
2684,1,1,2.209105022017848,0.9010641703775972,14,18,12,1,17,11,3
2685,1,0,0.2597033974641521,0.4354366210672628,1,0,0,0,0,0,1
2686,0,0,6.973945116860159,0.000935077978865495,38,58,38,8,50,12,26
2687,1,1,3.740365045944194,0.9768053340208347,18,28,16,4,24,13,5
2688,0,1,1.7292300316958407,0.8493139063697984,10,12,6,2,10,8,2
2689,0,0,2.6087362327602315,0.0685782832402615,18,25,14,8,17,6,12
2690,1,0,0.14616752016184442,0.46352304086149787,7,7,2,2,5,3,4
2691,0,0,1.2302228151820196,0.2261424302417181,9,11,6,2,9,3,6
2692,0,0,2.0268717833514174,0.11641030122538731,18,25,15,7,18,6,12
2693,1,1,4.4230949810625,0.9881451786730658,12,17,11,1,16,11,1
2694,0,1,2.9537904056395092,0.9504423281543937,21,28,18,5,23,13,8
2695,0,0,7.085765426694054,0.0008362340578244032,32,45,25,9,36,9,23
2696,1,1,1.3760717375239468,0.7983593630278486,5,5,2,0,5,5,0
2697,0,0,3.7776696530063285,0.022364333129813674,26,38,22,8,30,7,19
2698,0,0,3.8660742414108418,0.020510908350093726,18,22,10,3,19,4,14
2699,1,1,1.2903366943461492,0.7842041727365372,6,6,3,1,5,4,2
2700,0,0,0.5775966211779915,0.35948579839193895,27,37,20,10,27,12,15
2701,0,1,2.1411271871273003,0.8948367304636152,14,18,10,4,14,8,6
2702,1,1,2.0343878637564163,0.8843605687432846,9,11,5,2,9,7,2
2703,1,1,1.2688486152906333,0.7805455861274331,22,31,20,5,26,12,10
2704,1,1,0.25937577398228995,0.5644828370348487,19,27,17,6,21,11,8
2705,1,1,0.35755514175241576,0.5884484742496288,4,3,1,1,2,3,1
2706,0,0,4.220649118321149,0.014476460177022421,29,40,23,5,35,7,22
2707,0,0,4.986923181382142,0.006780349552515497,33,48,27,11,37,11,22
2708,0,0,3.3326785381814905,0.03446697995755976,40,67,46,15,52,18,22
2709,0,0,3.5182721673307613,0.028796779807564787,6,5,2,0,5,0,6
2710,1,1,4.502382131016126,0.989038912022122,19,28,16,6,22,14,5
2711,0,0,4.219897254883936,0.01448719084838701,17,20,11,3,17,4,13
2712,1,1,0.9200024740938904,0.7150426098144052,9,12,5,2,10,7,2
2713,0,0,2.8038730057245473,0.05711524444229821,11,12,6,1,11,2,9
2714,0,1,0.47493477745703894,0.61655108499596,19,27,15,8,19,9,10
2715,0,0,0.49052504122160645,0.37976988916468446,6,6,3,1,5,1,5
2716,1,1,2.3604539682668055,0.9137615855366311,25,34,24,5,29,12,13
2717,0,0,2.292106967774078,0.0917787716054771,11,13,6,1,12,1,10
2718,0,1,0.5278630608508816,0.6289845670810958,26,37,21,10,27,14,12
2719,1,1,1.8690098795344292,0.8663436707060433,17,24,14,5,19,11,6
2720,0,0,1.0637483246580361,0.2565937968449249,12,13,7,2,11,3,9
2721,0,0,3.718082591976866,0.02370491220716442,12,14,8,2,12,3,9
2722,0,0,0.7708018356485933,0.31630567864057135,12,15,8,3,12,4,8
2723,0,1,0.40834640322729077,0.6006913111631782,13,18,12,3,15,9,4
2724,0,0,1.7359225934074896,0.1498315818268966,6,5,1,0,5,0,6
2725,1,1,0.8387974108783594,0.6982118763993861,25,36,24,7,29,13,12
2726,1,1,2.205378147193175,0.9007314317230961,6,8,4,0,8,6,0
2727,0,0,4.7288666517290165,0.008759080733006352,12,12,8,1,11,1,11
2728,0,0,4.146073175104786,0.015579868402338493,20,27,17,6,21,6,14
2729,1,1,1.630816110728819,0.8362814070941087,18,23,13,6,17,11,7
2730,1,0,0.5352263997924345,0.369298740387341,17,21,11,3,18,6,11
2731,1,1,1.6138426082906634,0.8339441987669627,7,8,5,1,7,6,1
2732,1,0,1.0728876148728599,0.2548543276387929,25,37,20,7,30,10,15
2733,1,1,3.210554601683605,0.9612295393415654,21,32,20,6,26,13,8
2734,0,0,0.03655106756352966,0.4908632502964524,8,9,4,3,6,2,6
2735,0,0,0.5082061317011135,0.3756141441947616,15,19,10,5,14,5,10
2736,0,1,0.9356954393195529,0.7182293367379335,19,28,19,5,23,10,9
2737,1,1,2.0707443140672877,0.8880269937292362,9,11,6,1,10,8,1
2738,1,0,0.5433766035395493,0.36740244841468217,13,16,8,5,11,5,8
2739,1,1,10.042378265775806,0.9999564857366706,31,56,40,8,48,27,4
2740,1,0,0.2867313698823206,0.42880426948454653,11,15,9,4,11,4,7
2741,0,0,1.3722813276934713,0.20225151366599958,4,3,1,0,3,0,4
2742,1,1,2.9498793944362802,0.9502577879763419,16,21,12,5,16,10,6
2743,1,1,3.8687732673762456,0.9795432455347005,18,26,17,2,24,13,5
2744,1,1,1.5346384769213544,0.822683965373557,17,24,14,4,20,12,5
2745,0,1,1.6276219284050883,0.8358436063225088,6,5,1,1,4,5,1
2746,1,1,0.8025647113431924,0.6905228302801252,4,4,2,0,4,4,0
2747,1,1,0.7028359572451768,0.6688162402138209,9,9,4,3,6,5,4
2748,0,1,1.2574889000697418,0.7785935330491268,6,6,3,1,5,4,2
2749,1,1,3.1229677597405594,0.9578302632844535,12,16,10,1,15,10,2
2750,0,0,3.008800664500546,0.04702986837648426,11,10,3,2,8,3,8
2751,1,0,0.6572750915839365,0.3413519898010383,10,11,7,2,9,3,7
2752,0,0,1.0535370576212175,0.25854646732502895,13,16,10,3,13,7,6
2753,1,1,2.3972979866000026,0.9166210292812396,25,33,19,7,26,16,9
2754,0,0,1.0603520862525233,0.2572421763065186,21,29,18,7,22,8,13
2755,1,1,1.4266452699501178,0.8063780717430691,7,6,2,2,4,4,3
2756,0,0,0.8435993260649033,0.30077726627085044,7,7,3,3,4,3,4
2757,0,0,2.633419892843111,0.06701829857682828,20,26,18,4,22,7,13
2758,0,0,0.9352499523167377,0.28186082788457145,20,24,14,4,20,9,11
2759,0,0,1.8485840204928403,0.1360392349557339,20,27,17,4,23,5,15
2760,0,0,4.611074460883495,0.00984327789373296,22,27,14,6,21,7,15
2761,1,0,0.6961224254794911,0.332672495975304,23,32,17,8,24,10,13
2762,0,0,2.4615169632330507,0.0786004048281066,22,33,22,4,29,5,17
2763,0,0,2.8564077105920154,0.05435103808548569,18,24,12,8,16,8,10
2764,1,1,2.438223537189857,0.9196959844495918,14,18,10,3,15,8,6
2765,1,1,0.5404567890665468,0.6319186721154751,3,2,0,1,1,2,1
2766,0,0,1.7336715402615948,0.15011855173856659,9,10,7,2,8,1,8
2767,0,1,1.7511249915476592,0.85209464010565,9,11,4,2,9,7,2
2768,1,0,0.6046270305317551,0.35328581695841665,22,32,20,6,26,11,11
2769,0,0,8.169676526809866,0.0002830294516441567,24,31,20,6,25,5,19
2770,0,0,2.487979967368461,0.07670513673776569,9,8,2,1,7,1,8
2771,0,1,0.7392995139842042,0.6768426602459847,25,33,18,8,25,13,12
2772,0,0,3.1523233534218473,0.04099982914974243,22,31,21,4,27,8,14
2773,0,0,0.49257225964638757,0.3792877965024827,13,14,9,3,11,5,8
2774,1,1,2.162141817377705,0.8967979452538781,5,5,2,0,5,5,0
2775,1,1,3.6016734146469798,0.9734462961439191,12,15,8,2,13,9,3
2776,1,1,1.0338655119396798,0.7376646193367429,14,17,12,4,13,7,7
2777,0,0,7.811811705313471,0.00040475988341637237,25,35,21,1,34,1,24
2778,1,1,0.3844080277534969,0.5949358241593007,16,19,7,7,12,7,9
2779,0,1,1.1026625025555483,0.7507586458972741,11,13,6,4,9,5,6
2780,0,0,0.9024144723853605,0.2885545753874702,6,6,2,1,5,1,5
2781,0,0,2.5987399699090252,0.0692195577755721,15,18,11,4,14,4,11
2782,1,1,2.7472919489935146,0.9397602269519444,9,11,6,1,10,8,1
2783,1,1,1.3211969025256571,0.7893807709875579,4,4,2,0,4,4,0
2784,0,0,1.0513844369853311,0.25895933954743366,11,12,6,1,11,1,10
2785,0,0,2.0021830921783854,0.11897390182595213,15,18,11,2,16,3,12
2786,0,0,5.6005501881282385,0.003682220893803101,12,13,6,1,12,1,11
2787,1,1,2.458495600587433,0.9211805021118286,14,16,10,3,13,10,4
2788,1,0,1.6428657752077038,0.16207549316922254,17,22,12,3,19,5,12
2789,1,1,2.395509713840834,0.9164842552411909,33,51,29,15,36,19,14
2790,0,0,4.169045200048444,0.015231436045860414,20,27,16,5,22,4,16
2791,1,1,1.8574294384985703,0.8649970467335869,8,9,5,2,7,6,2
2792,1,0,1.593185389943709,0.1689362067504282,19,22,11,4,18,6,13
2793,0,0,0.5830571128676598,0.3582294558166116,27,42,27,9,33,12,15
2794,1,1,0.47567950275143733,0.6167271345664376,23,33,21,8,25,11,12
2795,0,0,0.8274457076100621,0.3041854325942004,29,44,25,8,36,10,19
2796,1,1,1.5008359491540482,0.8176991219463523,9,11,6,1,10,8,1
2797,1,1,3.4046962909872693,0.9678509840433476,20,28,15,8,20,13,7
2798,1,1,3.073241400989983,0.9557753851267154,12,17,12,3,14,10,2
2799,0,0,8.319970750605336,0.00024354366139733852,30,39,21,6,33,5,25
2800,0,0,5.973926689659749,0.0025377746856917183,24,30,17,6,24,7,17
2801,0,1,1.5726492618960606,0.8281609535932906,21,27,13,10,17,10,11
2802,0,0,0.6726641618685174,0.33790054730464025,18,24,11,6,18,6,12
2803,0,1,1.678222522679694,0.8426690203369995,31,48,33,7,41,20,11
2804,1,1,0.6463938478121536,0.6561973650217405,10,11,5,3,8,5,5
2805,0,1,0.22776605867705624,0.5566966203341777,25,34,23,5,29,16,9
2806,1,1,5.680834323793955,0.9966008817938409,12,20,14,0,20,12,0
2807,0,1,0.629266103080057,0.6523230346766262,6,5,1,2,3,4,2
2808,0,0,5.180468901701249,0.005593900303189181,24,31,17,5,26,5,19
2809,1,1,3.3488335937690428,0.9660666196008515,16,23,14,2,21,11,5
2810,0,1,0.5113299342755577,0.6251181903225971,5,5,3,3,2,4,1
2811,1,1,1.688052335339018,0.8439678512701403,3,2,1,0,2,3,0
2812,1,1,6.94090535763506,0.9990335415818589,22,37,28,4,33,20,2
2813,1,0,0.3235103968956465,0.4198204762644119,6,6,4,2,4,3,3
2814,1,1,1.688052335339018,0.8439678512701403,3,2,1,0,2,3,0
2815,0,0,5.794870094712125,0.0030338932007085706,28,40,23,5,35,5,23
2816,1,0,0.2597033974641521,0.4354366210672628,1,0,0,0,0,0,1
2817,1,1,1.4669419730058466,0.8125921359566051,4,3,2,0,3,4,0
2818,1,1,1.550918319051598,0.8250463260642537,17,21,11,6,15,9,8
2819,1,1,1.0290824329084414,0.7367379676471766,7,8,3,2,6,5,2
2820,0,0,5.320027216421825,0.0048687993758549375,15,19,10,0,19,0,15
2821,0,0,4.584066100695706,0.010110026942162897,15,16,9,1,15,2,13
2822,0,0,3.8562575693823486,0.020709058461121588,14,16,8,4,12,4,10
2823,1,0,2.7812129101482883,0.05834787842098843,9,9,5,1,8,2,7
2824,0,0,3.0045238717427525,0.04722191768689643,17,20,11,5,15,6,11
2825,1,1,1.8606567170958976,0.8653734754095939,5,5,4,0,5,5,0
2826,0,0,3.5394039077277824,0.02821162567971891,20,24,15,4,20,5,15
2827,1,1,4.081379680233686,0.9833961865168273,23,33,16,9,24,12,11
2828,1,1,5.359144713653782,0.9953171042412026,12,18,12,0,18,12,0
2829,1,1,0.5189004336380092,0.6268906149964419,14,18,11,6,12,10,4
2830,1,1,1.0421827441728166,0.7392709484200939,6,6,3,1,5,4,2
2831,1,1,3.380453686002317,0.9670880485229006,11,17,8,1,16,10,1
2832,0,0,4.187491574635691,0.014957210727685077,12,13,7,2,11,3,9
2833,0,0,5.756868006411502,0.003151035918170342,11,12,7,0,12,0,11
2834,0,0,0.23496066853949227,0.4415285859340836,37,63,38,15,48,17,20
2835,1,1,2.0513111217532316,0.8860800332538299,10,12,8,2,10,8,2
2836,1,1,2.415054508263034,0.9179681047972155,7,9,4,1,8,6,1
2837,0,0,0.9005558159469298,0.2889362904206787,23,32,17,8,24,8,15
2838,1,1,3.029890277513289,0.9539063488120592,6,8,4,0,8,6,0
2839,1,1,0.381137138172841,0.5941473375312663,32,50,29,16,34,16,16
2840,0,0,3.762148338302754,0.022706221526358594,13,14,8,3,11,4,9
2841,1,1,1.7719145764432664,0.854695605785097,4,4,2,0,4,4,0
2842,1,1,0.4570818824572449,0.6123216896634438,7,6,3,1,5,5,2
2843,0,0,1.145981006625575,0.24122393404459774,21,27,17,3,24,5,16
2844,0,0,3.7636929034254596,0.02267197187985226,14,17,8,4,13,4,10
2845,1,1,3.9935164682001028,0.9818989147201133,20,30,23,2,28,18,2
2846,0,0,4.427299777583524,0.011805666110081603,19,25,13,4,21,4,15
2847,1,1,1.3538280564127414,0.7947547639423342,19,26,16,6,20,14,5
2848,0,1,0.04727091886643264,0.511815529609309,15,19,11,4,15,6,9
2849,1,0,0.9497662424389954,0.2789318349407208,22,28,19,3,25,5,17
2850,0,0,2.0764641740778145,0.11140551276878741,8,8,4,2,6,2,6
2851,1,0,0.5343025748697192,0.36951394105294966,29,44,27,8,36,10,19
2852,0,0,1.8715398454933996,0.13336365010088747,9,9,4,1,8,1,8
2853,1,1,1.54477471125829,0.8241577560568583,30,46,31,10,36,17,13
2854,1,1,3.201985625912788,0.9609089314823014,21,32,22,3,29,15,6
2855,1,1,0.3054504586381501,0.5757743830318784,37,58,35,16,42,16,21
2856,1,1,2.6633819062896666,0.9348310022994395,21,31,18,6,25,12,9
2857,0,1,1.1668449156555,0.7625742459954125,9,11,5,1,10,7,2
2858,0,0,2.364540418655009,0.08591694065518418,14,18,12,4,14,4,10
2859,1,1,3.2896592617323464,0.9640723538829015,14,20,11,2,18,11,3
2860,0,0,1.6216966816201066,0.1649710099582029,28,42,25,9,33,9,19
2861,0,1,0.7917372014728419,0.6882042196577653,14,16,10,5,11,7,7
2862,1,1,1.9729697814076057,0.8779297393953968,17,22,12,6,16,10,7
2863,1,0,0.2796873050121643,0.4305304390695387,6,5,2,1,4,2,4
2864,1,1,3.3593661612807773,0.9664102074328321,13,17,10,3,14,10,3
2865,0,1,0.7775410613724663,0.6851499145567462,12,14,8,4,10,6,6
2866,1,0,0.8765187424374563,0.2938997000590945,14,18,9,4,14,5,9
2867,1,1,3.5052425731960186,0.9708365687881857,10,13,8,1,12,9,1
2868,1,1,5.244320569138139,0.9947502986963526,35,55,34,10,45,21,14
2869,1,1,2.6608382761874276,0.9346758677649893,19,25,15,6,19,10,9
2870,0,0,1.7932737025867018,0.1426718267814161,10,10,4,1,9,2,8
2871,1,0,1.3891328817733397,0.19954622341639028,19,25,16,4,21,5,14
2872,1,1,1.130942093155507,0.7560127171422886,5,4,2,1,3,4,1
2873,0,0,6.955306714299457,0.0009526530119730037,22,32,20,2,30,2,20
2874,1,1,0.4914041728896905,0.620437163759876,9,9,5,3,6,5,4
2875,1,1,0.5011743632245345,0.6227352712039697,7,7,3,2,5,4,3
2876,0,0,2.277147902688803,0.0930333285813606,22,27,15,7,20,8,14
2877,0,1,1.6215138178626902,0.8350037979962837,27,42,23,11,31,15,12
2878,1,1,2.875960421052979,0.9466452000234157,15,20,11,4,16,11,4
2879,1,1,2.3766362248406288,0.9150282604212289,12,14,7,3,11,9,3
2880,0,0,0.5254323165241983,0.3715828562861476,25,38,24,10,28,10,15
2881,0,0,3.6794415159689873,0.02461583398606093,7,7,3,0,7,0,7
2882,0,1,0.9241430230733085,0.7158855225820097,25,39,25,14,25,13,12
2883,1,1,4.389411974147891,0.9877440488138967,15,23,16,2,21,13,2
2884,1,0,0.2709290078236508,0.43267903919932116,8,8,4,1,7,2,6
2885,1,1,3.8252158879245495,0.9786519547017303,17,25,16,2,23,15,2
2886,0,0,2.9048263587023526,0.05191549398354134,11,14,7,2,12,2,9
2887,1,1,2.3578737392545666,0.9135580428170849,7,9,6,1,8,6,1
2888,1,1,0.20106915820243998,0.5500986175621455,21,31,21,5,26,13,8
2889,0,0,1.739404016561188,0.14938865132505197,38,63,42,15,48,16,22
2890,0,1,1.9676141427694211,0.8773546176544946,9,10,5,2,8,5,4
2891,1,1,1.5925637078830535,0.8309764931345365,20,29,16,6,23,14,6
2892,0,0,0.43625339853602596,0.39263407058413147,13,16,10,2,14,4,9
2893,0,0,5.479344415225037,0.0041547301433182415,27,40,24,5,35,5,22
2894,0,0,3.7694689729274597,0.022544338250965912,26,36,19,7,29,7,19
2895,0,1,2.4102743345797997,0.9176074250505266,20,25,13,7,18,12,8
2896,1,1,3.637370953750123,0.9743535971979065,19,28,21,4,24,14,5
2897,1,1,2.536337021398457,0.9266502442656143,10,14,8,1,13,9,1
2898,1,1,3.397742775675277,0.9676339169485394,16,24,17,3,21,14,2
2899,1,0,1.489026022895322,0.18406796105788292,10,9,5,2,7,3,7
2900,0,0,2.745380261426477,0.06034808650797141,15,18,12,3,15,4,11
2901,0,0,1.8888535020279695,0.13137524767779019,15,20,10,1,19,2,13
2902,0,0,0.7840998767540612,0.3134369421449853,19,25,18,4,21,12,7
2903,1,1,1.9133809882397743,0.871398508038959,18,25,15,4,21,10,8
2904,1,1,2.2573547067221793,0.9052830517097363,10,13,8,1,12,9,1
2905,1,0,0.4011505005185681,0.4010359511866971,18,23,16,2,21,5,13
2906,0,0,3.9954692423331055,0.018066410415272238,13,13,5,2,11,3,10
2907,0,0,4.554156879349802,0.010413780903818615,22,31,16,8,23,8,14
2908,1,1,2.1802655003894453,0.8984632954694658,11,15,9,1,14,9,2
2909,1,1,3.175645570271059,0.9599074202980321,21,32,20,5,27,14,7
2910,0,0,3.0686637305216187,0.04441851170878586,4,3,2,0,3,0,4
2911,1,1,2.2338711408808996,0.9032501837591236,20,30,17,7,23,11,9
2912,0,0,2.231410828516932,0.09696503460399952,12,15,8,3,12,2,10
2913,0,1,2.158178027556998,0.8964305135695918,19,26,14,5,21,12,7
2914,0,0,0.5441294712346751,0.36722748596853616,32,50,29,13,37,12,20
2915,1,1,3.297456729314617,0.9643414584583817,26,35,23,8,27,12,14
2916,0,0,4.537151341984618,0.010590495658717503,19,21,12,2,19,3,16
2917,1,1,2.4227342913926453,0.9185445597225665,12,16,9,2,14,9,3
2918,0,0,3.490799719122837,0.029575143240267665,9,9,4,2,7,3,6
2919,0,0,0.8511760292048001,0.29918621676601176,3,2,0,0,2,0,3
2920,0,1,0.7111632680587392,0.6706581485564174,35,51,30,12,39,15,20
2921,0,0,3.487914463970944,0.029658063863729267,16,19,10,5,14,5,11
2922,1,1,2.2281622675684334,0.9027501395819342,7,8,5,1,7,6,1
2923,0,0,1.3418140927380504,0.2072118899637223,3,2,0,0,2,0,3
2924,1,1,3.5137019977383677,0.9710751282384882,11,14,8,2,12,9,2
2925,1,1,0.8140875330831727,0.6929798481718767,8,8,4,3,5,5,3
2926,0,0,1.7609078955137902,0.1466766687612555,8,8,3,2,6,1,7
2927,0,0,5.918199505711099,0.0026828223222979952,30,44,29,7,37,6,24
2928,1,1,0.019654222649116093,0.5049133974975646,34,54,34,15,39,17,17
2929,1,1,3.8283025208075476,0.9787163463963496,13,20,12,1,19,12,1
2930,1,1,1.8113446719059534,0.8595243115079843,13,16,8,3,13,7,6
2931,1,1,0.9145766617725017,0.713935775613833,15,20,13,6,14,8,7
2932,0,1,1.4724914342764452,0.8134357764409701,8,9,3,2,7,6,2
2933,1,1,0.9762347433218863,0.7263604685837509,12,14,8,4,10,6,6
2934,1,1,4.937853402301047,0.9928810696256586,12,17,11,1,16,11,1
2935,1,1,2.3378710067908175,0.9119653096841673,27,39,21,12,27,15,12
2936,0,0,4.607439583374627,0.009878768011680639,12,15,8,1,14,1,11
2937,0,0,0.7933647757430995,0.31144664382673104,8,10,5,3,7,3,5
2938,1,1,1.4815111712114204,0.8148007256923091,26,40,25,13,27,14,12
2939,1,1,5.136889748687055,0.9941583879814675,14,21,15,0,21,14,0
2940,1,1,3.8265995264040953,0.9786808429638348,28,43,26,7,36,20,8
2941,0,0,0.5898127145808116,0.35667782743107,22,33,18,11,22,11,11
2942,0,1,0.042550308036389595,0.5106359723297433,11,16,10,5,11,6,5
2943,0,0,2.354668432166518,0.08669541522906232,27,35,19,9,26,10,17
2944,1,1,1.8826404852958303,0.8679141237506676,8,10,5,1,9,6,2
2945,0,0,2.4319950980195624,0.08076522280150977,25,36,20,10,26,10,15
2946,1,1,3.9093293519648524,0.9803403086897129,8,12,6,0,12,8,0
2947,0,0,1.810924497965498,0.14052642891138423,15,22,13,3,19,2,13
2948,1,1,1.945484951009785,0.8749534865479353,8,10,5,1,9,6,2
2949,0,1,0.1710303689054451,0.5426536696303571,6,5,2,2,3,3,3
2950,1,1,0.8072549034612782,0.6915242325883262,4,3,1,0,3,4,0
2951,1,1,1.733998445329206,0.849923151011325,17,23,13,5,18,9,8
2952,1,1,0.6746259752770012,0.662538217310345,12,17,10,5,12,9,3
2953,1,1,0.45174157577471763,0.611053229318021,14,18,9,6,12,6,8
2954,1,1,1.0214138666076396,0.7352479120319098,9,9,3,2,7,6,3
2955,1,1,1.5135651934037575,0.8195889674242522,18,26,17,7,19,10,8
2956,1,1,1.5584498252279615,0.8261308004485854,17,22,13,5,17,8,9
2957,0,0,1.227759713482305,0.22657376877953772,19,27,12,10,17,9,10
2958,1,1,4.240526044487693,0.9858044020191,15,20,12,3,17,11,4
2959,0,0,3.526410578688761,0.0285700393483177,7,6,2,0,6,0,7
2960,1,1,0.09125302330413998,0.5227974382816915,10,11,7,3,8,5,5
2961,0,0,1.8949438825265539,0.13068179806670965,9,11,6,2,9,1,8
2962,1,1,2.1966130031713593,0.8999449448587578,10,12,6,1,11,8,2
2963,1,1,0.14656931777607718,0.536576872457083,9,11,5,5,6,4,5
2964,1,1,2.167053228649525,0.89725161815021,10,13,10,1,12,9,1
2965,0,0,3.454314587702468,0.03064044930344534,17,22,12,5,17,5,12
2966,0,0,4.989291778496343,0.0067644171482780235,16,20,12,3,17,3,13
2967,0,1,0.11626084054101471,0.5290325157989085,4,3,1,1,2,3,1
2968,1,1,0.5270278592559179,0.6287896409590863,10,12,8,2,10,7,3
2969,1,1,1.7194158432052071,0.8480535779576681,22,32,18,9,23,10,12
2970,0,0,7.3055593066158755,0.0006713426640068132,21,26,14,5,21,4,17
2971,1,0,0.5446044365511726,0.3671171245464454,22,31,18,4,27,6,16
2972,0,0,2.1096336183366153,0.1081640045317237,35,53,34,13,40,15,20
2973,0,1,0.1897168083318399,0.5472874544119462,7,6,3,2,4,3,4
2974,0,1,0.9000898034022593,0.7109679569021587,19,24,12,7,17,9,10
2975,0,0,0.39751802665270064,0.401908806447289,5,4,1,1,3,1,4
2976,0,0,0.679626089752261,0.3363447605974733,19,27,14,7,20,7,12
2977,0,1,2.493263152693132,0.9236681903969897,6,8,4,0,8,6,0
2978,1,1,3.913128943937865,0.9804134054429349,10,14,7,1,13,8,2
2979,1,1,0.5355072692800182,0.6307666765399765,5,4,1,1,3,4,1
2980,0,0,1.584660308232328,0.1701364809619882,15,17,8,3,14,4,11
2981,0,1,1.1423356263906423,0.7581082046960443,24,32,21,7,25,14,10
2982,1,1,1.1418710573978066,0.75802300174721,11,13,8,3,10,6,5
2983,1,1,0.7103744582787717,0.6704838961198402,14,17,9,4,13,8,6
2984,0,0,1.2405880078270288,0.2243336510424102,10,12,5,4,8,4,6
2985,0,0,1.9280584274380135,0.12696563861320675,20,26,14,9,17,8,12
2986,0,0,0.44015368246759445,0.3917043504071519,11,13,5,5,8,5,6
2987,1,1,4.54100868670746,0.9894498466902847,13,18,10,1,17,12,1
2988,0,0,2.88660078828754,0.052819922647867834,14,17,11,3,14,4,10
2989,1,1,0.23165957266985449,0.5576572698292648,7,8,4,3,5,4,3
2990,1,1,2.8976245976272503,0.9477288873088111,16,25,18,1,24,15,1
2991,1,1,2.38551815663404,0.9157163034995606,27,41,26,9,32,14,13
2992,0,0,0.5734616878900587,0.3604384427402568,20,29,16,8,21,9,11
2993,0,1,0.2595850111834688,0.5645342756250636,9,11,6,3,8,6,3
2994,1,1,6.7471336310357275,0.9988271366154031,23,38,27,1,37,22,1
2995,0,0,6.735023310996329,0.0011871365254663147,20,24,13,6,18,5,15
2996,0,0,4.932723994559879,0.007155278131053544,28,38,23,8,30,11,17
2997,0,1,1.084691865127089,0.747380847954018,7,7,3,2,5,4,3
2998,1,1,1.6028625118040423,0.8324180804921011,14,16,8,4,12,9,5
2999,0,0,0.8900702317454205,0.29109533427968515,8,7,3,1,6,2,6
3000,1,0,0.2597033974641521,0.4354366210672628,1,0,0,0,0,0,1
3001,0,1,0.4161213330515683,0.6025547474147606,14,16,8,3,13,8,6
3002,0,0,2.5174123890294924,0.07464648620026226,25,34,18,5,29,7,18
3003,0,0,0.05144202696097988,0.48714232855356454,9,10,5,2,8,3,6
3004,1,1,3.2044673863519297,0.9610020471830278,9,12,7,0,12,9,0
3005,1,0,2.892940865725116,0.05250362651895868,19,22,11,2,20,3,16
3006,0,0,1.2945814958337163,0.2150783546766879,14,18,11,2,16,3,11
3007,0,0,0.2668723667259858,0.43367508497405094,17,23,11,5,18,5,12
3008,0,0,2.808943717051192,0.05684278341278581,19,29,16,6,23,5,14
3009,1,1,1.8411235323117585,0.8630815314313358,14,19,14,2,17,12,2
3010,1,1,1.7861877083890476,0.8564592421466799,12,14,8,3,11,8,4
3011,1,1,0.1284097318661983,0.5320583940046573,13,18,9,6,12,7,6
3012,1,1,2.3002614817148834,0.908898692472365,8,9,7,1,8,7,1
3013,1,1,1.389081095754369,0.8004455048021063,24,34,20,11,23,10,14
3014,1,1,0.2377010406653245,0.5591470293429932,19,28,19,7,21,11,8
3015,1,1,2.7305043642290094,0.9388028203704071,28,43,27,7,36,20,8
3016,1,1,2.845957719153166,0.9451093556248525,18,23,9,5,18,12,6
3017,1,1,1.2454008643868775,0.7765027135551605,9,10,6,2,8,6,3
3018,0,0,4.994782477731704,0.006727626736527603,16,20,13,2,18,3,13
3019,1,1,0.5383499456130585,0.6314284896151797,19,26,16,5,21,10,9
3020,1,1,2.384383313057453,0.9156286749920248,11,14,8,2,12,8,3
3021,1,1,0.02553629371562427,0.5063837265291153,8,7,4,2,5,4,4
3022,1,1,1.5138475080619656,0.8196307075197782,11,14,8,3,11,5,6
3023,0,1,0.9617502981599162,0.7234721070833648,6,6,3,1,5,4,2
3024,1,1,5.117151509874946,0.994042633110958,20,27,13,6,21,12,8
3025,1,1,0.9678414572794785,0.7246890454366297,13,18,12,2,16,9,4
3026,1,1,0.970962832739755,0.7253113691747795,7,8,5,3,5,6,1
3027,1,1,4.208593756352808,0.9853505367526371,15,22,12,3,19,12,3
3028,0,0,1.0502256056416632,0.2591817806955806,42,70,47,17,53,21,21
3029,0,0,3.480777771232204,0.029864137763146115,11,12,5,2,10,3,8
3030,0,1,0.31280710265277134,0.5775702947504712,3,2,0,1,1,2,1
3031,1,1,1.949728152638106,0.875416996599874,21,28,18,10,18,12,9
3032,0,0,2.2159091042498686,0.09833091555682316,35,51,31,9,42,11,24
3033,0,0,6.110686633298121,0.0022141134552829955,26,36,24,4,32,4,22
3034,0,0,0.8680457573528846,0.29566110188730077,14,21,12,5,16,5,9
3035,0,0,2.837976830630677,0.0553061480251571,8,10,6,0,10,0,8
3036,0,0,1.1390117055647004,0.24250185925035084,18,23,15,2,21,5,13
3037,1,1,1.361210825334716,0.7959564180856629,15,19,10,4,15,9,6
3038,1,1,4.091877804094066,0.9835667341615,26,37,18,10,27,15,11
3039,0,0,1.4314617972525205,0.1928710214664996,17,22,11,3,19,4,13
3040,1,1,3.3225839029765565,0.965195497320883,17,23,11,3,20,13,4
3041,1,0,0.9412209912591027,0.28065377403129754,27,38,20,8,30,12,15
3042,1,1,1.0487698824652498,0.7405386128974965,16,20,10,6,14,9,7
3043,1,0,0.2769587968438263,0.4311995246858358,14,17,8,5,12,5,9
3044,1,1,4.455141134611613,0.9885147633281414,9,12,7,1,11,8,1
3045,1,1,5.868843968968244,0.9971818260000123,35,54,34,11,43,24,11
3046,1,1,4.677424183955441,0.9907828013699345,19,30,21,4,26,16,3
3047,0,0,5.111643609883525,0.005990072908384825,12,15,7,1,14,2,10
3048,0,1,1.9332367734042974,0.8736072491087343,13,16,10,5,11,9,4
3049,0,1,0.4219851451531631,0.6039581799438358,35,55,37,12,43,18,17
3050,1,0,1.0527847747585466,0.2586907062868674,24,35,21,8,27,8,16
3051,0,0,3.2577980585278645,0.03704768386735857,18,23,13,7,16,6,12
3052,0,0,0.8326593123334818,0.30308306635937954,26,38,20,9,29,9,17
3053,0,0,4.9145905124048905,0.0072852579076568835,20,27,16,3,24,2,18
3054,0,0,1.588731142124749,0.16956249124262635,8,8,3,1,7,2,6
3055,0,0,8.60648379141328,0.00018288249948916757,18,22,14,0,22,0,18
3056,0,0,6.606841982914398,0.0013492692043672871,26,37,23,6,31,5,21
3057,1,1,2.4737359885224306,0.9222799819326712,16,20,8,4,16,10,6
3058,1,1,0.324007496465744,0.5803005980680777,5,4,1,2,2,3,2
3059,0,0,5.22646016481204,0.005343799865075938,23,32,16,6,26,6,17
3060,1,1,0.39378910364594555,0.5971945151160238,29,42,29,10,32,10,19
3061,1,1,3.191147150325345,0.9604997662913803,19,30,23,3,27,17,2
3062,0,0,8.237731073236965,0.0002644137301346383,28,37,22,2,35,3,25
3063,1,1,1.8154366288900265,0.8600176572028101,4,4,2,0,4,4,0
3064,1,1,1.2817430379479071,0.782746333967972,11,15,8,4,11,7,4
3065,1,0,4.040524740200168,0.01728424133912909,28,39,23,7,32,7,21
3066,0,0,5.852285581604538,0.0028650920908518396,29,41,28,5,36,5,24
3067,0,0,4.253456165292741,0.014015784800855635,26,38,25,5,33,5,21
3068,0,0,2.1925589009586375,0.10042069524196373,10,10,4,2,8,3,7
3069,0,0,2.9304255259814562,0.050669852188393705,10,10,4,2,8,3,7
3070,1,1,3.814757165141655,0.978432350506086,13,18,10,2,16,11,2
3071,1,1,1.9569325307405891,0.8762005982967505,5,6,3,0,6,5,0
3072,0,0,1.3578873460787992,0.20458387845198522,35,50,28,12,38,13,22
3073,0,0,2.1462217400229027,0.10468481540671015,24,34,21,8,26,10,14
3074,0,0,2.4734373220154824,0.07774142906833081,15,19,11,2,17,5,10
3075,1,1,0.782328797720998,0.686181806001507,6,6,2,2,4,4,2
3076,0,0,0.755280784217331,0.3196717347760253,4,4,2,0,4,0,4
3077,0,0,2.572155349103538,0.07095209655397516,14,16,8,2,14,3,11
3078,1,1,3.6449430253754938,0.9745421350592284,11,12,5,3,9,8,3
3079,0,0,2.606708763289884,0.06870790179782038,36,56,35,13,43,13,23
3080,1,1,3.4257177559743033,0.9684986826169407,12,17,12,1,16,11,1
3081,0,0,3.493319116467279,0.029502921027355855,19,25,15,5,20,4,15
3082,0,0,4.867838108886362,0.0076312878215408775,23,32,22,3,29,3,20
3083,1,1,1.168685895922199,0.7629074031053503,8,8,4,2,6,4,4
3084,1,0,0.5023872853881377,0.3769798121000748,33,52,33,14,38,14,19
3085,0,0,3.6222387902292796,0.026027261902097587,10,12,8,0,12,0,10
3086,0,0,7.079125015854785,0.0008418007832755592,43,68,41,16,52,15,28
3087,0,0,0.8607185672415345,0.2971892382308623,21,31,16,8,23,8,13
3088,1,1,1.017272845792522,0.7344410425911699,18,22,12,6,16,10,8
3089,1,1,1.540337046768225,0.8235137165605813,7,8,3,2,6,5,2
3090,1,0,3.3365552332477746,0.03433819996867882,40,62,38,10,52,14,26
3091,0,1,1.3527850599386335,0.7945845784398992,14,17,10,4,13,7,7
3092,0,0,7.866083124656554,0.00038338663588621813,42,65,40,10,55,16,26
3093,1,1,2.0939806748931074,0.8903167542067156,8,11,7,0,11,8,0
3094,1,1,2.1077627710044804,0.8916553926763275,11,12,5,4,8,7,4
3095,0,0,1.543954022265459,0.1759612112700445,19,25,10,4,21,5,14
3096,0,0,4.975311483185511,0.00685899663639411,19,26,16,4,22,4,15
3097,0,0,3.375343757760713,0.033074982897226546,22,28,14,4,24,5,17
3098,0,0,2.966082584033119,0.048981884572443124,24,37,21,8,29,9,15
3099,0,0,3.5142648761131268,0.02890906569940843,15,16,8,3,13,4,11
3100,0,0,1.8151726708958003,0.14001412300373917,4,3,0,1,2,1,3
3101,1,0,0.024557358046920497,0.49386096900413323,11,12,8,3,9,4,7
3102,0,0,3.993794935634842,0.018096136620867842,27,36,24,4,32,8,19
3103,0,1,1.6351023914332763,0.8368674168552253,12,18,12,2,16,10,2
3104,0,1,0.19759824097101886,0.5492394512741741,9,8,4,3,5,4,5
3105,1,1,0.07029427253958676,0.5175663353750999,25,38,26,10,28,15,10
3106,0,1,1.2135965077710353,0.7709346909477555,11,13,5,5,8,6,5
3107,1,1,2.6679608123704526,0.9351094036156735,16,22,14,5,17,10,6
3108,0,0,2.6249916785317255,0.0675472152620018,16,18,11,3,15,5,11
3109,0,0,0.05991813695248993,0.4850249457594169,26,38,22,9,29,9,17
3110,0,0,2.678445657342992,0.06425727307358453,13,16,10,3,13,4,9
3111,1,1,2.1789286660309415,0.8983412750989817,19,28,18,8,20,12,7
3112,1,1,3.461312595527029,0.9695667214960173,20,28,16,5,23,12,8
3113,1,0,1.4281471840913824,0.1933875385808851,10,12,6,4,8,3,7
3114,1,1,1.6231984074143657,0.8352357570754918,8,10,4,1,9,7,1
3115,1,1,5.784368009397424,0.9969341748957131,13,18,11,1,17,12,1
3116,0,1,0.2493105392840489,0.5620067938365714,7,7,3,2,5,4,3
3117,0,0,2.5563765519691595,0.07199926915671606,10,9,3,1,8,1,9
3118,0,0,2.1797893485961604,0.10158015067338344,9,9,4,3,6,3,6
3119,1,0,0.2597033974641521,0.4354366210672628,1,0,0,0,0,0,1
3120,1,1,2.650440487129146,0.9340381345054484,5,6,3,0,6,5,0
3121,0,0,0.5785873497589522,0.3592577092017021,16,20,10,5,15,6,10
3122,0,0,0.6261057363410407,0.3483940738259187,10,11,5,4,7,4,6
3123,0,0,2.722847148464422,0.06163858360339447,13,16,7,3,13,3,10
3124,0,0,1.9604797968280063,0.12341513192398301,19,27,15,6,21,6,13
3125,0,0,1.7567583654716754,0.14719679665463292,13,15,6,4,11,4,9
3126,1,0,0.7554801278481098,0.31962838273951,23,31,20,6,25,8,15
3127,0,1,0.5437692793864031,0.6326888117239357,33,49,31,13,36,14,19
3128,0,1,5.746035703921532,0.9968147548818004,36,58,37,12,46,22,14
3129,0,1,1.6514573613672352,0.8390879197083669,12,15,8,3,12,8,4
3130,0,1,0.574737386891663,0.6398555822866918,2,1,0,0,1,2,0
3131,0,1,0.7747982937495874,0.6845579458271094,25,36,25,9,27,15,10
3132,1,1,4.806075167017749,0.9918864663815803,8,11,6,0,11,8,0
3133,0,1,1.7435664429303588,0.8511395036469154,34,56,37,17,39,21,13
3134,0,0,3.190493186359741,0.039525052552062956,22,29,17,3,26,4,18
3135,0,0,5.257321933708724,0.00518224121493871,18,20,10,1,19,2,16
3136,0,1,0.3885642315059403,0.59593701953421,15,18,12,4,14,7,8
3137,1,1,0.35963503727444246,0.5889520840042726,15,18,13,2,16,9,6
3138,1,0,3.7394886250696464,0.02321453106071547,9,8,3,1,7,1,8
3139,0,0,2.6444493229723416,0.06633194774968121,20,25,16,1,24,3,17
3140,1,1,1.595942582870011,0.8314505409454366,15,20,10,4,16,8,7
3141,1,1,5.849539013075444,0.9971270505596761,17,26,16,2,24,15,2
3142,0,1,0.7242161968618275,0.6735347758150418,15,19,9,4,15,8,7
3143,0,0,1.2904217373347233,0.21578143595743626,17,23,14,4,19,5,12
3144,1,1,1.7878348453435555,0.8566616170397587,14,18,9,5,13,8,6
3145,0,0,3.6662167534569448,0.024935363315103376,10,14,6,0,14,0,10
3146,1,1,1.6307099070363607,0.8362668657158558,26,35,23,7,28,15,11
3147,1,1,2.7300670845752792,0.9387776929216013,19,27,19,3,24,13,6
3148,0,0,0.9190502407495018,0.2851514538104787,9,9,3,2,7,3,6
3149,0,0,4.483093742200509,0.011172176901871667,22,30,18,4,26,4,18
3150,1,0,0.6633838897482771,0.33997987781606787,10,11,7,2,9,5,5
3151,1,1,2.4011917851334657,0.9169181379458526,38,61,38,14,47,19,19
3152,1,1,2.5956284393303104,0.9305797029707912,20,31,20,6,25,13,7
3153,1,1,3.886975589445351,0.9799048225649881,9,12,8,0,12,9,0
3154,0,0,8.385200338409645,0.00022816796026126074,27,39,25,5,34,4,23
3155,1,1,0.8458696564929258,0.6996999915385467,12,15,5,4,11,8,4
3156,1,1,4.4484618091677,0.988438682804823,16,22,10,3,19,11,5
3157,0,1,0.26446397503947816,0.5657333173920467,5,4,1,2,2,3,2
3158,1,1,0.4825870381486437,0.6183585797830712,10,10,4,5,5,3,7
3159,0,0,1.3100487635362579,0.21247868433280825,12,13,4,2,11,2,10
3160,0,0,2.5720231345686,0.07096081235241436,23,31,19,5,26,7,16
3161,1,1,1.4243935858861714,0.8060262681835009,12,14,6,5,9,5,7
3162,1,1,0.49451197860451823,0.6211687617010253,17,21,11,6,15,8,9
3163,1,1,3.0374603726992815,0.9542380571561067,35,53,33,10,43,19,16
3164,0,0,1.8034481213683784,0.14143184548768495,11,15,8,2,13,2,9
3165,0,0,3.6272652787397996,0.02590014431972465,15,17,9,1,16,2,13
3166,0,1,0.8069174381300099,0.6914522403483689,23,32,19,9,23,11,12
3167,1,1,5.619882356342025,0.996388026099291,29,41,26,9,32,19,10
3168,1,1,3.676917324572438,0.9753234876648856,19,31,20,4,27,16,3
3169,0,0,4.377977806785861,0.012395145036073307,28,40,27,5,35,5,23
3170,0,0,3.801582096930364,0.02184743573778991,13,17,12,0,17,0,13
3171,0,0,4.216912441505277,0.014529867774932037,24,34,21,5,29,5,19
3172,0,0,0.24706157073466817,0.4385468783479104,27,41,28,7,34,9,18
3173,1,1,3.134916844809216,0.9583102724818363,8,10,4,1,9,7,1
3174,1,1,4.411592264403698,0.9880096732086502,15,18,9,3,15,12,3
3175,1,1,4.879108864063086,0.9924535942449368,12,17,11,0,17,12,0
3176,0,0,2.067351050901719,0.11231086009096358,11,12,7,4,8,5,6
3177,0,0,3.1127786767216588,0.04258321379293872,18,25,15,6,19,5,13
3178,1,1,3.5466109306668594,0.9719852897122374,11,15,11,0,15,11,0
3179,0,1,2.650609562946686,0.9340485506539449,17,20,10,5,15,10,7
3180,0,0,5.352170955108921,0.004715512746105821,31,43,26,7,36,8,23
3181,1,1,2.51133594417474,0.924932700734089,14,19,11,4,15,8,6
3182,0,0,2.4777674044657965,0.07743153921025359,17,23,14,6,17,6,11
3183,0,0,3.6530850786462405,0.025256641126120694,21,28,17,6,22,8,13
3184,1,1,0.7047726898328186,0.6692450882211971,27,43,29,13,30,16,11
3185,1,1,3.0795417604718605,0.9560409303465122,12,17,12,1,16,11,1
3186,0,0,0.1323535558150173,0.46695982863748353,20,29,21,6,23,9,11
3187,0,0,1.4096541353363197,0.19628861403409237,11,14,9,2,12,3,8
3188,1,1,3.163712931876876,0.9594456621357751,20,28,17,4,24,14,6
3189,0,0,0.6065628922914641,0.3528436467651236,26,38,23,7,31,10,16
3190,0,0,1.3512955097735073,0.20565865251244886,16,20,10,2,18,3,13
3191,0,1,0.8884530364877059,0.7085708304718227,22,29,14,7,22,14,8
3192,0,0,4.852325895125482,0.00774966436583524,16,22,15,5,17,4,12
3193,1,1,2.7550330007460007,0.9401969662580625,27,43,27,9,34,18,9
3194,0,0,2.5826317159296104,0.07026461292206587,10,11,6,0,11,0,10
3195,1,0,0.9002334667541017,0.2890025222482523,30,42,25,10,32,13,17
3196,0,0,2.3811283016803184,0.08462312419639317,15,20,11,6,14,7,8
3197,1,1,2.8888238029144517,0.947291184230189,7,9,6,0,9,7,0
3198,0,0,0.3956558776521062,0.40235650796699307,13,18,10,6,12,6,7
3199,1,1,3.288077817094479,0.9640175374029748,14,18,11,3,15,9,5
3200,0,0,4.976926415111605,0.0068480045559282665,17,21,11,2,19,3,14
3201,1,1,0.15616726372052758,0.5389626622851404,16,20,9,7,13,6,10
3202,1,1,1.1648767524186538,0.7622177165270047,16,20,10,5,15,9,7
3203,0,0,1.8828583504507694,0.13206090236469448,11,13,6,2,11,3,8
3204,0,0,1.9736527038319254,0.1219970913023678,9,10,4,2,8,1,8
3205,1,1,2.5870571241801175,0.9300239386972841,13,16,10,2,14,10,3
3206,1,0,0.3278138890463347,0.4187726325055473,11,12,7,3,9,4,7
3207,1,1,1.6203691394486206,0.8348460323591989,7,7,4,1,6,5,2
3208,0,1,1.5405898786439238,0.8235504598554112,23,32,18,7,25,11,12
3209,0,0,4.852977569816582,0.007744654850689425,17,25,17,0,25,0,17
3210,0,0,3.4722101430156083,0.03011336375513307,23,32,17,5,27,7,16
3211,1,0,1.1735552899379071,0.236212950240126,14,16,8,2,14,3,11
3212,0,1,0.8962977050119796,0.71018808607256,19,27,15,6,21,10,9
3213,0,0,5.947855035647398,0.002604634117110871,28,38,22,5,33,5,23
3214,0,0,0.8668695295800368,0.2959061050209384,15,17,10,4,13,5,10
3215,1,1,2.8039068587787406,0.9428865786220542,18,21,11,6,15,10,8
3216,0,0,1.5343223260710779,0.1773621578551794,19,28,16,7,21,6,13
3217,1,1,0.03559753173502056,0.5088984432896563,18,23,12,7,16,7,11
3218,1,1,3.142404733246811,0.9586084018043511,12,18,10,1,17,11,1
3219,1,1,1.6361800701966247,0.8370144885237618,8,10,6,1,9,7,1
3220,1,1,2.7097696589682703,0.9376006737264347,8,11,7,1,10,7,1
3221,0,0,3.9736029145942524,0.018458434983497418,43,69,43,16,53,17,26
3222,1,1,3.0063906252695722,0.9528620003490481,18,25,16,5,20,13,5
3223,1,1,1.302866831647612,0.7863170707418293,36,58,36,17,41,18,18
3224,0,0,0.5802365474765263,0.3588781659104012,16,20,12,3,17,4,12
3225,1,1,1.3330824979742377,0.7913500589845027,6,6,4,1,5,5,1
3226,1,1,2.603092932429753,0.9310603704550872,14,20,11,5,15,11,3
3227,1,1,3.3932294262073563,0.9674922667985434,13,20,12,2,18,11,2
3228,1,1,0.6788581333804244,0.6634837969753108,33,52,36,10,42,19,14
3229,0,1,1.821119048476906,0.8607003498076395,22,30,17,7,23,11,11
3230,0,1,0.31280710265277134,0.5775702947504712,3,2,0,1,1,2,1
3231,0,1,0.7310732750710796,0.675040751207239,16,24,16,7,17,8,8
3232,1,1,0.6728874912259677,0.6621494149716671,20,31,18,11,20,10,10
3233,1,1,3.0646815247038695,0.955412154559463,19,28,16,5,23,12,7
3234,1,1,0.574737386891663,0.6398555822866918,2,1,0,0,1,2,0
3235,0,0,1.8387269788048246,0.13720192012214227,16,19,10,5,14,5,11
3236,0,1,0.9541197506917227,0.7219429379566163,6,5,2,1,4,4,2
3237,0,0,2.7736069816226445,0.058767180508480066,19,24,13,6,18,7,12
3238,0,1,4.652462227899976,0.9905520275454924,20,31,20,3,28,16,4
3239,1,1,4.259823913125274,0.986071941511426,17,27,19,4,23,14,3
3240,1,1,1.6866144976136481,0.8437784143456151,9,10,4,2,8,6,3
3241,1,1,0.044093780424721896,0.511021659415064,13,16,8,5,11,7,6
3242,0,0,3.387243642411447,0.03269651968979381,14,16,9,0,16,0,14
3243,1,1,5.226412435192406,0.9946559464343758,24,39,29,4,35,21,3
3244,0,0,7.956880489502867,0.0003501213769944167,24,31,19,6,25,5,19
3245,0,0,3.504512859464867,0.02918409864222893,19,27,17,6,21,6,13
3246,1,0,1.3363879947707527,0.2081046790534793,18,23,14,3,20,6,12
3247,1,1,3.5734469358233723,0.9727068483719196,10,13,9,1,12,9,1
3248,1,1,6.162177982123546,0.997896775050449,12,19,13,0,19,12,0
3249,1,1,0.8063153235150617,0.6913237667737819,20,27,19,6,21,11,9
3250,0,0,6.9941267362444695,0.0009164128646169667,29,41,22,7,34,9,20
3251,0,0,4.606999789087193,0.00988307064524363,13,16,10,2,14,3,10
3252,1,1,4.990429339348954,0.9932432214493726,11,15,10,0,15,11,0
3253,0,0,9.28978824736285,9.235408617203067e-05,28,34,18,4,30,5,23
3254,1,1,1.4921431901057904,0.8163997357953839,16,19,9,5,14,8,8
3255,0,0,2.0069032168655947,0.11848003168309074,6,6,2,0,6,0,6
3256,0,0,0.6261419169617275,0.34838586030409757,42,66,40,17,49,18,24
3257,1,1,1.4447898800769705,0.8091952961153965,22,33,20,8,25,11,11
3258,1,1,1.957256924539092,0.8762357820068593,10,12,7,1,11,8,2
3259,0,1,0.04510668990980182,0.5112747608939019,12,17,10,6,11,6,6
3260,1,1,0.10549002368748694,0.5263480766840148,12,17,11,4,13,7,5
3261,1,0,1.3687139740921785,0.20282770272747153,12,15,9,3,12,4,8
3262,0,0,5.632500384094108,0.003566845788943507,39,58,38,11,47,16,23
3263,0,0,2.4058834357817416,0.08272515393785451,13,15,11,2,13,3,10
3264,0,0,2.658697038916307,0.06545499126978604,23,30,14,6,24,6,17
3265,1,1,1.158400303772722,0.7610419201950027,15,19,8,5,14,8,7
3266,0,0,0.873588321331852,0.29450819593262634,31,48,30,10,38,13,18
3267,0,0,4.153605464190868,0.015464765191389729,8,7,4,0,7,0,8
3268,1,1,4.082793046734974,0.983419248384286,16,24,15,2,22,14,2
3269,0,1,0.5667754512011225,0.6380187949147752,17,22,12,6,16,8,9
3270,0,0,0.8007029657042688,0.30987516777683377,14,17,9,4,13,6,8
3271,0,0,3.3314582350117448,0.03450761351412557,16,21,12,4,17,5,11
3272,0,0,1.7884284390955014,0.14326550953516504,16,19,11,3,16,4,12
3273,0,1,0.4969230807320111,0.621735971762418,13,14,7,5,9,5,8
3274,0,0,3.1555165248457886,0.04087446119744165,10,10,5,3,7,3,7
3275,0,0,3.258434656432842,0.03702497983168174,10,11,5,1,10,2,8
3276,0,0,0.8834216994289945,0.2924692208436346,13,14,8,2,12,3,10
3277,0,0,2.675553147414367,0.06443141407289366,9,10,4,0,10,0,9
3278,0,0,1.5729044937124645,0.17180272730993007,9,10,6,2,8,3,6
3279,1,1,5.712876924997238,0.9967077189872466,20,34,24,3,31,18,2
3280,0,0,1.5814733831209895,0.17058691624487832,18,21,12,3,18,6,12
3281,1,1,2.7662359592010217,0.9408237732087041,11,15,10,1,14,10,1
3282,1,1,1.5841926453107218,0.8297974794962258,22,31,22,4,27,16,6
3283,1,1,6.281437260403945,0.9981327830575796,14,22,14,0,22,14,0
3284,0,0,0.25311894114990874,0.43705597086015224,17,22,13,3,19,6,11
3285,0,0,1.8340503565871575,0.13775646708994538,15,20,10,4,16,5,10
3286,0,0,2.2278991412319,0.09727296333911595,20,31,22,3,28,7,13
3287,1,1,0.6492700948609422,0.6568459613735322,17,25,19,4,21,11,6
3288,1,1,4.796146050804068,0.9918061682753337,12,16,9,2,14,10,2
3289,0,0,2.8767548129357428,0.0533146910127229,14,16,10,2,14,3,11
3290,1,1,2.0144856066503576,0.8823096040987373,18,24,13,3,21,13,5
3291,1,1,3.830168942494991,0.9787551904734269,9,13,8,0,13,9,0
3292,1,1,0.8960638780569508,0.7101399572170204,4,3,1,1,2,3,1
3293,1,1,0.38640409604867454,0.5954167597511869,28,43,27,11,32,13,15
3294,1,1,0.6313554273509472,0.6527967376720691,20,28,13,9,19,9,11
3295,1,1,3.3396806142805837,0.9657652841240576,17,25,20,3,22,15,2
3296,0,1,0.859383216479924,0.7025317744852704,20,27,14,9,18,11,9
3297,1,1,1.3301355023114398,0.7908630475747218,21,29,18,6,23,12,9
3298,0,1,0.0013904242793572053,0.5003476060138377,18,23,13,7,16,9,9
3299,1,1,2.878817965101298,0.9467893449733085,9,13,9,0,13,9,0
3300,1,1,0.8093568756586724,0.6919724414736124,14,16,7,6,10,7,7
3301,1,0,0.4982382267394363,0.3779547812902615,15,20,12,6,14,6,9
3302,1,1,0.9285917632691636,0.7167894974739764,13,18,12,3,15,10,3
3303,1,1,5.115505282459442,0.9940328764222595,17,27,21,1,26,16,1
3304,0,0,3.480112318184591,0.02988342348209516,23,33,21,10,23,7,16
3305,1,1,3.954641767340229,0.9811948771631447,17,24,16,4,20,12,5
3306,0,0,0.024104381731035573,0.49397419632439876,30,46,29,7,39,10,20
3307,1,1,3.907702430041251,0.9803089282016834,20,28,19,3,25,16,4
3308,0,0,0.016068396001544194,0.49598298742973645,16,22,14,4,18,4,12
3309,1,1,2.469242564355276,0.9219572832376358,7,7,4,1,6,6,1
3310,0,0,0.8334665030378479,0.30291259564054307,4,3,1,1,2,1,3
3311,0,0,1.460985442954538,0.1883166505523901,21,29,17,8,21,7,14
3312,1,1,3.321604315833706,0.9651625749036705,23,36,24,4,32,19,4
3313,0,1,0.7327672048921929,0.6754122226659236,37,57,36,16,41,18,19
3314,0,0,1.6782376010376145,0.15732898061566003,19,26,13,5,21,6,13
3315,0,1,0.7975716760848361,0.68945479961198,10,10,5,3,7,5,5
3316,0,0,3.493998179025649,0.029483483980375147,5,4,2,0,4,0,5
3317,1,1,2.97879717140625,0.9516070097691135,33,50,28,14,36,16,17
3318,0,1,2.3786284589682536,0.9151830316775275,17,23,16,5,18,12,5
3319,1,1,3.1492586549407853,0.9588795007995845,14,20,13,2,18,12,2
3320,1,1,0.926847704850978,0.7164353157556633,10,11,5,4,7,6,4
3321,1,0,0.13192502253885152,0.46706649565556724,13,15,9,4,11,5,8
3322,1,1,4.8615445602945035,0.9923209028210478,27,39,26,7,32,20,7
3323,1,1,3.307594258850926,0.9646884215652076,8,12,6,0,12,8,0
3324,0,0,3.172799739019773,0.04020224544512341,19,24,14,3,21,5,14
3325,0,0,1.891815281172315,0.1310376307570036,7,7,2,2,5,1,6
3326,0,0,1.152790619963121,0.23997973411696216,3,2,0,0,2,0,3
3327,0,1,1.9076720625430854,0.8707573902402587,12,16,7,3,13,8,4
3328,0,1,0.125271202745328,0.5312769093297951,8,9,5,3,6,5,3
3329,1,1,2.39781344748043,0.916660415908437,5,5,2,0,5,5,0
3330,1,1,4.133944955255611,0.9842330224375885,13,20,15,0,20,13,0
3331,0,0,5.762782206035346,0.003132513267110615,30,43,24,8,35,7,23
3332,1,1,1.7275228693039395,0.8490952937637862,24,36,23,8,28,10,14
3333,0,1,0.020528075210188845,0.5051318385899473,22,31,18,9,22,9,13
3334,0,0,1.5771825289012449,0.17119487481724305,13,15,8,3,12,3,10
3335,0,0,2.150321203763576,0.10430121165619,19,26,16,4,22,6,13
3336,0,1,0.6602394645456324,0.6593141787881993,9,10,4,3,7,5,4
3337,1,1,3.8299928658233817,0.9787515289202108,10,12,8,1,11,9,1
3338,1,1,0.31987714786531063,0.579294311850372,5,4,2,1,3,3,2
3339,1,1,7.041364791161364,0.9991258331881498,26,42,31,7,35,22,4
3340,0,0,0.4458931986837664,0.3903376373515971,10,10,3,4,6,4,6
3341,1,1,1.0020254317533546,0.7314566162676255,18,23,13,7,16,9,9
3342,1,1,2.3710379790004534,0.9145919756309434,18,26,19,4,22,13,5
3343,0,0,6.28663855616708,0.0018575482020466438,15,19,10,1,18,1,14
3344,0,0,7.246862876173699,0.0007118986313944253,28,43,27,5,38,5,23
3345,0,0,0.6818321652305812,0.33585250505142195,20,27,16,6,21,6,14
3346,0,0,0.5921105763252816,0.3561507367574567,14,17,7,5,12,6,8
3347,0,0,1.1024815900972385,0.24927520799599057,7,7,4,2,5,3,4
3348,1,1,3.3146948145126895,0.9649295031839787,13,18,12,2,16,10,3
3349,0,1,4.277294990630886,0.9863098639354119,16,21,11,4,17,11,5
3350,1,1,1.9050512860139115,0.8704621640875239,15,20,13,3,17,10,5
3351,0,0,0.896408435429449,0.2897891238161222,19,27,15,9,18,8,11
3352,0,0,4.985295013540021,0.006791323057414256,14,20,11,2,18,1,13
3353,0,1,3.7064073305665968,0.9760233794944038,10,15,9,1,14,9,1
3354,1,1,0.5771071775537169,0.640401496645898,14,16,8,4,12,8,6
3355,1,1,4.020186492637043,0.9823668904104931,35,59,40,12,47,23,12
3356,1,1,4.567328114878107,0.9897210814747252,11,16,11,1,15,10,1
3357,0,0,5.998807502178902,0.0024755662093558506,17,21,13,2,19,3,14
3358,0,0,0.046122414897849406,0.48847143990662667,11,14,8,6,8,6,5
3359,0,1,0.3412590352849725,0.5844963252038804,4,3,1,1,2,3,1
3360,0,0,2.300940209774192,0.09104512317742552,12,13,8,2,11,3,9
3361,1,1,3.72412061302766,0.9764344245107034,11,14,8,1,13,10,1
3362,1,0,0.07724400913769403,0.48069859380162494,6,6,2,2,4,3,3
3363,1,1,3.576709276538205,0.9727933243275753,8,10,5,0,10,8,0
3364,1,1,2.3499540961754852,0.9129305788102153,10,14,7,4,10,8,2
3365,0,0,3.1371736691184067,0.04159965676437127,13,16,9,1,15,2,11
3366,1,1,3.869114478747573,0.9795500817035796,16,28,19,3,25,14,2
3367,1,1,1.5272800407748865,0.8216080031073505,6,7,3,1,6,5,1
3368,1,1,1.6077026604035807,0.8330921866839777,9,12,5,2,10,7,2
3369,0,0,1.565515990445487,0.17285656258792148,25,37,23,10,27,12,13
3370,1,1,4.536062786121547,0.9893980920072508,13,20,13,1,19,12,1
3371,1,1,3.0205005234418394,0.9534917263632536,20,29,19,5,24,15,5
3372,1,1,2.5703237439511053,0.9289270729666576,17,23,13,4,19,12,5
3373,1,0,1.036163235730442,0.26189097830720365,16,20,11,4,16,7,9
3374,0,0,0.051112725200678444,0.4872245999011645,20,27,16,6,21,7,13
3375,1,1,7.210877939652562,0.999262036487464,22,32,19,3,29,17,5
3376,1,1,0.9462903195886745,0.7203685197225463,18,25,16,7,18,10,8
3377,1,0,1.8395368890040027,0.13710607310276135,26,39,24,10,29,9,17
3378,0,0,2.269807395215305,0.09365455990401739,23,33,21,6,27,6,17
3379,0,1,0.7507430075738779,0.6793405752478765,20,26,15,7,19,10,10
3380,1,0,0.5388454759211954,0.36845619483723013,14,15,8,4,11,5,9
3381,1,1,2.8576906348535154,0.9457148626895601,18,25,15,4,21,12,6
3382,1,1,1.1566244739865437,0.7607188232198885,11,14,7,6,8,6,5
3383,1,1,5.264330568089557,0.9948537659775413,18,27,17,2,25,15,3
3384,1,1,2.8910602923696187,0.94740274183828,28,41,26,11,30,16,12
3385,0,0,1.180089493712289,0.23503610541014086,7,7,3,2,5,3,4
3386,1,1,4.788120821407839,0.9917406916254288,17,25,16,2,23,14,3
3387,1,1,2.3671332321254956,0.9142864680193741,21,28,13,7,21,13,8
3388,0,0,3.365187974767438,0.03340131996356188,29,44,29,9,35,10,19
3389,1,1,4.17373577606579,0.9848387602208238,24,37,26,4,33,16,8
3390,0,1,0.39517373948630374,0.5975275488620179,7,7,4,2,5,3,4
3391,0,0,0.5543055932109042,0.3648660565797057,9,9,4,1,8,2,7
3392,0,0,0.11270949082358284,0.4718524185547792,12,14,7,4,10,5,7
3393,0,0,2.5743104049527386,0.07081017108781551,19,25,15,6,19,6,13
3394,1,1,3.9527249858202946,0.9811594770474323,15,20,13,2,18,13,2
3395,0,0,2.490691620120052,0.0765133138316868,14,18,10,3,15,3,11
3396,1,1,6.046143844828913,0.9976386174844818,14,22,14,0,22,14,0
3397,1,1,6.492492142989686,0.9984875217769744,20,33,23,3,30,18,2
3398,0,0,2.052399611784379,0.11381013832473263,20,26,15,2,24,3,17
3399,1,1,0.027284890646269044,0.5068207995127954,28,40,23,11,29,11,17
3400,1,0,0.08439118958864711,0.47891471501099525,19,29,17,8,21,9,10
3401,1,1,0.9931720762168397,0.7297140113015375,22,32,20,6,26,14,8
3402,1,1,0.6347097015644256,0.6535566043508954,14,18,7,5,13,8,6
3403,1,1,1.3532475292397363,0.7946600523614349,9,11,5,2,9,6,3
3404,1,1,0.9680642370398996,0.7247334910783323,10,12,7,3,9,7,3
3405,1,1,3.9883330856947667,0.9818065577142557,21,29,18,6,23,14,7
3406,0,1,3.0491059893232926,0.9547439138280805,21,27,17,6,21,13,8
3407,1,1,1.1237145617650723,0.7546770792828592,17,20,10,8,12,9,8
3408,0,0,0.2597033974641521,0.4354366210672628,1,0,0,0,0,0,1
3409,0,0,1.1840256923102477,0.23432913823431867,20,26,14,5,21,6,14
3410,1,1,1.2938811555024414,0.7848033905175038,25,38,23,9,29,13,12
3411,1,1,0.4243965675318422,0.6045348297276867,6,6,2,1,5,5,1
3412,1,1,2.160835990948795,0.8966770265652003,11,15,8,2,13,9,2
3413,0,0,1.8980071177844624,0.13033419560459325,15,19,11,4,15,3,12
3414,0,0,6.686698949269798,0.0012458396414006812,25,38,22,2,36,3,22
3415,1,0,0.18300892635524102,0.45437503767140375,29,41,22,7,34,8,21
3416,0,1,4.5055574010860635,0.9890732815435394,25,37,22,7,30,19,6
3417,1,1,4.621151276263406,0.9902544511245164,23,33,20,6,27,15,8
3418,1,1,2.2225084122095344,0.902252642954526,14,19,11,3,16,10,4
3419,1,1,3.3210299161437824,0.9651432562542871,21,31,18,5,26,13,8
3420,1,1,3.8981651473684753,0.9801239810418373,23,33,21,6,27,13,10
3421,1,1,2.6207328840307813,0.9321840517901417,15,21,13,5,16,11,4
3422,1,1,4.744247486722697,0.9913734571728581,20,29,21,1,28,16,4
3423,0,0,2.752490702413393,0.05994613868529963,13,14,6,4,10,4,9
3424,0,0,5.336377648028799,0.004790217910463079,22,30,21,5,25,5,17
3425,0,1,0.6083495751502035,0.647564225998901,9,11,5,3,8,5,4
3426,0,0,3.872041591521372,0.020391365427752772,18,22,16,2,20,3,15
3427,1,0,0.834677423419087,0.3026569629042277,11,10,3,2,8,3,8
3428,0,1,2.227981979962015,0.9027343105644703,27,42,23,12,30,12,15
3429,1,1,2.351670094397611,0.9130668840376153,8,9,5,1,8,7,1
3430,1,1,2.4631868915636126,0.9215204502833196,13,15,7,3,12,8,5
3431,1,1,0.586542848247704,0.6425715219922907,13,16,10,3,13,7,6
3432,0,0,5.26844418543593,0.0051252161432781,14,19,12,0,19,0,14
3433,0,0,1.8978466736109014,0.13035238257995296,6,6,2,1,5,1,5
3434,0,0,8.34985709761829,0.00023637441639323686,22,29,17,0,29,0,22
3435,0,0,1.882919586387378,0.13205388360954295,26,38,24,9,29,8,18
3436,1,1,7.643441002950823,0.9995210527371006,20,29,18,4,25,17,3
3437,1,1,0.41262502832739556,0.6017171440554727,20,27,17,6,21,10,10
3438,0,0,2.6703164396653496,0.06474780379706813,34,53,34,10,43,14,20
3439,1,1,0.9126728226593144,0.7135467934119308,6,7,3,1,6,5,1
3440,0,0,4.106305126211601,0.016201693547019613,37,56,34,9,47,12,25
3441,1,1,2.09547042465521,0.8904621479194448,12,15,8,3,12,8,4
3442,0,0,8.053089868439004,0.0003180162946969656,27,38,22,6,32,7,20
3443,0,0,5.982487484493037,0.002516196477659438,23,30,17,3,27,6,17
3444,1,1,1.2258981316758149,0.7730998451310034,22,33,21,6,27,13,9
3445,0,0,2.163050003409703,0.1031180311509503,30,46,30,7,39,14,16
3446,1,1,1.2573251034646973,0.7785652955775006,5,4,1,1,3,4,1
3447,0,0,5.433160430507484,0.0043502577699340295,11,12,8,0,12,0,11
3448,1,1,1.6620764665633467,0.8405165470957061,7,8,5,1,7,6,1
3449,0,0,7.783445325562598,0.00041640100266704394,24,30,16,5,25,4,20
3450,1,0,0.2597033974641521,0.4354366210672628,1,0,0,0,0,0,1
3451,0,0,3.7708542945489705,0.022513831360602365,19,23,15,1,22,4,15
3452,1,1,5.98630041668376,0.9974933553381372,13,19,10,1,18,12,1
3453,1,1,0.27330175226528275,0.5679033000746643,8,8,3,2,6,5,3
3454,0,0,4.62471027380282,0.009711262369159868,19,26,14,5,21,5,14
3455,1,1,2.8299147392938204,0.9442711155521442,23,35,25,6,29,17,6
3456,1,1,0.8999929778574279,0.7109480595704096,9,9,4,3,6,4,5
3457,0,0,3.2367103154594403,0.0378073808071947,18,22,13,3,19,4,14
3458,1,1,2.3608327748199596,0.9137914313262805,10,12,7,2,10,6,4
3459,1,0,0.2597033974641521,0.4354366210672628,1,0,0,0,0,0,1
3460,1,1,3.8556627411372686,0.9792788748672515,28,45,28,9,36,17,11
3461,1,1,3.1657259624997787,0.9595239161184506,19,30,20,2,28,15,4
3462,1,1,3.037612325252587,0.9542446921299279,13,18,10,3,15,9,4
3463,1,1,1.35862607908075,0.7955363088291124,24,33,20,6,27,16,8
3464,0,1,0.2412506747490062,0.5600218353423595,11,13,6,4,9,5,6
3465,0,0,5.252028987242518,0.005209599984831947,14,17,10,2,15,3,11
3466,1,1,0.5860900206570991,0.6424675128444637,17,21,13,6,15,8,9
3467,0,0,4.904922198716637,0.007355515058990014,17,20,13,1,19,2,15
3468,0,1,1.0912121608232295,0.7486099106630371,21,34,23,9,25,13,8
3469,1,1,0.6882767931697684,0.6655834812434571,8,9,3,2,7,6,2
3470,0,0,1.7506330204576475,0.147967373438891,12,13,6,4,9,4,8
3471,0,0,0.7825515753012473,0.31377022388067777,10,12,6,4,8,4,6
3472,1,1,3.50431444705446,0.9708102793354014,10,13,8,1,12,9,1
3473,0,0,2.044190409067713,0.11464072564628736,5,5,4,0,5,0,5
3474,0,0,3.128429746320247,0.04194967001730332,14,15,8,2,13,2,12
3475,0,0,2.842975169378714,0.055045577651351874,8,8,3,0,8,0,8
3476,1,1,0.29313815514311825,0.5727642310978561,28,40,24,9,31,13,15
3477,1,1,4.546589106263669,0.9895079410135884,17,25,15,3,22,14,3
3478,1,1,0.9751151728336738,0.7261378853178141,4,3,1,1,2,3,1
3479,1,1,3.820641608077513,0.9785561779111163,24,32,19,8,24,15,9
3480,0,0,4.883674655653252,0.007512287225678427,8,7,3,0,7,0,8
3481,0,0,3.247520715453324,0.037416079206715636,7,7,3,1,6,1,6
3482,0,0,1.1956461550513544,0.23225064665510164,21,32,19,8,24,7,14
3483,1,0,0.8349091646450784,0.3026080548285075,3,2,1,0,2,0,3
3484,1,0,0.9416950819632097,0.2805580711247201,14,17,10,3,14,5,9
3485,0,0,0.024308207475312926,0.49392324735205795,10,11,6,2,9,3,7
3486,1,1,3.6313134021270557,0.9742017913327089,21,30,13,7,23,13,8
3487,1,1,1.7180190250796987,0.8478734982606563,26,37,18,12,25,12,14
3488,1,0,1.0256489818544539,0.2639285088906035,4,3,1,0,3,0,4
3489,1,1,5.4028517724526015,0.9955164735137155,19,29,19,4,25,15,4
3490,1,1,0.6177138051549211,0.6496984108453918,9,10,5,4,6,5,4
3491,1,0,0.2738818481430593,0.431954356306671,2,1,0,0,1,0,2
3492,1,1,1.9696972263317776,0.8775785885851987,4,4,2,0,4,4,0
3493,0,1,0.8816239367154401,0.7071586276177733,4,3,1,1,2,3,1
3494,1,1,0.4134976326140567,0.6019262482607618,7,7,3,3,4,3,4
3495,0,0,2.127369170434043,0.106465004048379,16,22,12,5,17,5,11
3496,0,1,0.6621884716365884,0.6597518267670328,14,20,12,5,15,8,6
3497,0,0,2.927663430540691,0.05080288067469585,12,16,9,2,14,1,11
3498,0,0,3.1506130461307413,0.041067129270174085,14,17,11,3,14,5,9
3499,0,0,3.8212446244712504,0.02143117205306977,24,34,23,9,25,7,17
3500,0,0,2.8626282579709508,0.05403220548439902,18,22,14,2,20,3,15
3501,1,1,0.18909847039938565,0.5471342481215382,18,22,10,7,15,10,8
3502,0,0,3.144294777004896,0.04131666937838041,15,18,13,3,15,4,11
3503,0,0,2.924895608430419,0.050936516512361085,35,54,32,11,43,13,22
3504,1,1,3.816649679769072,0.9784722511299567,17,22,12,5,17,9,8
3505,0,0,3.8695594639726663,0.020441006379255944,17,23,15,2,21,3,14
3506,0,0,0.07134414710414227,0.48217152480857883,10,12,7,2,10,3,7
3507,1,1,2.183081339458857,0.8987198879578441,28,44,27,9,35,17,11
3508,0,0,0.8411477816500945,0.3012931029960403,12,16,10,4,12,4,8
3509,0,1,0.18155637001789016,0.5452648231354266,17,24,15,9,15,10,7
3510,0,0,4.7323690808847845,0.008728723646379999,17,22,13,5,17,4,13
3511,1,1,3.003382570076094,0.9527267063158875,16,23,17,2,21,14,2
3512,1,1,1.4760996736688905,0.8139827365067434,5,5,4,0,5,5,0
3513,1,1,6.672837522700925,0.9987367929680347,23,31,19,4,27,17,6
3514,0,0,1.816282211445124,0.13988057639413354,18,25,16,5,20,6,12
3515,0,0,2.403290970060459,0.08292208757810116,12,14,8,2,12,3,9
3516,0,0,4.719231292674996,0.00884313558677352,23,27,17,2,25,3,20
3517,0,0,0.9940049783658751,0.2701217456147418,9,10,6,2,8,3,6
3518,1,1,4.32687103434503,0.9869633853831022,18,27,18,2,25,15,3
3519,0,0,5.413534640758138,0.004436095837394904,19,26,17,1,25,1,18
3520,1,1,1.4458426697420428,0.8093577921068416,8,9,5,2,7,6,2
3521,0,0,1.4710093436728937,0.18678924717699286,21,29,18,7,22,9,12
3522,0,1,0.1127243290256259,0.5281512792380822,14,16,10,5,11,7,7
3523,0,1,0.19753047873684348,0.5492226749507946,9,10,7,2,8,3,6
3524,0,1,0.1996854361153133,0.5497561363179364,6,5,1,3,2,2,4
3525,0,1,0.8417581561012188,0.6988353747424019,4,3,1,1,2,3,1
3526,1,1,6.430703657436889,0.9983912755438928,20,30,22,2,28,18,2
3527,1,1,6.021772408773973,0.9975805011314277,12,16,11,1,15,10,2
3528,1,1,4.57320929839103,0.9897807402998849,14,19,10,2,17,12,2
3529,0,0,2.200126268791588,0.09973915071369999,14,17,11,2,15,3,11
3530,1,1,2.0977750203752823,0.8906867344030021,15,22,14,4,18,11,4
3531,1,1,4.644192003010079,0.9904743140847435,14,18,9,3,15,11,3
3532,1,0,0.9086508813596992,0.2872759879641358,13,16,8,3,13,4,9
3533,0,0,2.6695910938527967,0.06479174136359256,21,31,18,9,22,8,13
3534,0,0,5.311716356560712,0.004909232422388943,28,42,23,3,39,4,24
3535,0,0,1.535730990636079,0.17715672030439045,14,20,14,2,18,3,11
3536,1,1,1.1463797820417525,0.7588490482605728,7,7,5,1,6,5,2
3537,1,1,2.3565060545780345,0.9134499759990523,9,11,6,2,9,7,2
3538,1,1,6.385921301400058,0.9983177195553257,18,27,19,2,25,15,3
3539,1,1,1.6930944045988034,0.8446306708554181,12,14,8,3,11,8,4
3540,1,0,0.46927874286340066,0.3847869697007551,15,18,6,6,12,6,9
3541,0,0,5.687019781691694,0.0033782288030762553,27,38,22,4,34,4,23
3542,1,0,0.6974236534341589,0.33238368433326604,18,22,9,6,16,6,12
3543,1,1,1.6335015396613555,0.8366487501467449,14,16,6,5,11,8,6
3544,1,1,4.0135534819628615,0.982251623807478,12,18,12,0,18,12,0
3545,1,1,1.891715881416548,0.8689510504987572,9,12,5,2,10,7,2
3546,1,1,3.9330067975452416,0.9807914960097163,29,45,28,11,34,18,11
3547,1,1,1.1814720931955875,0.7652123867954507,18,24,15,7,17,10,8
3548,1,1,0.5404567890665468,0.6319186721154751,3,2,0,1,1,2,1
3549,0,0,2.161097395852094,0.10329875747790684,16,20,12,1,19,2,14
3550,0,0,4.2196662422009705,0.014490489458528488,13,15,10,3,12,3,10
3551,0,0,1.5338778604455823,0.17742701683331774,23,31,15,7,24,8,15
3552,1,1,3.2202677269597384,0.9615899041516461,12,19,12,0,19,12,0
3553,0,1,0.07178405873589933,0.5179383124082371,29,41,26,14,27,15,14
3554,1,1,0.9745674439862013,0.7260289495614117,18,22,14,5,17,10,8
3555,1,1,1.9275237255052389,0.8729750803328518,7,7,2,2,5,5,2
3556,1,1,1.948418080608416,0.8752740471356837,16,20,11,3,17,9,7
3557,1,1,1.910277751319253,0.8710503485524673,9,11,6,2,9,7,2
3558,0,0,1.2873571926376435,0.21630046929432178,26,39,29,7,32,13,13
3559,1,1,2.543444123596055,0.9271318485689702,17,23,13,4,19,11,6
3560,1,0,0.7508488889532199,0.32063636031251963,15,19,9,3,16,4,11
3561,0,0,0.7221753137215718,0.32691414400079066,17,22,12,4,18,5,12
3562,1,1,0.4852783992312284,0.618993514800916,11,11,4,4,7,5,6
3563,1,1,0.18738769093133723,0.5467103199054734,44,68,41,17,51,22,22
3564,0,0,0.897505226919213,0.2895634436926471,19,25,14,7,18,8,11
3565,1,1,2.644530654155078,0.9336730890771365,29,41,26,7,34,18,11
3566,1,1,5.409437583909419,0.9955457730643582,22,30,18,5,25,12,10
3567,1,1,1.158969009099379,0.7611453279512242,35,53,37,11,42,19,16
3568,1,1,1.6977753462924832,0.8452439589591147,7,8,4,1,7,6,1
3569,1,1,0.11211866731145737,0.5280003412242291,16,21,11,7,14,7,9
3570,0,1,0.28178843197212955,0.569984627219125,7,7,2,2,5,5,2
3571,1,1,2.4984668338764036,0.9240342694185143,20,32,23,6,26,15,5
3572,0,0,6.618252556107489,0.001333981195589029,25,33,19,6,27,6,19
3573,0,0,1.8218443601716332,0.13921271150857117,12,13,9,1,12,2,10
3574,1,1,3.286643043249393,0.9639677352146517,23,30,20,5,25,14,9
3575,1,1,5.445312878216031,0.9957020627391553,28,41,23,9,32,19,9
3576,1,1,1.104779770792353,0.7511546189654067,10,11,5,3,8,5,5
3577,1,1,2.110885782830451,0.8919567257047905,7,8,4,1,7,5,2
3578,1,1,0.48210555674011846,0.6182449479118666,11,14,8,4,10,7,4
3579,1,1,0.8072549034612782,0.6915242325883262,4,3,1,0,3,4,0
3580,1,1,7.263544008627802,0.9992998699006199,20,29,17,3,26,17,3
3581,1,0,0.8328088109343215,0.3030514896382289,31,47,26,9,38,13,18
3582,1,1,1.143759165702365,0.7583691576299376,25,37,22,12,25,12,13
3583,1,1,4.813473494508644,0.9919457897761725,23,34,19,7,27,16,7
3584,1,0,1.1018520816108612,0.24939303096763943,11,13,6,2,11,2,9
3585,1,1,2.5713853720475432,0.9289971314077109,6,7,3,1,6,5,1
3586,0,0,0.7490102649717381,0.3210369973663112,14,19,11,5,14,7,7
3587,0,0,3.5202129842368737,0.0287425495732907,21,32,20,4,28,4,17
3588,1,1,3.7557445988132736,0.9771512401618843,13,19,12,3,16,11,2
3589,0,0,0.9951817262976602,0.269889805482037,14,17,11,2,15,3,11
3590,1,1,5.748669107153478,0.9968231052688918,25,40,26,6,34,19,6
3591,0,0,0.06678902803473408,0.4833089471150095,15,19,11,5,14,6,9
3592,0,0,0.7606608935386472,0.31850279627160916,2,1,0,0,1,0,2
3593,1,1,3.135105472744651,0.958317807835964,14,21,14,1,20,11,3
3594,0,0,1.0345222452996015,0.26220831239755893,12,15,8,5,10,5,7
3595,1,1,0.016789658071378333,0.5041973159189433,4,3,1,1,2,2,2
3596,1,0,0.009317866988751478,0.4976705501068712,8,8,5,3,5,4,4
3597,0,0,10.62026826897334,2.441549259446507e-05,33,49,30,8,41,6,27
3598,0,0,2.5392904324958305,0.07314926643181985,16,18,10,3,15,4,12
3599,0,1,0.6935550216027553,0.6667572918481457,3,2,1,0,2,3,0
3600,0,0,6.941155931629853,0.0009662165130912559,23,30,15,4,26,5,18
3601,1,0,4.646001033165985,0.009508632946667372,30,45,25,6,39,9,21
3602,1,1,3.330093202617058,0.9654468790136108,11,15,7,2,13,9,2
3603,0,0,2.935152863164722,0.05044293825634727,15,18,11,4,14,4,11
3604,0,0,0.2775453554886993,0.4310556673126952,14,15,7,3,12,5,9
3605,1,1,2.0775474498439532,0.8887016802500031,9,13,9,0,13,9,0
3606,0,1,0.4429843682599739,0.608969915758789,24,34,21,7,27,11,13
3607,1,1,1.86018481774749,0.8653184886064748,23,32,18,7,25,10,13
3608,1,1,0.33765198822902187,0.5836200502946325,14,15,7,4,11,6,8
3609,0,0,2.324455284013612,0.0891177355769146,7,6,2,1,5,1,6
3610,1,1,2.4947175141229185,0.9237706673732358,15,19,13,2,17,9,6
3611,0,0,4.807258192452686,0.008104018517751221,14,19,12,3,16,1,13
3612,1,1,3.1446705229840504,0.9586982112055656,10,13,6,2,11,7,3
3613,1,1,1.9957298487267519,0.8803480099558003,18,25,18,4,21,13,5
3614,1,1,2.2377507397789635,0.9035886891505986,19,27,16,9,18,11,8
3615,0,0,8.683064234120657,0.00016940239277196678,18,21,9,1,20,1,17
3616,1,1,3.251987188783615,0.9627444538685833,27,41,28,7,34,20,7
3617,0,0,4.49762050112518,0.011012828921220241,11,11,6,0,11,0,11
3618,0,0,3.7948272656334288,0.021992254519749954,23,32,19,9,23,7,16
3619,0,0,1.710899573450047,0.15304707335867596,17,22,12,7,15,7,10
3620,0,0,0.20488430293922377,0.44895735335724674,12,15,11,2,13,5,7
3621,0,0,2.748531851782355,0.06016961924325637,9,8,3,1,7,2,7
3622,1,0,0.26984190950858067,0.4329459064312915,6,5,1,1,4,2,4
3623,1,1,0.3608157281469109,0.5892378844880739,28,44,27,10,34,15,13
3624,0,0,0.3825389903151519,0.4055146697235118,26,40,24,11,29,13,13
3625,1,0,0.2637626471761114,0.4344389921644731,6,5,1,1,4,1,5
3626,0,0,3.2431034417106614,0.03757549774143032,26,34,18,4,30,7,19
3627,1,1,1.4061873117379327,0.8031638860539488,17,24,13,5,19,8,9
3628,0,1,0.10703004905493396,0.5267319982535517,4,3,1,1,2,2,2
3629,0,0,2.0814042038950777,0.11091741583091652,24,33,17,7,26,8,16
3630,1,1,3.9394873948554774,0.9809132078073405,26,41,28,7,34,19,7
3631,0,0,1.2654100502469567,0.22004398819808169,5,5,3,0,5,0,5
3632,0,1,0.11626084054101471,0.5290325157989085,4,3,1,1,2,3,1
3633,1,1,1.3300462024749777,0.7908482771153337,9,9,3,3,6,5,4
3634,1,1,4.4104459468676085,0.9879960856909323,9,13,9,0,13,9,0
3635,1,1,0.23057389033171094,0.5573894417054381,6,5,2,2,3,3,3
3636,1,1,7.091668588625124,0.9991686837339592,14,23,15,0,23,14,0
3637,0,0,4.57104528184284,0.010241171567592078,26,38,24,3,35,4,22
3638,1,1,1.4408979279701803,0.8085936622168881,29,46,29,14,32,12,17
3639,0,0,3.039073324505436,0.045691560389241936,14,18,10,2,16,2,12
3640,1,1,6.008479751973855,0.9975482042367235,18,29,18,2,27,16,2
3641,1,1,6.062599543844388,0.9976770681852213,18,29,21,1,28,17,1
3642,0,1,0.20691171909637918,0.5515441664783449,30,47,32,11,36,15,15
3643,1,1,1.7048097223037022,0.8461618688314263,11,14,7,2,12,9,2
3644,0,0,6.670947376052894e-05,0.4999833226315661,19,27,16,7,20,9,10
3645,0,0,3.6164024740778205,0.026175621582932296,14,16,9,3,13,4,10
3646,1,1,6.372346381159048,0.9982947662323055,38,63,41,15,48,28,10
3647,0,0,2.9333576963493746,0.05052899338708272,20,26,15,5,21,5,15
3648,0,0,1.5946240147241537,0.16873432467201765,20,27,18,6,21,10,10
3649,0,0,2.347902965227795,0.08723260032934832,21,29,17,6,23,5,16
3650,1,1,5.702986035034204,0.9966751026321281,23,37,21,5,32,17,6
3651,1,1,2.9033425011582787,0.9480114215594083,17,25,17,4,21,13,4
3652,1,1,2.500161317682499,0.924153128174095,17,20,12,6,14,8,9
3653,1,1,2.3974969391848395,0.9166362333538363,12,16,11,2,14,10,2
3654,0,0,3.5676363189397815,0.02744783769736603,28,43,29,7,36,7,21
3655,1,1,3.219359167030329,0.9615563326313727,24,33,20,5,28,17,7
3656,0,0,0.5216336817030438,0.3724703036843514,2,1,0,0,1,0,2
3657,0,0,2.034785099937819,0.11559881332490252,26,34,20,7,27,11,15
3658,0,1,1.5947227634084906,0.8312795256667787,23,31,15,9,22,12,11
3659,1,1,5.116570007663825,0.9940391885370973,10,14,9,1,13,9,1
3660,1,1,3.1506948527835488,0.9589360922055987,11,15,11,1,14,10,1
3661,0,0,1.6388129540592424,0.162626648842639,30,41,21,11,30,12,18
3662,0,1,0.06241430113107782,0.5155985118861083,10,11,7,2,9,4,6
3663,1,0,0.5957032773144917,0.3553273303007126,2,1,0,0,1,0,2
3664,1,1,2.5611905787810088,0.9283217198591586,16,20,11,4,16,11,5
3665,1,1,1.5470005511024536,0.8244800959516765,30,46,28,12,34,18,12
3666,1,1,1.04154222575951,0.7391474699519849,25,39,26,7,32,11,14
3667,1,1,1.6333979088387236,0.8366345866748472,5,5,2,0,5,5,0
3668,0,0,5.4939941904623755,0.0040945553489986075,25,36,22,2,34,3,22
3669,1,1,5.8579782039518,0.9971511251285362,23,31,19,6,25,14,9
3670,0,0,2.1828506302453587,0.10130111369203842,9,9,5,1,8,2,7
3671,1,1,2.1695353737518426,0.8974802244348848,10,14,8,1,13,9,1
3672,0,0,5.920327418927091,0.002677134845858742,15,17,9,3,14,2,13
3673,1,0,3.571319239803708,0.02734969505180196,10,9,4,1,8,1,9
3674,0,0,3.5037151486958558,0.02920670818285087,12,12,5,1,11,1,11
3675,0,0,4.3717798713672975,0.012471246843021921,15,19,11,0,19,0,15
3676,0,0,4.648179483854265,0.009488137728815738,12,15,7,3,12,2,10
3677,1,1,5.765278129602576,0.9968752710972113,16,25,17,1,24,15,1
3678,1,1,1.3649493088544853,0.7965629126920477,14,17,11,3,14,9,5
3679,0,0,3.8371782385969153,0.021099550002677825,17,22,13,5,17,5,12
3680,0,1,0.16912456591824832,0.5421806478701245,33,51,30,18,33,15,18
3681,0,0,3.173249759553471,0.040184884534187226,27,36,19,7,29,10,17
3682,0,1,2.3071941880812403,0.9094711084864425,18,28,18,4,24,13,5
3683,1,1,4.450869129273434,0.9884661605016657,21,31,20,6,25,15,6
3684,1,0,3.5881017633227863,0.026906775328926047,31,43,24,10,33,11,20
3685,0,0,2.8663396135027317,0.05384282166014975,17,23,14,2,21,1,16
3686,1,1,3.3889788251797963,0.9673583152520505,10,13,5,2,11,8,2
3687,1,1,3.8086520291253825,0.9783031399497625,10,14,9,0,14,10,0
3688,0,0,5.122177231434265,0.005927678961055172,12,14,7,0,14,0,12
3689,1,1,1.6906282513535709,0.8443067631742761,15,21,13,3,18,11,4
3690,0,0,6.300937102017696,0.0018312252401991858,22,31,20,4,27,4,18
3691,1,1,0.7668669439570681,0.6828427614389312,16,22,14,3,19,11,5
3692,0,0,1.5949065771253967,0.16869469531683945,10,11,5,2,9,3,7
3693,1,0,1.9737071271445785,0.1219912619344099,15,16,6,5,11,6,9
3694,1,1,2.093205053160955,0.8902409896154524,5,5,2,0,5,5,0
3695,0,0,2.458354247376415,0.07882976172963574,8,9,4,0,9,0,8
3696,1,1,4.049312042889803,0.9828643839678947,15,20,10,4,16,11,4
3697,1,0,2.095308097942912,0.10955368631981444,7,6,1,1,5,1,6
3698,1,1,1.443574979731855,0.8090076471396161,10,12,7,2,10,5,5
3699,0,1,0.4124363786601659,0.6016719326118938,33,52,36,9,43,18,15
3700,1,1,0.5563043271140509,0.6355970024262676,13,16,9,3,13,8,5
3701,0,0,0.1912081974986387,0.4523430593227924,5,4,1,1,3,1,4
3702,1,0,0.5812044608879005,0.3586554943461847,7,6,2,2,4,2,5
3703,1,1,2.8628252075205896,0.9459778602598791,34,49,30,12,37,14,20
3704,0,0,1.9253312608407966,0.12726824004771986,30,48,31,8,40,12,18
3705,1,0,0.8037804606206613,0.30921742301795496,17,22,11,5,17,6,11
3706,0,1,0.9630363489013747,0.7237293207164905,5,4,2,1,3,3,2
3707,1,1,0.6468986147017151,0.656311232654853,10,12,5,4,8,5,5
3708,0,0,2.4108783047889446,0.08234692387811515,14,16,9,4,12,5,9
3709,0,0,7.550826296023971,0.0005253993943319379,23,27,14,4,23,7,16
3710,1,1,4.110379717595766,0.9838631243107145,14,19,10,3,16,11,3
3711,0,0,2.368149655124131,0.08563391177578472,20,25,18,1,24,4,16
3712,0,0,3.161530375498564,0.04063934565140215,13,15,9,4,11,3,10
3713,0,0,4.442556372720432,0.011628997497860727,19,23,14,3,20,3,16
3714,0,0,4.1926969399138665,0.014880710838569233,33,49,32,8,41,12,21
3715,0,0,2.968184698101738,0.048884055295569384,14,18,12,2,16,3,11
3716,1,1,3.016832242788169,0.953328784648966,13,15,6,3,12,9,4
3717,1,0,0.5241696662996295,0.37187774430012244,8,9,5,1,8,1,7
3718,0,0,2.608660276759248,0.06858313511177538,13,16,8,3,13,2,11
3719,0,0,0.7730809763022424,0.31581300637414733,10,10,5,2,8,3,7
3720,1,1,2.901575516245752,0.9479242653814969,14,18,10,3,15,7,7
3721,1,1,2.475351288595478,0.9223956870743562,37,60,36,15,45,18,19
3722,0,0,3.678458563611044,0.02463944560000697,14,16,9,2,14,2,12
3723,1,0,0.412542173874344,0.39830271248168403,10,10,4,1,9,3,7
3724,0,0,5.245193169738824,0.00524514642617202,24,34,20,6,28,6,18
3725,0,0,2.6850763887230897,0.06385972870624157,6,6,2,0,6,0,6
3726,1,1,1.7588954001900337,0.8530712628930025,7,9,4,1,8,6,1
3727,0,0,5.392875749994407,0.004528274540304689,21,26,14,2,24,2,19
3728,1,0,0.2597033974641521,0.4354366210672628,1,0,0,0,0,0,1
3729,0,0,0.0018645875933986922,0.4995338532367042,21,28,16,8,20,11,10
3730,1,1,1.6963641127399574,0.8450592703305653,10,12,6,4,8,6,4
3731,0,1,0.2834113997638934,0.570382374852842,9,10,5,5,5,6,3
3732,1,1,1.1403449104936705,0.7577429593571783,26,39,26,9,30,16,10
3733,0,0,2.854488723075817,0.05444975268203833,29,42,24,8,34,8,21
3734,0,0,2.6125275710041382,0.06833650611992503,13,14,8,2,12,3,10
3735,1,1,3.1737158212141447,0.9598330876400355,28,46,34,10,36,18,10
3736,1,0,0.20174487174343336,0.44973415567412833,15,19,12,4,15,4,11
3737,0,0,0.43374828324008163,0.3932316322449265,10,12,5,5,7,5,5
3738,1,1,0.05613892832787348,0.5140310472790302,16,21,13,4,17,6,10
3739,0,0,1.8937498649656042,0.13081750314224827,15,16,11,2,14,6,9
3740,0,1,0.06980082956246725,0.5174431258300698,10,12,6,3,9,5,5
3741,1,0,0.27334763078942137,0.43208544186874276,25,38,25,7,31,10,15
3742,0,0,3.4515214481590584,0.030723518900031888,36,54,33,13,41,13,23
3743,0,0,1.886454768528136,0.1316492231775448,17,25,16,6,19,5,12
3744,0,0,1.677801213099674,0.15738684408458137,17,23,14,7,16,7,10
3745,1,1,0.27736020256309324,0.5688989239676709,34,54,33,14,40,19,15
3746,0,0,1.7214957932801997,0.15167859635001024,15,19,9,3,16,4,11
3747,1,1,1.5371255386817912,0.8230464745401971,4,4,2,0,4,4,0
3748,0,1,0.5480570504601079,0.6336846944969369,7,7,5,1,6,3,4
3749,1,0,2.1788702769547976,0.10166405736237816,8,8,4,1,7,1,7
3750,0,0,0.2982249090514615,0.42599147615956323,22,32,17,9,23,8,14
3751,0,1,0.3174234817936177,0.5786962069052525,21,32,19,9,23,9,12
3752,0,0,2.772916400386139,0.058805390683468794,10,9,5,1,8,2,8
3753,1,1,2.7426874928993756,0.9394990359385117,7,7,3,1,6,6,1
3754,0,0,0.013416311662546754,0.49664597239390496,14,18,10,4,14,6,8
3755,0,0,2.039683711670937,0.11509894246223484,13,14,9,3,11,3,10
3756,0,0,3.6042811609737364,0.026486380409760257,26,38,26,8,30,6,20
3757,1,0,0.05568327750735236,0.4860827764477269,12,13,6,2,11,4,8
3758,0,0,0.8694846520636692,0.29536154650134405,22,32,23,4,28,6,16
3759,1,0,0.17813159454519356,0.4555844845269681,12,13,6,3,10,4,8
3760,0,1,0.11194063728144243,0.5279559730746173,5,4,1,2,2,3,2
3761,0,0,2.640859780225692,0.06655460174422434,26,36,21,9,27,11,15
3762,1,0,2.721306225906649,0.061727769662969,22,32,20,4,28,5,17
3763,1,1,6.193132981798806,0.9979607522958192,16,24,16,1,23,15,1
3764,0,0,0.6124141499806333,0.3515086945520326,11,11,5,2,9,3,8
3765,0,0,3.8318438047898713,0.021210011242822957,25,37,22,5,32,5,20
3766,0,0,2.9940663425193614,0.04769465701135511,26,40,28,7,33,8,18
3767,0,0,6.3027282151551045,0.0018279542344239452,36,54,33,12,42,14,22
3768,0,0,2.005613776502972,0.11861477034156986,25,32,20,8,24,12,13
3769,1,1,2.5527810531197135,0.9277601262400335,20,26,14,7,19,11,9
3770,0,0,4.220598445269227,0.01447718314178259,11,13,7,0,13,0,11
3771,1,1,2.467096918816286,0.9218027597984021,23,34,20,7,27,12,11
3772,0,0,0.042992519460191336,0.4892535253605219,6,5,1,1,4,1,5
3773,1,1,3.5015935532468117,0.970733076664088,24,34,18,10,24,15,9
3774,1,1,1.7606285306515572,0.8532883617481697,29,47,32,9,38,18,11
3775,1,1,1.3141169055989343,0.7882012477134436,8,9,4,2,7,5,3
3776,0,0,3.0025959303473346,0.04730873540078495,8,7,4,2,5,2,6
3777,0,1,0.33596556993231297,0.5832101799826075,10,12,8,4,8,5,5
3778,0,0,2.3192319081887263,0.08954265810366124,23,33,17,7,26,8,15
3779,0,1,0.6538418781611794,0.657875698149617,8,9,4,3,6,4,4
3780,0,0,7.086111681385448,0.0008359447999880532,35,54,31,10,44,9,26
3781,1,1,2.2659827614268986,0.9060202873091832,27,35,20,8,27,14,13
3782,1,1,0.7088611615705942,0.6701494693308117,30,44,28,8,36,14,16
3783,0,0,2.8620814215028205,0.05406016260434754,23,32,15,6,26,6,17
3784,0,0,3.9354504637120344,0.019162520498834268,38,60,36,15,45,15,23
3785,1,1,1.7533096735186933,0.8523697624482875,22,30,18,7,23,12,10
3786,1,1,3.3943149958221372,0.9675263917057267,12,17,10,2,15,10,2
3787,1,1,3.683288484676336,0.9754763626058046,18,27,16,4,23,15,3
3788,0,0,2.66478825334187,0.06508337260208985,19,25,15,6,19,6,13
3789,0,0,1.9714285847475663,0.12223552551035521,15,19,11,5,14,5,10
3790,0,1,0.19331995192122342,0.5481800302620072,11,13,9,2,11,8,3
3791,1,1,2.9723748755202632,0.9513103966595219,13,15,10,2,13,10,3
3792,0,1,0.7400832684502747,0.6770140644875906,33,56,35,18,38,17,16
3793,1,1,3.6313939044796193,0.9742038144938194,11,15,9,1,14,10,1
3794,1,1,1.732440093259047,0.8497242688902746,11,14,9,2,12,9,2
3795,1,0,0.012210993543710108,0.4969472895460332,9,10,6,2,8,5,4
3796,1,1,0.7801905894240968,0.6857211888690351,23,37,22,12,25,12,11
3797,0,0,3.1822743129107915,0.039838247739081845,15,20,13,2,18,1,14
3798,0,0,3.8051051635392947,0.021772274055310348,32,48,29,11,37,10,22
3799,1,1,3.4619284708309905,0.9695848889320451,12,17,10,1,16,11,1
3800,0,0,2.0405552012759864,0.11501020999096445,8,8,5,0,8,0,8
3801,1,1,3.5354822988332617,0.9716806614011141,16,20,12,4,16,10,6
3802,0,0,8.747346127001851,0.00015885718025343554,25,32,19,4,28,4,21
3803,1,1,2.879096516316884,0.9468033764369737,26,41,27,7,34,16,10
3804,1,1,4.944937979379089,0.9929309707400065,32,50,29,10,40,21,11
3805,1,1,0.3365341095702412,0.5833483718197889,10,11,6,3,8,4,6
3806,0,0,2.304949696139293,0.09071385810855626,22,30,18,7,23,9,13
3807,0,0,5.693832502037932,0.0033553690555027105,26,37,22,8,29,7,19
3808,1,1,0.32579540965038745,0.580735984942691,6,5,2,2,3,3,3
3809,1,1,2.636531531642392,0.9331760004514225,20,28,16,5,23,14,6
3810,0,1,0.17668039270491276,0.5440555547155852,18,24,16,7,17,10,8
3811,0,0,4.185603086804408,0.014985060250939486,19,26,15,5,21,5,14
3812,1,1,2.478919477015211,0.9226507200691643,12,17,14,0,17,12,0
3813,1,0,1.8105843232796222,0.14056751980965565,16,18,9,3,15,4,12
3814,0,0,1.4717447469017235,0.18667756587333495,15,17,8,2,15,4,11
3815,0,0,5.817312204806497,0.002966764307886005,26,36,22,7,29,7,19
3816,0,0,0.6216108783639935,0.349415171004994,12,13,5,3,10,3,9
3817,0,0,0.9652506517158952,0.2758281594913057,16,21,13,6,15,6,10
3818,0,0,5.838466524030904,0.0029048439865547726,23,28,16,2,26,3,20
3819,0,0,2.156936545980695,0.1036848058565143,10,12,6,4,8,3,7
3820,0,0,5.148481425451722,0.005774677657422345,42,68,44,14,54,17,25
3821,0,0,5.35245762104021,0.004714167534577762,20,28,17,1,27,2,18
3822,1,1,1.6342650904796987,0.8367530759972277,13,14,8,3,11,7,6
3823,1,1,0.21353983451521907,0.553183019849919,13,17,10,3,14,6,7
3824,1,0,1.7065322124829323,0.15361404491405473,16,18,8,4,14,6,10
3825,0,0,4.197759446458648,0.014806680133074401,14,20,14,0,20,0,14
3826,1,1,3.7522540238447064,0.9770731772255637,20,27,15,4,23,12,8
3827,0,0,3.4550617030942323,0.030618266551596163,15,17,9,1,16,2,13
3828,1,0,0.053764299593543674,0.48656216189681445,10,11,6,2,9,3,7
3829,1,1,6.687032820757578,0.9987545757215565,20,36,25,0,36,20,0
3830,0,1,0.48225527441402716,0.6182802833720115,9,10,4,4,6,5,4
3831,1,0,1.2477157941253108,0.2230957962380129,16,23,13,6,17,6,10
3832,0,0,8.832663128099764,0.00014586791950133016,27,38,22,7,31,6,21
3833,1,1,0.16072916752338756,0.5400960094485665,17,22,13,7,15,6,11
3834,1,0,2.5718076333249167,0.07097502066644112,32,47,30,12,35,13,19
3835,0,0,1.5342685109287664,0.17737000988031448,4,3,1,0,3,0,4
3836,1,1,0.6960882375327628,0.6673199142056043,19,27,14,9,18,8,11
3837,0,0,3.9104995027452967,0.019637151446051937,11,13,6,1,12,2,9
3838,1,1,0.36777256110008005,0.5909206412185191,5,4,1,2,2,3,2
3839,1,1,0.10677514662410026,0.5266684543664044,12,14,9,4,10,5,7
3840,1,1,2.716740534252903,0.9380072673744845,13,17,10,3,14,10,3
3841,1,0,0.40471490317625936,0.4001800626836034,22,31,15,9,22,9,13
3842,1,1,3.633873297485354,0.9742660502757229,11,16,10,0,16,11,0
3843,1,1,2.1130058223038106,0.8921608640421919,17,24,15,3,21,13,4
3844,1,1,1.8724869887533024,0.8667457806122223,11,13,7,3,10,8,3
3845,1,1,1.9366439651977279,0.8739829844726723,8,10,7,1,9,7,1
3846,0,1,0.05851429506884309,0.5146244012703197,11,13,9,2,11,6,5
3847,1,1,1.9960428751817032,0.8803809787944212,21,30,15,7,23,10,11
3848,1,1,3.0226172694085953,0.9535855039464283,8,9,4,1,8,7,1
3849,1,1,2.3328130688434783,0.9115583882093875,16,20,12,5,15,9,7
3850,0,0,0.49140577774393845,0.37956245830522306,16,22,12,6,16,6,10
3851,1,1,0.11426884517507019,0.5285361674433614,6,6,2,2,4,4,2
3852,1,0,0.5507352028090232,0.3656938531455508,9,11,7,2,9,3,6
3853,1,1,3.513227812894981,0.9710618062530293,11,14,9,2,12,9,2
3854,0,0,5.7224775739857545,0.0032609268010874715,13,14,7,2,12,2,11
3855,1,0,1.2308967926022758,0.22602450459444845,39,61,41,18,43,21,18
3856,1,1,2.2225079191587875,0.9022525994709859,12,15,9,3,12,8,4
3857,0,0,2.048105952796816,0.1142439041569876,35,54,30,12,42,13,22
3858,1,1,1.5759569104751832,0.8286311555425134,30,47,31,11,36,19,11
3859,0,0,3.703718792497058,0.024039617566458116,19,26,17,3,23,4,15
3860,1,1,4.948633955077406,0.9929568658014375,24,35,25,3,32,19,5
3861,0,0,2.0544894938017575,0.1135995283356408,11,11,5,3,8,4,7
3862,0,0,4.72109779743234,0.008826790783545535,18,24,14,1,23,1,17
3863,1,1,4.49611986714295,0.9889708148549756,18,25,12,4,21,14,4
3864,0,0,5.317702978616839,0.004880073496102311,18,23,13,3,20,4,14
3865,0,0,2.757219685313689,0.059680202119075876,25,36,22,6,30,8,17
3866,1,1,3.520855021289114,0.9712753683778172,13,18,12,1,17,12,1
3867,0,0,4.257486952180959,0.013960190953981932,9,9,6,0,9,0,9
3868,1,0,1.5520661051021076,0.1747880586957523,23,31,19,7,24,10,13
3869,1,1,3.61832919844111,0.973873446693302,8,10,5,0,10,8,0
3870,1,1,5.7298755507777885,0.9967630306426422,20,33,23,1,32,19,1
3871,0,0,3.3791518302876646,0.032953413129788944,9,9,5,0,9,0,9
3872,0,0,0.9107468128655141,0.28684704054867904,15,20,13,4,16,5,10
3873,0,1,0.3326885970089011,0.5824134097478608,10,11,6,4,7,5,5
3874,0,0,0.14710343323799235,0.46329031585101166,8,9,4,1,8,2,6
3875,1,1,2.070469645156747,0.8879996791008034,8,10,6,1,9,7,1
3876,1,0,0.06648586679623492,0.4833846533490668,7,6,2,2,4,3,4
3877,0,0,0.9987606681413865,0.26918515856760683,39,64,43,17,47,18,21
3878,0,0,2.122533001737063,0.10692594614477524,20,26,15,3,23,4,16
3879,0,0,5.886448340676846,0.0027691321421454695,20,28,17,4,24,4,16
3880,1,1,2.2155990872150646,0.9016415943064224,8,9,4,1,8,6,2
3881,1,1,5.941436992462254,0.997378639430892,19,27,15,4,23,15,4
3882,1,1,1.3503058517297122,0.7941796267155317,18,23,13,6,17,10,8
3883,0,1,0.8938480456216356,0.7096836353204166,16,19,12,5,14,8,8
3884,0,0,0.9974689278660926,0.26943935129192065,14,16,6,3,13,4,10
3885,0,0,4.226936976614768,0.014387025310747203,13,18,9,0,18,0,13
3886,1,1,4.086068766096533,0.9834725772119514,25,38,26,5,33,17,8
3887,0,0,2.175152926172378,0.10200406041657395,14,17,10,2,15,4,10
3888,0,0,4.508893478954871,0.010890723140629333,11,13,6,0,13,0,11
3889,0,0,7.184882123867044,0.0007573842821340104,20,28,16,1,27,1,19
3890,1,1,0.30215799347811334,0.5749699713155628,34,51,28,19,32,14,20
3891,0,0,3.6944639435272997,0.02425771132291976,7,6,3,0,6,0,7
3892,1,1,2.7903529013389323,0.9421522813280034,16,23,14,4,19,12,4
3893,1,0,0.23010729931344986,0.4427256723895706,21,29,16,6,23,9,12
3894,1,1,2.8616932595998366,0.9459199842674153,12,17,10,1,16,11,1
3895,0,0,3.781887717862468,0.022272294210961663,12,14,8,2,12,2,10
3896,0,0,4.303333283875465,0.013342964121161538,25,33,19,4,29,5,20
3897,0,0,2.734352986080795,0.060976441332701525,12,16,10,5,11,4,8
3898,1,1,2.000588626089994,0.8808588660901231,10,12,7,2,10,8,2
3899,0,0,10.219334713942068,3.6457215178309355e-05,27,37,21,7,30,7,20
3900,0,0,4.192304706854227,0.01488646178518116,15,20,13,2,18,1,14
3901,1,1,1.1889192917016904,0.7665477246938954,4,3,1,1,2,3,1
3902,0,0,3.0941750785066517,0.04334816771692762,22,29,15,3,26,4,18
3903,0,0,1.783394733766292,0.14388445919950488,8,8,3,1,7,1,7
3904,1,1,3.1400045972158317,0.9585130635105196,13,17,10,1,16,10,3
3905,0,0,0.7464453495499983,0.3215963341785729,7,8,3,3,5,2,5
3906,1,1,3.631284035177277,0.9742010532528342,14,20,13,4,16,10,4
3907,0,0,1.5441234972200244,0.1759366389437419,11,11,7,1,10,3,8
3908,1,1,0.5100789627859448,0.6248249850063243,12,16,8,4,12,6,6
3909,1,1,3.4869658968596915,0.9703146256501006,13,17,11,2,15,10,3
3910,0,0,3.249468560114573,0.037345988583740164,9,8,2,2,6,2,7
3911,1,0,0.10601449007588637,0.473521172624341,14,15,6,4,11,5,9
3912,0,0,7.529865175911514,0.000536522615768531,20,26,12,2,24,3,17
3913,0,0,0.7009201466997137,0.331608251044503,16,20,11,2,18,3,13
3914,1,1,3.4680719741761656,0.9697655393170005,17,24,15,3,21,10,7
3915,1,1,2.450315043689433,0.9205844862994808,6,7,4,0,7,6,0
3916,0,0,3.869752654684094,0.020437138446844028,15,17,9,2,15,3,12
3917,0,0,1.029140550141634,0.2632507603721219,17,24,12,6,18,6,11
3918,1,1,2.666356396612378,0.9350119799871258,9,12,7,1,11,8,1
3919,1,1,3.626940742512881,0.9740916665898111,16,20,9,5,15,11,5
3920,0,0,3.594476015812994,0.02674038188797767,17,19,9,4,15,5,12
3921,0,0,5.179122151076435,0.005601396740080755,23,32,15,5,27,4,19
3922,1,1,2.0316967458614412,0.8840850715185408,17,22,13,5,17,11,6
3923,0,0,2.013631898866078,0.11777907331406456,18,24,14,5,19,7,11
3924,0,1,3.84708097980452,0.9791040177006577,17,21,13,4,17,10,7
3925,1,0,0.11904806946629032,0.4702730829294094,31,48,30,11,37,15,16
3926,1,1,1.6684643226480467,0.8413709680848275,16,21,10,7,14,8,8
3927,0,0,2.7168865284490327,0.06198424365933919,18,23,14,4,19,5,13
3928,1,0,0.5137981064513633,0.3743035836440852,34,55,37,11,44,16,18
3929,0,0,0.5750271716888222,0.3600776422908135,15,17,9,4,13,5,10
3930,0,0,0.27218700852209676,0.4323702666150875,11,12,7,2,10,3,8
3931,0,0,1.8017354113838366,0.14163994568872673,15,20,13,3,17,3,12
3932,1,1,4.975072225620128,0.993139373360529,12,16,9,2,14,10,2
3933,0,0,2.818771311701834,0.056318198418240706,18,22,13,3,19,4,14
3934,0,0,0.9151479897501786,0.2859475554888058,10,12,6,3,9,2,8
3935,1,0,0.034878346676573635,0.4912812971707582,15,22,15,7,15,8,7
3936,0,0,3.6024523031207774,0.02653357809847101,16,20,12,3,17,3,13
3937,0,0,2.844588648566432,0.05496171185209797,15,20,14,4,16,4,11
3938,1,1,3.5097934267038307,0.9709651410497336,17,23,11,7,16,11,6
3939,1,1,2.1835591495181537,0.8987633711156215,28,40,24,12,28,14,14
3940,1,1,2.0911091128137356,0.8900360235839142,12,17,9,3,14,9,3
3941,1,1,4.544890263381134,0.9894902889929664,21,30,19,3,27,17,4
3942,1,1,1.5423762941196713,0.8238099029728179,4,4,2,0,4,4,0
3943,1,1,1.1389673392413069,0.7574899907977444,8,10,5,1,9,6,2
3944,0,0,1.5848404453268465,0.17011104890627782,11,12,6,4,8,4,7
3945,0,0,1.226209011516325,0.22684562605335634,11,13,6,3,10,4,7
3946,0,0,10.572512045525976,2.5609743956378495e-05,22,26,13,3,23,3,19
3947,0,0,3.978823875346819,0.018364080504220448,34,50,35,7,43,12,22
3948,1,1,3.4691623579781465,0.9697974933678797,17,25,18,4,21,14,3
3949,0,1,1.6942401742920925,0.8447809705044751,27,41,23,8,33,17,10
3950,1,1,2.4287098186965492,0.9189905346523215,13,17,8,4,13,9,4
3951,0,1,1.5989714323302961,0.831874579518722,23,31,18,8,23,10,13
3952,0,0,3.2240517838380107,0.038270576476790996,12,11,4,2,9,3,9
3953,0,0,3.478230680714492,0.029938021193868458,29,44,24,8,36,8,21
3954,0,0,8.32687181170826,0.00024186914284385352,29,41,27,4,37,4,25
3955,0,0,1.0029312330143054,0.26836549645882635,15,19,11,7,12,6,9
3956,0,0,2.4878789760300926,0.07671228939743246,12,14,7,1,13,1,11
3957,0,1,0.07683635244807685,0.5191996430968411,26,40,27,10,30,14,12
3958,0,0,1.8415290939702433,0.13687054967365564,10,9,3,2,7,3,7
3959,0,0,2.7890902862887588,0.05791657133863659,25,34,21,7,27,8,17
3960,1,1,1.6844876032984737,0.8434978497523625,11,13,5,3,10,7,4
3961,0,0,8.547566368225676,0.00019397905549445316,25,34,19,1,33,2,23
3962,0,0,2.5549706331783906,0.07209326269074223,8,9,6,2,7,3,5
3963,0,0,3.9352718184325135,0.019165878482166443,8,8,4,0,8,0,8
3964,1,1,1.7215855492226788,0.8483329523834837,5,5,4,0,5,5,0
3965,0,0,4.502255127655002,0.010962464899535118,27,41,26,7,34,9,18
3966,0,0,2.0040109948703737,0.118782436093125,14,16,8,2,14,2,12
3967,0,0,3.024742112352742,0.046320540689186784,13,17,9,4,13,3,10
3968,0,1,0.9887571620558058,0.7288423687024164,27,39,21,13,26,11,16
3969,1,1,0.1593515575557345,0.5397538028781574,18,21,11,6,15,8,10
3970,1,1,3.9463596699277623,0.9810414495454539,24,34,18,7,27,14,10
3971,0,0,1.4044985753608983,0.19710322576827266,6,5,1,0,5,0,6
3972,0,0,1.8279045896645232,0.13848808544026725,7,8,4,0,8,0,7
3973,1,1,3.8231477330204413,0.9786087033758678,12,17,12,1,16,11,1
3974,1,0,0.7660095359549604,0.3173429552506416,17,21,13,4,17,4,13
3975,1,1,1.7218118548446413,0.8483620675096821,9,13,7,3,10,8,1
3976,0,0,2.3116075608434095,0.09016617954182671,8,9,5,0,9,0,8
3977,0,0,4.10936728708008,0.016152957395710543,12,14,8,0,14,0,12
3978,0,0,3.8924372422374574,0.01998791147531076,12,14,6,1,13,1,11
3979,0,0,0.34058563086983806,0.4156672273422223,20,27,15,7,20,7,13
3980,0,0,4.445275912424443,0.011597781229494508,15,18,8,5,13,5,10
3981,0,1,0.5026326084817989,0.6230778042226954,7,8,5,3,5,4,3
3982,1,1,1.9188768960325386,0.8720131406506483,5,4,1,1,3,4,1
3983,1,0,0.12281414787055311,0.46933499750374463,25,37,20,11,26,13,12
3984,0,0,1.6933098993085411,0.15534105193846626,24,31,16,7,24,9,15
3985,0,0,2.4139950415942115,0.08211171120161709,19,23,12,3,20,6,13
3986,1,1,5.8307135227221565,0.9970726134091453,19,29,18,3,26,16,3
3987,0,0,2.7442597623875495,0.06041165705500695,16,20,12,2,18,3,13
3988,1,1,5.066278921592718,0.9937336733924034,17,25,17,1,24,16,1
3989,0,0,1.9399373107485318,0.12565474374776942,10,11,3,3,8,4,6
3990,1,1,3.6529090666244137,0.9747390253170097,14,20,13,1,19,10,4
3991,0,0,4.358067168326925,0.012641262531487119,22,31,17,7,24,8,14
3992,0,0,1.0306202153283066,0.2629638801579831,15,18,9,6,12,5,10
3993,1,1,4.932018682865625,0.9928397095360316,16,21,13,2,19,12,4
3994,1,1,0.6135772287290273,0.6487563838242512,6,6,4,1,5,5,1
3995,1,1,0.6403755397505417,0.6548383469458194,32,50,30,15,35,17,15
3996,1,1,4.56703407547625,0.9897180897039608,18,24,15,4,20,13,5
3997,0,0,2.862911308129566,0.05401773984523772,11,12,8,0,12,0,11
3998,1,1,3.169682978077584,0.9596773186427705,9,12,7,1,11,8,1
3999,0,0,3.6604563924402997,0.025075802305826955,33,48,29,10,38,11,22
4000,0,0,2.2866221750053324,0.09223698365010324,23,31,18,2,29,5,18
4001,1,0,0.8604187604774656,0.2972518620158826,8,7,2,2,5,3,5
4002,0,0,0.609881727993399,0.35208617783502716,3,2,0,0,2,0,3
4003,1,1,6.913977842616705,0.9990071898950417,24,37,24,5,32,20,4
4004,1,0,2.9185922574518863,0.0512420969942321,32,49,31,11,38,14,18
4005,1,1,2.1641493912526872,0.8969836010518407,9,12,7,1,11,8,1
4006,0,0,2.7594903348275146,0.059552904058565725,22,34,22,6,28,6,16
4007,0,0,3.8450448827360013,0.020937680163951145,17,21,11,5,16,5,12
4008,0,0,1.6685623425221374,0.1586159500459139,19,26,15,6,20,8,11
4009,1,0,2.0406370949755583,0.11500187487867208,22,33,19,10,23,8,14
4010,0,1,2.201573053264898,0.9003906826682836,11,14,7,3,11,8,3
4011,1,1,3.776028006343686,0.9775997454706868,19,29,20,4,25,16,3
4012,1,1,3.176246294868856,0.9599305328969598,21,30,19,6,24,13,8
4013,0,1,0.26689812436542404,0.5663312411172905,9,10,6,4,6,5,4
4014,1,0,1.0125663044261501,0.26647792128269154,8,8,5,1,7,2,6
4015,0,0,3.927671407686611,0.019309278535702634,14,14,7,4,10,3,11
4016,0,0,2.2527173066071544,0.0951153332025686,20,28,19,4,24,8,12
4017,1,1,2.5389688784140287,0.9268289297069262,23,34,22,5,29,14,9
4018,0,0,0.2370427583733843,0.441015244626608,14,16,8,2,14,4,10
4019,0,0,6.4128842673944835,0.0016376005131849558,28,42,23,9,33,7,21
4020,0,0,1.207237221575551,0.2301902577800644,11,12,6,2,10,3,8
4021,0,0,6.021676977660723,0.0024197292163293804,14,17,8,1,16,1,13
4022,0,0,2.592743988494871,0.06960686737039479,10,13,7,3,10,2,8
4023,1,1,1.1167992448554491,0.7533945266925919,31,45,25,12,33,14,17
4024,1,1,3.1813725045396954,0.9601272427246924,19,27,18,3,24,15,4
4025,1,1,1.6183624433137394,0.8345691668969095,21,29,19,6,23,14,7
4026,0,0,0.002556794170077592,0.4993608018056942,3,2,0,1,1,1,2
4027,1,1,0.48182262658064223,0.6181781690304113,18,23,14,8,15,11,7
4028,0,0,6.670957660325513,0.0012655809126038697,22,27,16,1,26,1,21
4029,0,0,9.403430087919087,8.243400490259845e-05,32,45,28,9,36,9,23
4030,1,1,1.608720569146589,0.833233678496543,8,9,4,2,7,6,2
4031,1,1,0.21690104453429981,0.5540136661275521,10,12,6,5,7,6,4
4032,1,1,4.324182461427994,0.9869287470971628,19,29,20,4,25,15,4
4033,0,0,2.380100954027778,0.08470273862007272,14,19,10,2,17,3,11
4034,0,1,2.9854978531840635,0.9519146514962449,24,37,24,6,31,17,7
4035,0,1,2.1146223964232074,0.8923162958356472,21,32,23,6,26,15,6
4036,0,1,0.12195598028222276,0.5304512619589068,15,19,12,4,15,6,9
4037,0,0,1.7023154073388838,0.15416310146061596,13,14,8,2,12,2,11
4038,0,1,0.8263153199467059,0.6955752603896458,13,15,6,5,10,7,6
4039,1,1,2.5485279923190958,0.9274745615906717,35,53,30,11,42,19,16
4040,1,1,7.078874819302568,0.999157988752084,24,37,25,4,33,21,3
4041,1,1,2.0002090523922784,0.8808190253908474,18,27,18,9,18,10,8
4042,0,0,1.0346604993931288,0.26218156731553555,30,45,31,7,38,13,17
4043,0,0,0.8940316524644765,0.29027853710903984,6,5,2,2,3,3,3
4044,0,0,2.198644979832511,0.09987223638711629,23,29,16,4,25,8,15
4045,1,1,7.855098646314881,0.9996123804888963,23,35,25,3,32,21,2
4046,0,0,4.539999875498876,0.010560689337555274,16,20,9,2,18,3,13
4047,0,0,4.408404434846339,0.012028150411679595,29,45,25,11,34,9,20
4048,0,0,2.5559523598105987,0.0720276168608367,8,10,5,0,10,0,8
4049,1,0,0.7505854894665271,0.3206937389867549,14,16,7,3,13,4,10
4050,1,1,4.3888017579731216,0.9877366594947554,14,20,14,2,18,12,2
4051,1,1,2.743870692762666,0.9395662547629432,10,13,8,1,12,8,2
4052,0,0,7.4177581127337,0.0006001335006666775,22,31,19,3,28,2,20
4053,1,1,3.876060246269052,0.9796887549115229,17,22,12,4,18,12,5
4054,1,1,5.088924615575104,0.9938731243298334,13,20,12,0,20,13,0
4055,0,0,4.148964014439478,0.015535593238931833,18,24,13,8,16,6,12
4056,0,0,2.4402887234545276,0.0801516227799185,16,21,14,2,19,3,13
4057,1,1,0.7746690465920951,0.6845300357415702,25,34,20,10,24,11,14
4058,0,0,0.4880268561407791,0.3803584999584664,5,4,1,1,3,1,4
4059,0,0,0.0649451760845462,0.48376941046222877,21,29,20,5,24,12,9
4060,0,1,0.359628670664776,0.5889505427266117,15,20,12,6,14,10,5
4061,0,0,3.571526474587132,0.02734418279643791,26,36,22,4,32,7,19
4062,1,1,1.3194192267504565,0.7890850647599529,7,8,3,2,6,5,2
4063,0,0,1.292275443443389,0.21546791743533145,6,6,3,1,5,1,5
4064,0,0,1.0735895020715738,0.2547210596696109,10,10,4,2,8,2,8
4065,1,1,4.623115486411887,0.9902733886360342,6,7,5,0,7,6,0
4066,0,0,4.330609422302376,0.012988601507026853,8,8,4,0,8,0,8
4067,0,1,0.10345395757459586,0.5258404465787672,6,5,2,2,3,3,3
4068,1,1,4.166614724992479,0.9847320652053078,10,13,8,1,12,9,1
4069,1,1,0.3728213976718733,0.5921405512527833,6,7,4,3,4,5,1
4070,1,0,7.217199483778485,0.0007333165680079023,31,45,26,4,41,5,26
4071,1,1,3.5005935116239435,0.970704651732289,9,12,7,0,12,9,0
4072,0,0,2.6696347156838542,0.06478909820250378,18,25,15,5,20,5,13
4073,1,0,1.7012771080633202,0.154298541026487,35,57,34,17,40,15,20
4074,0,0,2.6404970534971817,0.06657713971691603,15,20,11,4,16,5,10
4075,1,1,4.6961282189161295,0.9909520525458424,24,35,23,3,32,17,7
4076,0,0,2.2190191588156276,0.09805551631920906,15,18,9,5,13,5,10
4077,0,0,3.9474873680672027,0.018937587631134623,24,33,18,7,26,7,17
4078,0,0,1.1403850602636536,0.24224967048335433,23,31,19,6,25,9,14
4079,0,0,3.1963217239709074,0.039304377704673876,9,9,4,1,8,1,8
4080,0,0,1.21444724777121,0.22891510776780888,4,3,0,1,2,1,3
4081,1,1,2.1396685110152402,0.8946993841918354,7,8,4,1,7,6,1
4082,1,0,3.9119493500267857,0.019609259092802866,17,23,13,4,19,4,13
4083,1,1,0.9928982504794517,0.7296600008509972,20,24,14,7,17,9,11
4084,0,0,6.236827289725422,0.0019522330049577263,32,48,27,9,39,8,24
4085,1,1,3.093597097370047,0.9566278575960475,29,41,27,8,33,20,9
4086,1,1,0.7317075260862973,0.675179865527272,19,24,13,7,17,9,10
4087,1,1,2.364221928251168,0.9140580433319564,18,24,15,6,18,9,9
4088,1,1,2.2893665895103656,0.9079925473116071,16,26,16,5,21,10,6
4089,1,1,1.834524978936097,0.862299898681703,13,17,10,3,14,6,7
4090,1,1,2.092874198614715,0.8902086569916806,12,15,6,4,11,7,5
4091,0,1,0.8062203838622306,0.6913035067380413,19,23,13,8,15,7,12
4092,1,1,2.399081244360713,0.9167572169600906,14,18,11,4,14,9,5
4093,1,1,6.541058144765403,0.9985591183063769,23,37,27,4,33,20,3
4094,1,1,2.709408839927692,0.9375795604403595,7,9,6,0,9,7,0
4095,1,1,1.177120329441248,0.7644296363495158,17,25,14,8,17,8,9
4096,0,0,8.757173369641686,0.00015730394229285238,29,41,24,5,36,5,24
4097,1,1,0.6431393324770172,0.6554627658234075,19,25,15,8,17,11,8
4098,1,1,5.312345391660901,0.9950938395402187,13,18,13,1,17,12,1
4099,1,1,3.0049346980748295,0.9527965627769264,11,15,9,1,14,10,1
4100,0,0,7.790235012434255,0.0004135845119106474,29,41,27,5,36,6,23
4101,1,1,4.345524721505204,0.9872012286728866,11,15,7,1,14,9,2
4102,1,1,1.0382628788744535,0.7385146883483966,10,12,6,4,8,6,4
4103,1,1,2.492091016046789,0.9235855075421806,24,33,18,9,24,12,12
4104,1,1,0.6982452137208408,0.6677985987018986,3,2,0,0,2,3,0
4105,1,1,1.312107432121035,0.7878655918526651,4,4,2,0,4,4,0
4106,0,0,5.335595531215345,0.004793947918318109,18,24,14,2,22,3,15
4107,0,1,0.4895310777971069,0.6199959600355983,29,46,28,13,33,16,13
4108,0,1,1.6333979088387236,0.8366345866748472,5,5,2,0,5,5,0
4109,0,0,3.866064251833209,0.020511109043777398,46,73,47,17,56,17,29
4110,0,0,2.6925224124156997,0.06341603596846657,24,35,21,7,28,6,18
4111,0,0,2.643585067517412,0.06638549290158524,4,3,0,0,3,0,4
4112,1,1,2.212237970261693,0.9013431142541877,16,24,15,2,22,13,3
4113,1,1,5.185111685344629,0.9944318664930344,26,41,25,8,33,21,5
4114,0,0,2.6484312300272266,0.06608576563941682,23,33,18,8,25,8,15
4115,0,0,1.1538755288341465,0.23978191399650528,20,26,14,5,21,6,14
4116,1,1,0.8311955008495815,0.6966076528370494,21,29,16,9,20,10,11
4117,1,1,2.903670955450046,0.9480276072989263,12,16,9,2,14,8,4
4118,1,0,1.2332775936254223,0.2256082850758201,19,28,16,6,22,9,10
4119,0,0,4.7507029167795904,0.008571509935514476,19,23,11,5,18,5,14
4120,1,1,4.285719381538294,0.9864231513023389,10,14,8,1,13,9,1
4121,1,1,2.9143774117007966,0.9485526046059853,23,33,24,4,29,15,8
4122,0,0,3.5032088596779856,0.029221066759985592,9,11,6,0,11,0,9
4123,0,0,1.5163559468118408,0.1799987516846805,9,8,3,1,7,1,8
4124,0,0,2.2121056382571544,0.09866865382289003,23,33,20,5,28,8,15
4125,1,1,2.7807885465970954,0.9416288012308113,25,40,28,7,33,18,7
4126,1,0,2.533982663455535,0.07350994125954613,19,25,17,4,21,6,13
4127,1,0,0.7771639272055149,0.31493144632079784,15,19,11,4,15,5,10
4128,0,0,2.2134595018415433,0.0985483158726338,17,22,15,2,20,6,11
4129,1,1,1.0844493644588322,0.7473350604226328,11,14,7,3,11,6,5
4130,1,1,1.840847417372796,0.8630488991603175,18,23,12,6,17,10,8
4131,1,1,2.661947549258791,0.9347435638806041,8,10,5,1,9,6,2
4132,1,1,0.9621254587936889,0.7235471555085153,5,4,2,1,3,4,1
4133,0,0,1.2728502877186343,0.21876972028497255,18,24,12,7,17,7,11
4134,0,0,7.676244931102015,0.00046349797748990174,19,21,10,2,19,2,17
4135,1,1,6.573991615141437,0.9986057335641726,15,26,18,0,26,15,0
4136,1,0,0.5506325728065331,0.36571765971983416,42,69,41,19,50,20,22
4137,0,0,6.131832601866999,0.0021678858673525037,24,30,18,2,28,4,20
4138,0,0,2.8024195560832164,0.05719356760510064,32,46,27,9,37,13,19
4139,0,0,2.6312489582878786,0.06715416792836748,10,10,4,1,9,1,9
4140,0,0,0.2597033974641521,0.4354366210672628,1,0,0,0,0,0,1
4141,0,0,3.6575395031768805,0.025147210387525987,23,31,16,7,24,6,17
4142,0,0,2.5176250469853234,0.07463179831069211,19,25,16,6,19,5,14
4143,0,0,3.506951002422401,0.029115099471789918,19,23,14,4,19,5,14
4144,0,0,2.945656579012865,0.049942195686571766,17,21,12,3,18,3,14
4145,1,1,3.993639651514191,0.9819011039809,11,17,11,0,17,11,0
4146,1,1,2.2672127786412286,0.9061249679403263,17,22,14,4,18,11,6
4147,1,1,1.2030977423805977,0.7690753961957901,3,2,1,0,2,3,0
4148,1,1,0.5099286070629536,0.6247897381482753,30,44,25,14,30,10,20
4149,0,0,2.013554873697109,0.11778707701649749,15,20,12,7,13,6,9
4150,1,1,3.251539812070178,0.9627284042304667,4,3,1,0,3,4,0
4151,1,1,2.2993501670688055,0.9088232058014885,13,17,10,4,13,11,2
4152,0,1,0.4512912099232127,0.610946186784131,17,23,13,8,15,7,10
4153,0,0,2.97223322808681,0.048696164716885426,27,39,25,7,32,9,18
4154,1,1,3.782595780733505,0.977743119520919,15,23,13,1,22,13,2
4155,1,0,1.283501151014598,0.21695483959844297,14,20,9,3,17,4,10
4156,1,1,3.627168864761776,0.9740974231093209,7,10,5,0,10,7,0
4157,1,1,2.8202514546175173,0.9437604142961582,14,19,12,2,17,12,2
4158,1,1,3.1168912821550103,0.9575841415916605,18,25,14,4,21,14,4
4159,1,1,1.6487843851248214,0.8387266889110143,8,9,5,2,7,6,2
4160,1,1,2.313020052109925,0.9099496288709548,11,12,7,2,10,7,4
4161,0,0,1.4122862389958222,0.1958737068719948,19,28,16,5,23,7,12
4162,0,0,3.043799025342798,0.04548594350486124,18,21,9,5,16,6,12
4163,0,0,3.5878288718818814,0.026913921313679645,23,30,19,4,26,7,16
4164,1,1,3.757845835094206,0.9771981068152736,9,13,9,0,13,9,0
4165,0,0,0.23022897519639107,0.44269565276738887,14,20,13,5,15,5,9
4166,1,1,1.5496298779293038,0.8248602682816234,5,4,1,1,3,4,1
4167,1,0,2.8919635433926096,0.052552266637649,12,13,6,1,12,2,10
4168,0,0,0.09222324890673894,0.4769605149391435,20,26,13,6,20,8,12
4169,0,0,4.618236572340587,0.009773717670670035,15,20,14,5,15,4,11
4170,1,1,2.588839290227334,0.9301398321675618,11,14,8,2,12,9,2
4171,1,1,3.269520380495106,0.9633682497789501,23,32,17,6,26,14,9
4172,1,1,0.06676930439890327,0.5166861274692438,14,19,11,6,13,6,8
4173,1,1,3.0535676996007988,0.9549363046168773,9,13,7,0,13,9,0
4174,0,0,2.2861339480396357,0.09227787070218496,10,10,5,3,7,4,6
4175,1,1,2.1382504374984803,0.8945657092908044,5,6,3,0,6,5,0
4176,1,1,2.251621480447439,0.9047903089304036,11,14,7,3,11,8,3
4177,1,0,0.2842114037732877,0.4294215981556089,31,46,27,14,32,14,17
4178,1,1,5.119116843993643,0.9940542602839729,17,25,15,2,23,15,2
4179,1,1,0.6175187625720429,0.6496540197327374,20,25,10,8,17,10,10
4180,0,0,0.8810258298227227,0.29296524687406245,11,14,9,4,10,6,5
4181,0,0,1.7054916631373616,0.1537493825468743,6,5,1,0,5,0,6
4182,0,0,1.6686137424789904,0.15860909048581484,10,12,7,2,10,3,7
4183,1,1,3.128367613062406,0.9580478327825056,16,21,11,4,17,12,4
4184,0,0,0.4228361198747339,0.3958382911352113,16,21,12,6,15,6,10
4185,0,0,1.8393520547633444,0.1371279419384972,13,15,9,1,14,1,12
4186,1,1,1.055854243653206,0.7418974890921358,10,11,4,4,7,5,5
4187,1,1,0.9047191678747861,0.7119183268052559,33,50,32,15,35,18,15
4188,1,1,2.890497382281639,0.9473746845203884,5,6,3,0,6,5,0
4189,0,1,1.7162791307753829,0.8476489438250201,16,24,18,3,21,13,3
4190,0,1,0.23602419010034828,0.5587336420440818,16,22,16,4,18,12,4
4191,0,0,7.160989721686077,0.000775683713627684,23,32,20,6,26,5,18
4192,0,1,1.3923226489767668,0.8009627819634112,20,25,15,6,19,10,10
4193,1,0,0.15037402131388153,0.46247717463190663,3,2,0,1,1,1,2
4194,1,1,1.398397118515929,0.8019294122696708,11,12,8,3,9,7,4
4195,0,0,4.51608528416201,0.01081352407232905,14,16,11,2,14,3,11
4196,1,0,1.6134744741383962,0.1661067871861971,17,20,10,3,17,5,12
4197,0,0,0.9871314176389072,0.27147904857831817,14,18,10,5,13,6,8
4198,0,0,3.2611010467036774,0.0369300292745357,24,33,20,7,26,7,17
4199,0,1,1.6845426352459996,0.8435051143399006,23,33,20,7,26,13,10
4200,1,1,2.4632593666342064,0.921525691557265,19,28,17,6,22,15,4
4201,0,0,2.3484600676255094,0.08718825232317362,17,22,13,4,18,5,12
4202,0,0,6.816965028186165,0.0010938414981219724,14,18,7,4,14,2,12
4203,0,1,0.8079791251154727,0.6916787010098835,14,21,13,6,15,7,7
4204,1,1,2.825633644540974,0.9440454017946561,9,12,7,1,11,8,1
4205,1,1,5.336034619430169,0.9952081465011754,17,23,11,3,20,14,3
4206,1,1,1.127232962099067,0.7553278906268402,11,13,7,3,10,8,3
4207,1,1,3.553857422251262,0.972181937411774,16,24,14,3,21,13,3
4208,1,1,1.5292530321944895,0.8218969976211308,33,48,26,14,34,16,17
4209,0,1,0.4712550236109385,0.6156807606005028,5,4,1,1,3,4,1
4210,0,0,1.5453607893597958,0.17575732461506488,22,33,20,9,24,9,13
4211,0,0,7.821867653841086,0.00040071165834232314,21,29,17,2,27,3,18
4212,1,1,3.320897262934933,0.9651387932926738,9,12,5,1,11,8,1
4213,0,0,5.856787034641872,0.0028522607008014678,39,61,35,11,50,11,28
4214,1,1,3.303322263093537,0.964542608196594,15,20,12,5,15,9,6
4215,0,1,0.5756356567829923,0.6400625539588565,8,7,2,3,4,4,4
4216,1,0,2.198212336872049,0.09991113675920582,13,14,7,3,11,3,10
4217,0,0,0.4289936241358139,0.39436667041957607,8,9,4,2,7,3,5
4218,1,1,5.626570395023685,0.996412016132895,16,23,16,1,22,15,1
4219,0,0,4.3020703847866955,0.013359600320918097,18,25,15,7,18,5,13
4220,0,0,1.4151234195113718,0.19542721607834235,26,36,21,12,24,10,16
4221,0,0,3.4142341464260473,0.03185356187155719,10,11,6,0,11,0,10
4222,0,0,1.7157893064801857,0.1524143229604744,10,10,5,1,9,1,9
4223,1,0,0.14963184002916763,0.4626616801195005,12,15,11,2,13,5,7
4224,0,1,0.8234887525840442,0.6949764031995779,17,25,14,8,17,9,8
4225,1,1,3.0980697250338647,0.9568130528510759,8,10,5,1,9,7,1
4226,1,0,1.6627154420473502,0.1593978178467058,14,17,7,4,13,5,9
4227,1,1,3.062423929819981,0.9553158825980369,5,6,3,0,6,5,0
4228,1,1,0.9381788131256885,0.7187316394089349,10,14,7,3,11,6,4
4229,1,1,4.164180291813847,0.9846954207044201,9,12,7,1,11,8,1
4230,0,0,2.426045738558771,0.08120801945369327,24,34,20,3,31,6,18
4231,0,1,1.6300475310693152,0.8361761499525491,24,37,24,6,31,14,10
4232,1,1,3.336899802147328,0.9656732237886964,7,9,6,0,9,7,0
4233,1,1,3.7231688883219043,0.9764125151648297,6,6,2,0,6,6,0
4234,0,1,2.7316210071267175,0.93886694240733,32,48,24,15,33,16,16
4235,0,0,4.95730402201197,0.0069827582618005035,14,18,10,1,17,2,12
4236,0,0,4.883615486605418,0.007512728394242996,28,39,24,6,33,8,20
4237,1,1,3.289014576979514,0.9640500173517091,12,16,8,3,13,9,3
4238,1,1,2.547728554600124,0.9274207686331294,6,7,5,0,7,6,0
4239,0,1,1.177546909608803,0.7645064449472423,20,28,15,7,21,11,9
4240,0,0,2.3674573945863697,0.0856881318423992,15,20,11,6,14,6,9
4241,0,0,0.7058262092848642,0.33052175041643905,14,16,6,6,10,6,8
4242,1,1,2.878704001364601,0.94678360326982,17,24,15,3,21,13,4
4243,0,1,0.09678525468963928,0.5241774433322494,15,21,12,6,15,8,7
4244,0,0,6.199384705936984,0.0020265644139032535,36,54,35,5,49,12,24
4245,1,1,6.757614872512032,0.9988393512875409,36,59,38,7,52,26,10
4246,1,1,3.6861134371964397,0.9755438510705209,25,34,23,7,27,17,8
4247,0,0,3.4951557861370164,0.02945037800516781,20,26,15,6,20,7,13
4248,1,0,0.4507337056946321,0.38918633511548295,8,7,2,1,6,2,6
4249,1,1,1.4195432628317186,0.805266804444107,20,26,14,6,20,12,8
4250,0,0,4.602492524366371,0.009927273586728402,21,29,16,3,26,3,18
4251,0,0,6.646414506659346,0.0012969857841671484,16,20,12,6,14,4,12
4252,0,0,3.567742585036699,0.027445001124385082,20,27,16,4,23,7,13
4253,0,0,2.642167249653951,0.06647342111057375,31,49,33,10,39,14,17
4254,0,0,2.590451466555551,0.06975548167679635,15,20,14,2,18,3,12
4255,1,0,0.6744089146278425,0.3375103151098965,31,48,28,13,35,13,18
4256,0,0,2.105337857692169,0.10857909121015041,11,11,5,2,9,3,8
4257,0,0,5.386314823224945,0.00455794603265669,13,17,11,0,17,0,13
4258,1,1,2.0733844058322775,0.8882892425844369,21,30,18,7,23,9,12
4259,0,0,1.4699904752363948,0.18694406168950306,6,6,2,1,5,1,5
4260,1,1,4.982347451394205,0.9931887661122688,11,14,7,1,13,9,2
4261,0,0,3.5649491493678247,0.027519661382126248,11,13,7,3,10,4,7
4262,1,1,2.7784361768593504,0.941499371174156,21,32,19,6,26,13,8
4263,1,1,3.153172905495368,0.9590335612325864,8,9,3,1,8,7,1
4264,1,0,0.8181746305995983,0.3061512724726577,36,57,36,15,42,16,20
4265,0,1,1.1101372068473983,0.7521546901522426,10,11,6,3,8,7,3
4266,0,1,0.1739069312736039,0.5433674887153488,17,23,12,7,16,8,9
4267,0,0,2.8478386064413534,0.054793149992116486,17,23,15,6,17,6,11
4268,1,1,5.976886018225885,0.9974697053472447,14,21,12,1,20,13,1
4269,1,0,3.054115856624061,0.045040112446178227,31,44,27,6,38,9,22
4270,0,0,0.19545814809004503,0.4512904388764477,7,8,3,3,5,4,3
4271,1,1,1.1359585143674398,0.7569368448358994,26,33,20,5,28,12,14
4272,1,1,2.503699623977978,0.9244007707375411,10,13,7,1,12,9,1
4273,1,1,6.126192972770254,0.9978198802498778,32,49,31,9,40,22,10
4274,1,1,0.3900200333674886,0.5962875219128654,23,30,19,6,24,12,11
4275,1,1,4.350773973078456,0.9872673834322818,13,17,9,2,15,11,2
4276,0,0,1.794427461654905,0.14253076109483087,10,11,6,4,7,4,6
4277,1,0,1.1066244086497106,0.24850073858932498,11,14,9,2,12,3,8
4278,1,1,1.0707756563940016,0.7447443962379159,34,52,34,13,39,18,16
4279,1,1,1.5639418298871022,0.8269182524697698,9,11,6,2,9,7,2
4280,0,0,0.6226523336281271,0.34917846015471155,11,13,8,4,9,5,6
4281,0,1,0.28314190075144885,0.5703163338589813,8,10,6,4,6,4,4
4282,0,0,1.200641820555615,0.23136105987045752,14,17,9,3,14,4,10
4283,1,1,0.9868940214634518,0.7284739970923532,39,59,35,18,41,16,23
4284,0,0,2.016006732005549,0.11753253504081407,11,13,5,2,11,3,8
4285,1,1,1.7066725624047598,0.8464042020423577,22,30,16,8,22,10,12
4286,0,0,3.4068687084547786,0.032081488853863416,21,27,15,1,26,2,19
4287,0,0,3.1854200995443596,0.03971809177904517,21,30,17,3,27,3,18
4288,1,1,4.8435746800628765,0.9921827515222216,15,26,18,3,23,14,1
4289,0,0,3.4888866510814194,0.029630098602441257,23,32,20,8,24,7,16
4290,1,1,1.4693558634233388,0.8129594607025047,21,30,19,8,22,10,11
4291,1,1,2.2356206861576053,0.9034029674489048,9,12,8,0,12,9,0
4292,0,0,0.9039762553991033,0.2882340615615643,12,13,8,3,10,3,9
4293,0,0,2.80430816213865,0.05709181443922884,18,23,10,5,18,6,12
4294,0,0,3.4478955551097106,0.030831680411029905,8,7,3,1,6,1,7
4295,0,0,4.701341699792243,0.009001322402241163,27,38,21,6,32,6,21
4296,1,1,3.5266622501634015,0.9714369446608342,6,7,4,0,7,6,0
4297,1,1,3.25547313017342,0.9628692846259308,7,9,5,0,9,7,0
4298,0,0,7.210732151284592,0.0007380710274625946,20,26,14,4,22,4,16
4299,1,1,0.13395644460310785,0.5334391225475468,8,10,5,3,7,4,4
4300,0,0,0.002556794170077592,0.4993608018056942,3,2,0,1,1,1,2
4301,1,1,3.087034082052763,0.9563547339980689,8,10,5,1,9,7,1
4302,1,0,1.0622819084929265,0.2568736205726322,18,26,16,9,17,10,8
4303,0,1,0.51521313076783,0.6260277566436613,16,23,15,6,17,9,7
4304,1,1,2.2028848227203923,0.9005082699544986,14,17,8,4,13,7,7
4305,1,1,1.2115681807620708,0.7705763029431517,11,12,5,4,8,6,5
4306,1,0,2.1855241547486877,0.10105797747658118,19,23,12,3,20,6,13
4307,1,1,1.262371855665424,0.7794341392936874,4,4,2,0,4,4,0
4308,1,1,2.00818930051936,0.8816542242332357,10,12,5,3,9,6,4
4309,0,0,1.5874736668577691,0.1697396312401852,11,13,6,2,11,2,9
4310,1,1,4.355070035687325,0.9873212741805347,17,23,12,5,18,12,5
4311,0,0,1.4220484538325113,0.1943406515025038,7,8,4,1,7,1,6
4312,0,0,0.602306819379304,0.35381610735910607,7,7,3,2,5,3,4
4313,1,0,1.3545532304467076,0.20512697122230206,13,15,8,1,14,2,11
4314,0,0,4.728857446778839,0.008759160654051912,8,8,4,0,8,0,8
4315,0,1,1.5164190577413463,0.8200105632499701,15,18,8,6,12,8,7
4316,0,1,0.020528075210188845,0.5051318385899473,22,31,18,9,22,9,13
4317,1,1,5.339774253761219,0.995225947425838,13,18,10,2,16,11,2
4318,1,1,0.7348132510592944,0.6758606174108643,5,5,2,1,4,4,1
4319,1,1,0.8344336690826726,0.6972915888728349,8,9,3,3,6,5,3
4320,1,1,2.770105389786687,0.9410388343326239,10,12,5,2,10,8,2
4321,0,1,2.2368726475339153,0.9035121660033366,9,12,7,3,9,6,3
4322,1,1,0.574737386891663,0.6398555822866918,2,1,0,0,1,2,0
4323,1,0,2.595630994250936,0.06942013197865804,17,21,13,4,17,4,13
4324,0,0,1.116468310558031,0.24666696314801606,15,20,9,3,17,4,11
4325,0,1,1.3412081768299242,0.7926885554677422,13,15,9,5,10,7,6
4326,1,1,1.923491019235308,0.8725272221741691,9,10,6,2,8,7,2
4327,1,0,3.4922994261449705,0.02953213132059951,35,53,28,14,39,13,22
4328,0,0,0.6443215601999714,0.3442702992111023,18,28,18,9,19,8,10
4329,0,0,3.979139975773431,0.018358383079527307,14,16,6,2,14,2,12
4330,0,1,2.332853273410053,0.9115616294355743,14,18,12,5,13,10,4
4331,1,0,0.5216336817030438,0.3724703036843514,2,1,0,0,1,0,2
4332,1,0,2.257310192202856,0.09472076528543005,15,19,11,4,15,4,11
4333,1,1,0.7743082881946368,0.6844521252612086,6,5,2,1,4,3,3
4334,1,1,3.418656947404971,0.9682825504557223,10,14,7,1,13,9,1
4335,0,0,6.702544658370672,0.0012262780301754983,25,31,18,4,27,5,20
4336,0,0,2.7383975417096047,0.06074526769254851,20,26,13,8,18,8,12
4337,1,1,2.5230690117488006,0.9257433026574818,6,8,4,0,8,6,0
4338,1,1,3.368212191803317,0.9666961812572125,14,18,7,5,13,8,6
4339,0,0,0.6226957496476837,0.3491685938045693,25,35,21,7,28,7,18
4340,0,0,4.2928385662103485,0.01348183431970229,13,14,8,1,13,1,12
4341,0,0,0.837039798137424,0.3021586027600248,23,37,22,13,24,11,12
4342,0,0,3.4628096194076425,0.03038913671734944,10,13,8,0,13,0,10
4343,0,0,7.666040851334935,0.0004682495346101101,25,32,20,9,23,6,19
4344,1,0,1.734243562834995,0.1500455860038662,7,6,2,1,5,1,6
4345,1,1,2.2892550739222317,0.907983230643397,23,35,23,6,29,15,8
4346,1,1,0.13740568020720545,0.5342974747469982,23,29,16,7,22,10,13
4347,0,0,6.858139942070256,0.0010497636272236432,22,27,15,3,24,4,18
4348,0,0,2.4183938860291576,0.08178078188860682,29,41,26,7,34,10,19
4349,1,1,2.1529084051824965,0.8959402437626509,8,8,3,2,6,5,3
4350,1,1,2.3120317281342233,0.9098686114991464,19,28,20,6,22,13,6
4351,0,0,3.3409727857399254,0.034192018901553656,20,23,12,4,19,5,15
4352,0,0,1.9716468709781518,0.12221210663836657,12,14,8,3,11,4,8
4353,1,1,2.8572194150794434,0.9456906660041529,19,26,16,5,21,10,9
4354,1,1,2.2331562606349884,0.9031876928705636,11,13,7,2,11,8,3
4355,0,0,0.8782515768090206,0.29354022612157893,8,7,1,2,5,2,6
4356,0,0,1.8658137660790346,0.13402684818599309,27,39,25,11,28,12,15
4357,1,1,1.7054526015987002,0.8462455350676734,9,11,7,1,10,7,2
4358,0,0,1.5842559568041397,0.17019357897891352,9,10,4,1,9,1,8
4359,1,1,1.530702279078831,0.8221090427886215,14,18,13,2,16,10,4
4360,0,0,1.6436370839955488,0.16197077131564885,11,13,7,2,11,3,8
4361,0,1,2.1011607086547404,0.8910159423631718,5,4,1,1,3,4,1
4362,1,0,1.5963005335242166,0.16849930160834325,21,29,14,6,23,6,15
4363,1,0,0.10062280799885759,0.4748655015497345,17,22,13,6,16,10,7
4364,0,0,5.686818323853571,0.003378907142488785,33,48,31,8,40,12,21
4365,1,1,0.44138254707536895,0.6085884146866927,7,6,2,2,4,4,3
4366,1,1,0.916942569147793,0.7144187237173532,18,22,11,6,16,9,9
4367,0,0,1.5178929442843088,0.17977200365432877,11,11,6,1,10,1,10
4368,1,1,2.360396316612506,0.9137570424000525,8,11,7,0,11,8,0
4369,0,0,3.9560233270065246,0.018779647941970734,19,24,13,5,19,5,14
4370,0,0,1.132189282105458,0.24375730297763698,14,16,9,3,13,4,10
4371,1,1,2.821530839776991,0.9438282812915777,7,9,4,1,8,6,1
4372,0,0,4.085996573483272,0.016528596267023632,12,16,8,1,15,1,11
4373,0,0,0.7949871466317306,0.31109883670333605,3,2,1,0,2,0,3
4374,0,0,6.357131045118807,0.0017313325995993445,37,59,35,11,48,15,22
4375,1,0,0.5754964389013804,0.3599695200274715,2,1,0,0,1,0,2
4376,0,0,2.911147524317999,0.05160524426011326,24,34,18,4,30,5,19
4377,1,1,1.5010330229028253,0.8177284973523664,24,35,24,5,30,14,10
4378,0,0,2.8099253249918306,0.05679018064740171,17,21,9,2,19,3,14
4379,0,0,1.2886765499608037,0.21607690271036595,20,27,18,6,21,9,11
4380,1,1,2.7123509942139576,0.9377515259382416,20,26,14,6,20,12,8
4381,0,0,0.42586376317143726,0.3951144580404181,13,17,10,5,12,7,6
4382,0,1,0.477997611844613,0.6172749286133794,18,25,13,9,16,8,10
4383,1,0,0.1114478241349206,0.4721668467501975,6,6,2,2,4,3,3
4384,1,1,4.089558767985346,0.9835292090212978,16,23,16,4,19,13,3
4385,1,1,0.4939243978110528,0.6210304834458444,9,9,5,2,7,4,5
4386,0,0,7.091019525118776,0.0008318555692433671,37,55,32,9,46,10,27
4387,0,0,2.095031590042021,0.10958066304128578,17,21,14,3,18,7,10
4388,0,0,5.2213595531198465,0.005370979375392104,23,31,17,2,29,2,21
4389,0,0,0.6754677823398145,0.3372735961086004,21,31,19,8,23,9,12
4390,1,1,0.33306036054851584,0.5825038228547714,13,15,8,3,12,7,6
4391,1,1,2.2632304394249014,0.9057856718648332,6,6,4,0,6,6,0
4392,1,1,2.883037981858677,0.947001545973175,13,16,8,3,13,7,6
4393,1,1,2.9035952159113005,0.9480238753895512,26,39,27,10,29,14,12
4394,0,0,1.0217927015840114,0.26467835112251237,12,15,11,2,13,3,9
4395,0,0,3.7561181485402257,0.022840421194038396,21,29,16,7,22,6,15
4396,1,1,2.5591029318268728,0.9281826825034802,10,13,5,2,11,8,2
4397,1,1,0.8657147991516481,0.7038532551947312,11,13,8,3,10,7,4
4398,1,1,5.877449219895279,0.9972059055805825,15,20,11,2,18,13,2
4399,0,1,0.5478330192460201,0.6336326889317846,7,6,2,3,3,3,4
4400,0,0,1.8023577815360114,0.141564296000671,20,28,16,7,21,9,11
4401,0,0,1.1394295304293542,0.24242511529197952,11,10,5,2,8,3,8
4402,1,1,3.6669606975242672,0.9750827182454086,26,36,22,8,28,12,14
4403,1,1,0.504116071722893,0.62342613465283,6,6,2,2,4,4,2
4404,0,0,0.5216336817030438,0.3724703036843514,2,1,0,0,1,0,2
4405,1,1,5.810850601262373,0.9970140609950322,22,37,28,2,35,20,2
4406,1,1,0.868363610781762,0.7044050853959768,25,34,21,9,25,12,13
4407,1,0,0.730759520436419,0.3250280780196866,5,4,2,1,3,2,3
4408,0,0,6.488840253031965,0.0015180033249054814,25,36,22,7,29,6,19
4409,0,0,3.5144531212250314,0.028903781500577486,29,41,25,6,35,8,21
4410,0,0,6.456107481043453,0.001568434725537915,31,41,24,8,33,7,24
4411,1,0,0.9854067795272412,0.27182027875584125,15,19,9,5,14,5,10
4412,1,1,1.770673761534075,0.8545414398764896,4,3,1,0,3,4,0
4413,0,0,7.327613080892002,0.0006567087075319833,20,25,14,1,24,2,18
4414,1,0,0.8322746818016277,0.30316431560446,7,7,4,1,6,1,6
4415,1,0,0.44365292763057407,0.3908708947717294,14,16,8,4,12,5,9
4416,1,1,4.209544479736478,0.9853642539775982,9,12,7,0,12,9,0
4417,1,1,2.06236552186387,0.8871911354392712,13,16,10,2,14,10,3
4418,0,0,3.8741290159608828,0.020349709679178818,10,11,5,2,9,1,9
4419,0,1,0.11292954208131212,0.5282024195761635,26,39,28,9,30,16,10
4420,0,0,0.6235733262309417,0.34896919103224,3,2,1,0,2,0,3
4421,1,0,0.9262702786181705,0.2836820063652187,22,30,14,9,21,9,13
4422,0,0,4.262223558329017,0.013895140010864448,21,28,16,5,23,5,16
4423,1,1,3.643825596523171,0.9745143972097086,40,60,34,16,44,24,16
4424,1,1,1.2646360017474356,0.7798231372262351,21,29,22,8,21,15,6
4425,1,1,2.289202901891305,0.9079788715939421,6,7,4,0,7,6,0
4426,0,0,5.6560775715327605,0.0034840227935327706,21,28,17,6,22,5,16
4427,1,1,0.917423658606856,0.7145168676811628,23,35,22,10,25,13,10
4428,1,1,3.234801878496078,0.9621231328354192,13,20,12,1,19,12,1
4429,0,1,0.48348955513696756,0.6185715431288819,23,31,17,11,20,10,13
4430,0,0,4.640063913614217,0.009564713184780471,28,43,27,7,36,6,22
4431,0,0,6.348293313822006,0.001746674620411004,18,23,15,2,21,3,15
4432,1,1,0.8868783437919143,0.7082455524854774,11,14,7,5,9,8,3
4433,1,1,4.844134602784765,0.9921870931641382,11,15,9,1,14,10,1
4434,0,0,4.966792003261784,0.006917275408883872,11,15,9,2,13,1,10
4435,0,0,0.9014818090516744,0.2887460803719185,7,6,1,1,5,1,6
4436,1,0,0.46996138755192873,0.3846253826981513,5,4,1,1,3,1,4
4437,0,0,1.2268314868634476,0.22673647072727499,27,40,24,10,30,10,17
4438,1,0,2.629207738831057,0.06728215210520416,23,31,17,6,25,7,16
4439,1,1,5.443785069979404,0.9956955195831799,18,25,14,4,21,12,6
4440,0,0,2.074281428151629,0.11162177557619724,10,10,5,1,9,1,9
4441,0,0,2.0469956698532545,0.11435630429825161,14,19,10,2,17,3,11
4442,0,0,4.191107830028922,0.014904024005225947,21,28,15,8,20,7,14
4443,0,0,4.1515704258716335,0.01549578045532718,15,19,11,4,15,4,11
4444,0,0,2.6701957238584364,0.06475511419030877,6,6,3,0,6,0,6
4445,0,0,0.09035173723588119,0.4774274194210337,5,5,2,1,4,1,4
4446,0,0,1.7740726863177096,0.1450365814398541,20,28,18,7,21,8,12
4447,0,0,1.235102623826267,0.22528959521336733,8,9,5,1,8,1,7
4448,1,1,2.670922936217595,0.9352889132268415,7,10,5,0,10,7,0
4449,0,1,1.247545976829267,0.7768747689544034,16,23,13,6,17,9,7
4450,0,0,9.960030764255007,4.724904979325206e-05,39,60,36,11,49,11,28
4451,0,0,4.361191389173715,0.012602327006327907,12,13,7,2,11,2,10
4452,1,1,3.4815967596886894,0.9701595810584704,11,17,11,0,17,11,0
4453,0,0,4.051696690076014,0.01709550004693261,25,37,24,11,26,10,15
4454,0,0,2.044190409067713,0.11464072564628736,5,5,4,0,5,0,5
4455,0,0,3.1185593371462548,0.04234815911906975,16,19,12,4,15,4,12
4456,1,0,3.187747260739579,0.03962942754901799,20,23,10,6,17,7,13
4457,0,0,8.469022696839183,0.00020982587355899973,40,62,38,7,55,8,32
4458,1,1,3.606578101140487,0.9735727814802333,7,10,5,0,10,7,0
4459,1,1,0.9851970226753175,0.7281382012412341,5,5,2,1,4,4,1
4460,0,0,1.5094517986745852,0.18102005076983851,13,16,9,5,11,5,8
4461,0,0,1.355710206479651,0.2049383907567569,28,42,25,11,31,11,17
4462,1,1,2.9052913971778853,0.9481073905693115,24,32,16,6,26,16,8
4463,1,1,3.348260615673451,0.966047831269894,23,32,20,6,26,15,8
4464,0,0,2.7412661484675844,0.06058180461394225,21,30,18,7,23,6,15
4465,1,1,1.1968604638529705,0.7679658066897558,10,11,7,2,9,6,4
4466,0,1,1.058297217319718,0.7423650068703354,22,33,26,5,28,15,7
4467,1,1,0.8750026998979459,0.7057855884773182,9,10,5,2,8,5,4
4468,1,1,3.3116636941979163,0.9648267837044572,32,48,28,12,36,17,15
4469,1,0,1.1597808452544556,0.23870710899726677,5,4,1,1,3,1,4
4470,0,0,5.6890837602464,0.0033712868843314148,12,13,5,3,10,3,9
4471,1,1,3.4089346286365556,0.9679826006740639,13,17,11,2,15,9,4
4472,0,0,3.5260162924824456,0.0285809843200463,41,61,34,13,48,15,26
4473,1,1,2.4166823187437587,0.9180905998924921,12,15,10,2,13,10,2
4474,0,0,0.48326363399501293,0.38148176231134856,31,43,27,6,37,10,21
4475,0,0,1.3273501605305054,0.2095980175354366,21,30,15,7,23,6,15
4476,1,1,1.2267735207460844,0.7732533660837583,12,16,9,5,11,9,3
4477,1,1,3.4076793308706987,0.9679436732642716,17,26,18,3,23,15,2
4478,0,0,0.07978269852061803,0.48006489862168744,26,38,24,7,31,11,15
4479,0,0,2.431462806349213,0.08080475012679744,9,10,6,3,7,4,5
4480,0,0,2.3452523342813842,0.08744388275186588,17,22,11,5,17,5,12
4481,0,0,6.795000688396655,0.00111810563884851,12,14,7,0,14,0,12
4482,1,1,3.4916842399012404,0.9704502323473203,10,12,7,1,11,9,1
4483,1,1,1.2663414679592702,0.7801158243398958,37,57,37,16,41,18,19
4484,1,1,0.8969872958258116,0.7103299977468758,10,11,6,2,9,7,3
4485,0,0,2.9393992969653064,0.05023992852030945,12,15,8,0,15,0,12
4486,0,1,1.7249484979845953,0.8487651366626769,7,8,5,1,7,6,1
4487,1,1,4.017916535304557,0.9823275267096258,16,23,17,2,21,13,3
4488,0,0,1.7393025422706723,0.14940154629261237,16,23,13,5,18,5,11
4489,0,1,1.2372676757363241,0.7750880556156555,10,13,8,4,9,8,2
4490,0,0,1.6197704690852095,0.16523652774148623,14,17,10,3,14,6,8
4491,1,0,0.47556684428950646,0.38329949540243613,17,22,13,4,18,7,10
4492,1,0,2.736795601337776,0.06083673118887378,11,11,5,1,10,1,10
4493,1,0,0.7202952416938893,0.3273279720118679,15,19,12,2,17,3,12
4494,1,1,1.0504758585493605,0.7408662666148316,7,7,4,1,6,5,2
4495,0,0,4.898470910281485,0.007402768587166264,28,44,24,10,34,9,19
4496,1,0,0.2597033974641521,0.4354366210672628,1,0,0,0,0,0,1
4497,0,0,4.269982914305312,0.013789220853910322,19,24,13,5,19,5,14
4498,1,1,3.674239236908132,0.975258950455641,30,43,25,10,33,17,13
4499,1,1,2.3002614817148834,0.908898692472365,8,9,7,1,8,7,1
4500,0,0,5.293118843037821,0.00500092534407659,27,40,28,5,35,9,18
4501,0,0,1.2271395833206205,0.2266824576341766,9,10,8,2,8,3,6
4502,0,1,0.17964258335407735,0.5447902566695061,12,15,8,6,9,6,6
4503,1,1,2.028853308597351,0.8837933614977427,20,26,14,5,21,12,8
4504,0,0,1.5968351479774823,0.16842441150191123,18,24,15,4,20,6,12
4505,1,1,2.041884916447148,0.8851250629544812,20,28,18,4,24,13,7
4506,0,0,1.692944117404835,0.15538905230956257,13,15,8,2,13,3,10
4507,1,1,1.5645031008840846,0.826998569336566,16,22,16,4,18,12,4
4508,1,1,3.473351565674107,0.96991995538778,15,22,14,2,20,13,2
4509,0,0,1.465974079979707,0.1875553053499902,29,45,31,9,36,9,20
4510,1,1,0.0709293516073588,0.5177249073974355,14,16,7,7,9,6,8
4511,1,1,2.7297968615531802,0.9387621602452451,15,21,15,1,20,11,4
4512,0,0,1.2628965649446653,0.2204756677173998,6,6,2,2,4,2,4
4513,1,1,1.0387190641774962,0.7386027730456646,17,22,12,5,17,12,5
4514,1,1,0.783150485917254,0.6863587182517052,7,6,2,3,3,3,4
4515,0,0,9.742505016475034,5.872977332954665e-05,29,42,25,7,35,5,24
4516,1,1,0.09907953202153896,0.524749639557664,26,36,23,10,26,13,13
4517,1,0,0.7174819020029126,0.3279477260999427,26,37,22,11,26,14,12
4518,0,0,5.4472796910022145,0.004289528555177058,13,16,9,1,15,1,12
4519,0,0,2.226418898309811,0.0974030223614033,20,26,12,5,21,6,14
4520,0,0,1.3274633727971783,0.2095792626507358,9,11,6,2,9,1,8
4521,1,1,0.6752697296330283,0.6626821337004993,5,5,2,1,4,4,1
4522,0,0,3.3731432951732083,0.033145428304520164,14,17,7,5,12,4,10
4523,0,0,5.195025696063352,0.005513506564708948,21,27,17,2,25,4,17
4524,0,1,2.0315402769838773,0.8840690358343053,13,17,11,4,13,6,7
4525,1,1,2.546802718723284,0.9273584245775375,15,20,11,4,16,11,4
4526,1,1,2.036004935585795,0.8845258389945106,16,20,11,6,14,8,8
4527,0,0,1.084664370735647,0.25262434309706994,14,18,9,5,13,5,9
4528,0,0,2.516063340622195,0.0747397243818051,15,16,6,3,13,4,11
4529,1,1,2.0353823984889736,0.8844622379078018,13,17,9,2,15,9,4
4530,0,1,3.1281429213677807,0.9580388010033143,37,57,36,13,44,19,18
4531,0,1,0.15850229759747392,0.5395428229188932,26,36,22,10,26,12,14
4532,0,0,0.4597185491268767,0.38705259395435376,15,17,10,4,13,7,8
4533,0,1,0.23209677408716622,0.5577651140481173,13,15,8,4,11,5,8
4534,0,1,0.5231813050973155,0.6278913604374874,27,40,23,11,29,11,16
4535,1,1,3.9814976464185747,0.9816840571223456,12,19,13,0,19,12,0
4536,0,0,3.8065040149625826,0.02174250090117047,17,24,15,3,21,6,11
4537,0,0,0.2905611592664248,0.4278664915427892,19,28,20,7,21,8,11
4538,0,0,6.92142707370366,0.0009854491718045422,24,35,23,5,30,4,20
4539,0,0,2.8058945270078364,0.05700647668495018,14,15,9,2,13,3,11
4540,0,0,4.680746292869907,0.009186909739799298,20,24,13,3,21,4,16
4541,0,0,10.023107241417414,4.4360922349606646e-05,30,41,25,6,35,6,24
4542,0,0,3.447419204880919,0.030845917455630256,14,17,9,3,14,4,10
4543,1,1,1.6940508228913431,0.8447561399761212,6,7,4,0,7,6,0
4544,0,1,0.17481416188708065,0.5435925812331015,15,20,11,7,13,9,6
4545,0,0,0.5949426088244638,0.3555015956629116,11,14,10,2,12,4,7
4546,1,1,2.162141817377705,0.8967979452538781,5,5,2,0,5,5,0
4547,0,0,3.253222935086549,0.0372112482505873,18,23,10,4,19,5,13
4548,0,1,3.7067405054792664,0.9760311751313564,16,21,12,5,16,11,5
4549,1,1,2.716798915667254,0.9380106621455352,7,9,6,0,9,7,0
4550,1,0,1.2199055903605476,0.22795306534285276,8,9,6,0,9,0,8
4551,1,1,2.9709115021863983,0.9512425699955153,7,9,5,0,9,7,0
4552,1,1,0.4665155879123475,0.6145587119104237,25,36,21,10,26,12,13
4553,1,1,1.8534261766633058,0.864528873743064,7,7,3,1,6,5,2
4554,1,1,3.5425354406787664,0.9718741008574721,25,38,28,5,33,18,7
4555,1,0,0.6450584689021879,0.3441039624496792,16,20,10,4,16,5,11
4556,0,0,0.5300778502914283,0.3704987308711417,13,17,12,3,14,5,8
4557,0,0,1.755072351907121,0.14740856768610555,20,29,18,5,24,5,15
4558,1,1,0.8052883387045429,0.6911045700780895,27,37,24,11,26,16,11
4559,1,1,1.0786459264779888,0.746237651977796,14,17,8,5,12,8,6
4560,1,1,1.9105438090671614,0.871080229644676,19,26,15,6,20,11,8
4561,1,1,0.9683087046191226,0.7247822584238086,3,2,1,0,2,3,0
4562,1,1,2.4297733131207426,0.9190696732781019,9,12,7,1,11,8,1
4563,1,1,5.124754491833139,0.9940874883313029,15,20,11,3,17,12,3
4564,0,0,1.1960138288467588,0.23218509309042468,13,15,8,3,12,4,9
4565,0,0,1.7145241175906767,0.1525778372568537,21,28,15,7,21,10,11
4566,0,0,2.9768761753354287,0.048481531014835655,18,26,16,6,20,5,13
4567,1,1,1.1272317087931554,0.755327659006223,24,36,22,9,27,11,13
4568,0,1,0.07868074682120296,0.519660045363709,16,20,10,7,13,8,8
4569,0,0,3.1626768182140035,0.04059467191589361,18,23,10,4,19,3,15
4570,0,0,0.49973933052219977,0.37760192904825274,20,26,16,4,22,7,13
4571,1,1,3.0944445376444776,0.9566630051372259,8,11,6,0,11,8,0
4572,1,1,2.1291033130830117,0.8936998527535686,24,32,19,6,26,13,11
4573,0,0,5.654676043458903,0.0034888921246369886,22,29,16,6,23,6,16
4574,1,1,1.440992017011285,0.8086082239504149,6,5,1,2,3,4,2
4575,0,0,5.911846943952235,0.002699873204454417,22,25,15,3,22,4,18
4576,0,0,5.954162335344309,0.002588299996511445,30,44,26,5,39,5,25
4577,1,0,0.4774889943530005,0.38284523770029677,13,16,9,3,13,4,9
4578,0,0,0.20794830648660034,0.448199454401918,8,8,3,2,6,3,5
4579,0,0,2.585192361251413,0.07009751633662009,7,8,5,0,8,0,7
4580,1,1,5.566992795893135,0.9961925951640385,21,32,19,4,28,16,5
4581,0,0,4.140345136363107,0.015667964317795158,13,14,10,0,14,0,13
4582,0,1,1.475560282317856,0.8139010508187222,5,4,1,1,3,4,1
4583,0,0,1.0547117784327762,0.25832133700238946,14,17,7,4,13,6,8
4584,1,1,1.000645834287555,0.7311855384077788,10,11,4,4,7,5,5
4585,0,0,2.420231886749889,0.08164286753017913,29,40,23,7,33,7,22
4586,0,0,1.1189464319982636,0.24620676188807344,14,18,11,5,13,6,8
4587,0,0,4.361312952188539,0.01260081442555816,21,26,14,6,20,5,16
4588,0,0,0.9799862274998098,0.27289451643249607,8,7,1,2,5,2,6
4589,1,1,2.2377425082680054,0.9035879720505084,10,11,4,3,8,7,3
4590,0,0,1.7299627254422234,0.15059234763243146,10,11,5,2,9,2,8
4591,0,0,2.5977041278970825,0.06928632500979992,7,8,5,3,5,1,6
4592,0,1,2.4055276316852443,0.9172478430326207,22,31,16,8,23,10,12
4593,0,0,3.0535523677684973,0.045064355161831604,14,17,9,4,13,5,9
4594,1,1,2.318503468102198,0.9103979382267845,16,23,14,5,18,11,5
4595,1,1,1.9695229804737429,0.8775598673526923,6,7,4,0,7,6,0
4596,1,1,1.0355070466077971,0.737982157831855,25,35,19,8,27,16,9
4597,0,0,1.9550652370536308,0.12400209518507443,8,9,5,0,9,0,8
4598,0,0,3.1883445534070805,0.03960670147539935,14,19,13,5,14,4,10
4599,1,0,0.806387557580744,0.30866081903518205,15,20,11,5,15,5,10
4600,0,0,0.2416867626796071,0.43987071654853926,13,16,9,5,11,5,8
4601,1,1,4.581992322947881,0.9898691979768071,16,22,13,3,19,13,3
4602,0,0,4.790790253075979,0.008237471491205572,13,14,7,2,12,3,10
4603,1,1,2.2079992379161535,0.9009655487271431,9,11,5,2,9,6,3
4604,0,0,0.837264027003713,0.3021113242320499,13,15,10,4,11,5,8
4605,1,0,1.3923274967506885,0.19903644519879227,12,15,9,1,14,1,11
4606,0,0,5.923963855856888,0.002667443214201426,24,35,19,4,31,5,19
4607,0,0,4.026016714477993,0.01753240092847841,33,47,29,7,40,9,24
4608,0,1,2.295960161863304,0.9085419082277376,4,4,2,0,4,4,0
4609,0,1,0.053897421648423594,0.5134710945187841,12,15,8,2,13,9,3
4610,1,1,5.870825127382537,0.9971873880341774,13,17,8,2,15,10,3
4611,1,1,1.3726061306589104,0.7978008868728365,12,16,9,4,12,7,5
4612,1,1,3.0659775518859975,0.9554673324434864,12,18,12,3,15,10,2
4613,1,1,2.3533294961396183,0.9131985100418493,9,11,6,2,9,7,2
4614,0,0,2.3508028889507138,0.08700197570673784,25,38,24,8,30,7,18
4615,0,0,5.6859418697074,0.003381859878209603,32,48,30,6,42,7,25
4616,0,0,3.8534858442289557,0.02076534432080368,39,58,35,8,50,12,27
4617,1,1,1.750151001935923,0.8519718467133105,5,5,3,0,5,5,0
4618,1,1,2.4265067328217755,0.9188263701990621,14,18,10,3,15,8,6
4619,0,0,3.4298742022630164,0.03137475506383214,19,24,13,2,22,5,14
4620,1,1,1.4270359507920585,0.8064390624095811,7,6,2,1,5,5,2
4621,1,1,1.191977650137279,0.7670945787812858,11,14,7,5,9,7,4
4622,1,1,4.001836531450568,0.9820461994543613,26,40,28,9,31,18,8
4623,1,1,3.966624177029389,0.9814147003748797,22,32,19,6,26,15,7
4624,0,0,3.0769930291419154,0.04406630893255348,21,28,17,5,23,5,16
4625,1,1,3.9074588228878655,0.9803042252213041,11,13,8,2,11,9,2
4626,1,1,2.4621728231927973,0.921447080986115,11,15,12,2,13,10,1
4627,1,1,2.9741084609839596,0.9513906316813157,27,41,29,5,36,20,7
4628,1,1,5.235432853267185,0.9947036811025315,42,69,44,17,52,23,19
4629,0,1,1.2239377129957685,0.7727557712939224,15,21,13,3,18,11,4
4630,0,0,0.34613405049961976,0.41432021662726326,21,27,13,8,19,10,11
4631,1,0,0.7135795065944518,0.3288083830685309,6,5,1,1,4,1,5
4632,0,0,4.48693281921883,0.0111298447329784,15,18,9,1,17,1,14
4633,0,0,1.687403458454003,0.1561176158801011,18,26,17,7,19,8,10
4634,1,1,1.8653981438202887,0.8659249058389054,8,9,4,2,7,5,3
4635,1,1,2.6240763136465146,0.9323951080295249,32,50,30,11,39,19,13
4636,1,1,5.163786209295064,0.994312530820535,11,17,8,1,16,10,1
4637,0,0,7.482187077387885,0.0005627078710388478,18,21,11,2,19,1,17
4638,1,1,3.4529194685262468,0.9693180862631473,21,31,18,6,25,15,6
4639,1,1,2.078747552421367,0.8888203282391849,27,40,27,9,31,16,11
4640,0,0,5.974019286878097,0.002537540301965624,17,19,10,2,17,3,14
4641,0,0,2.445960943437953,0.07973441976386164,9,11,7,2,9,3,6
4642,0,1,1.0155950768663577,0.7341136862212467,18,26,17,8,18,8,10
4643,0,0,5.319922531405025,0.00486930661091034,18,23,13,2,21,3,15
4644,1,1,2.4785326440622537,0.9226231086919858,9,12,8,0,12,9,0
4645,1,1,0.9056501692007601,0.712109228768965,8,8,2,3,5,5,3
4646,0,0,0.21681870447158147,0.44600667875343225,28,42,27,10,32,16,12
4647,1,0,0.6112890563777231,0.3517652028394932,13,17,8,6,11,6,7
4648,1,1,2.1457822477413124,0.8952739856243699,13,21,16,2,19,12,1
4649,1,1,2.8288320097180994,0.9442141114683962,8,10,4,1,9,7,1
4650,0,0,9.938985286131832,4.825391752660835e-05,30,40,26,2,38,3,27
4651,1,1,3.1676685469198365,0.9595992944551314,22,31,19,4,27,17,5
4652,0,0,1.4004591604410441,0.19774325972341766,14,16,8,2,14,3,11
4653,1,1,3.3570214887222285,0.9663340125111491,8,11,6,0,11,8,0
4654,1,1,3.5800840475410207,0.9728825002404421,11,15,9,1,14,10,1
4655,0,0,1.9679954357559035,0.12260435979141249,13,16,8,2,14,3,10
4656,1,1,3.9193550188367454,0.980532607580006,12,16,11,1,15,11,1
4657,0,0,3.1256961133868306,0.04205967210809791,21,29,18,4,25,5,16
4658,0,0,6.378673448796851,0.0016944969226447837,19,25,12,3,22,2,17
4659,1,1,0.385701477719242,0.5952474907165691,22,30,17,10,20,11,11
4660,1,1,3.4796279138503508,0.9701025302418871,14,22,15,1,21,13,1
4661,1,1,2.4993815074455545,0.9240984499762267,10,12,7,2,10,7,3
4662,1,0,0.7675145201887883,0.31701701054055276,25,39,26,8,31,13,12
4663,0,0,3.137071091032868,0.04160374665522926,19,24,12,2,22,3,16
4664,0,0,0.7204762062856167,0.3272881276822557,12,13,5,4,9,4,8
4665,0,0,2.4910159157122056,0.07649040256751838,33,49,28,12,37,12,21
4666,1,1,1.380192479135433,0.7990219114629992,12,14,6,3,11,8,4
4667,0,0,0.49517786370750416,0.3786745561085637,11,12,8,1,11,2,9
4668,1,1,1.23944267956263,0.775466989681993,24,36,20,10,26,13,11
4669,0,0,3.3519028192743177,0.03383290913620507,24,35,18,7,28,8,16
4670,0,0,3.840929673286043,0.021022205568786645,14,18,10,3,15,2,12
4671,1,1,1.4898188056226114,0.8160510747387901,14,18,11,5,13,7,7
4672,0,0,2.392471628621604,0.08374857685662718,7,7,4,0,7,0,7
4673,1,1,0.08979399976798996,0.5224334286429092,32,50,32,11,39,15,17
4674,1,1,5.403597200497164,0.9955197994468349,18,31,21,2,29,17,1
4675,0,0,4.69459162664432,0.009061735065188703,13,14,7,1,13,2,11
4676,1,1,3.093649750272265,0.9566300421650723,9,11,5,1,10,7,2
4677,1,1,5.078241712187204,0.9938077281218964,18,24,12,4,20,14,4
4678,0,0,0.2597033974641521,0.4354366210672628,1,0,0,0,0,0,1
4679,0,0,0.36125444226636927,0.4106559347967622,6,5,2,1,4,2,4
4680,1,0,0.7316655875169245,0.3248293321724435,33,50,31,16,34,18,15
4681,0,0,1.822232038590399,0.13916626151938527,36,57,39,10,47,15,21
4682,0,0,9.611766947417017,6.693196638063448e-05,29,42,22,3,39,4,25
4683,0,0,1.2244361348733395,0.22715671558552897,27,39,24,7,32,13,14
4684,1,1,6.313231923934579,0.9981911110300292,17,23,11,4,19,12,5
4685,1,1,0.9373599796205638,0.7185660772743641,14,17,11,3,14,9,5
4686,1,1,3.0899397961184576,0.9564758588386395,18,24,12,4,20,11,7
4687,0,0,1.930322326769849,0.1267149077173363,18,21,12,2,19,5,13
4688,1,1,5.745291375584259,0.9968123906912415,17,23,13,3,20,12,5
4689,0,0,8.221342926671623,0.0002687815085418155,28,38,24,6,32,6,22
4690,0,0,6.308653973404931,0.0018171738756392886,27,39,20,5,34,5,22
4691,0,1,1.6614403448021715,0.8404312574680826,16,20,11,7,13,9,7
4692,1,0,2.2791339367088903,0.09286588613823155,8,8,4,0,8,0,8
4693,0,0,0.6433362511569101,0.344492765131015,8,10,5,4,6,4,4
4694,1,1,2.5617238793278894,0.928357197841619,12,16,9,3,13,8,4
4695,0,0,1.6705503102702135,0.1583508219916968,18,21,13,4,17,7,11
4696,0,0,0.0211559516432569,0.4947112093482744,15,19,10,6,13,7,8
4697,0,1,0.9683087046191226,0.7247822584238086,3,2,1,0,2,3,0
4698,1,1,5.252270111188809,0.9947916494813128,9,11,6,1,10,8,1
4699,0,0,1.3418140927380504,0.2072118899637223,3,2,0,0,2,0,3
4700,1,1,5.2172027139901935,0.9946067685210992,10,15,9,0,15,10,0
4701,0,0,1.6800131603276403,0.15709372624902163,23,33,23,6,27,7,16
4702,1,1,1.9583881884925054,0.8763584115705015,16,21,10,4,17,10,6
4703,0,1,0.28430917318237103,0.5706023570115284,17,23,14,6,17,7,10
4704,0,0,3.1890228288783335,0.03958090928099134,17,24,14,3,21,4,13
4705,0,0,5.147198420754471,0.005782048484531788,30,46,27,10,36,9,21
4706,1,1,4.629348394648723,0.9903332409433807,11,16,9,2,14,9,2
4707,1,1,2.088777099584787,0.8898075773335203,8,10,7,0,10,8,0
4708,0,0,2.4314536328532643,0.08080543149397079,19,26,15,7,19,7,12
4709,0,0,4.146958760505495,0.015566291883668426,15,18,11,4,14,4,11
4710,0,0,2.8151221382522342,0.0565124533623097,8,11,7,0,11,0,8
4711,0,0,3.1256138796093857,0.04206298548571774,36,52,29,9,43,16,20
4712,0,0,5.383410244999354,0.004571143583875892,31,45,30,9,36,12,19
4713,1,1,0.02325513661352785,0.5058135221590101,9,10,4,3,7,5,4
4714,1,1,4.249872236163766,0.9859346012936684,12,18,13,0,18,12,0
4715,1,1,2.691615793081983,0.9365300945631045,22,34,22,6,28,15,7
4716,0,0,3.5678728900558023,0.027441523266547918,37,55,32,11,44,13,24
4717,1,1,0.9352683747544037,0.7181429010837193,11,12,6,3,9,6,5
4718,1,1,3.2577151260986357,0.9629493573919456,9,13,8,0,13,9,0
4719,0,0,2.1409657714082604,0.10517846036227341,16,21,13,3,18,4,12
4720,1,0,0.8837386858908762,0.29240363084114407,12,15,8,2,13,3,9
4721,0,0,2.0503148001052174,0.11402057634527718,18,22,11,6,16,7,11
4722,1,1,4.227440349978394,0.9856201107985525,19,27,19,4,23,16,3
4723,0,0,0.9948322346528091,0.26995867810358887,15,16,9,4,12,4,11
4724,1,0,1.5560862439460372,0.1742089630404321,32,50,30,12,38,17,15
4725,0,0,5.810556672669279,0.0029868141650436497,35,52,34,10,42,10,25
4726,0,0,6.854110547876592,0.0010539976048251631,37,57,36,9,48,12,25
4727,0,1,0.32308273558344286,0.580075354167422,13,16,10,4,12,8,5
4728,0,0,0.20799790511022365,0.4481871878653446,9,10,4,2,8,3,6
4729,0,0,2.526116932565045,0.07404744691038201,31,45,28,9,36,12,19
4730,1,1,1.8710759541376556,0.866582725243349,23,32,16,8,24,10,13
4731,0,0,4.7577926457986965,0.008511470575037539,11,12,6,0,12,0,11
4732,0,0,0.07750468915405229,0.4806335212401651,29,45,26,10,35,12,17
4733,0,0,2.0152735446816754,0.11760860155881481,15,18,9,2,16,2,13
4734,0,0,5.428830248515724,0.004369053541331658,20,27,15,5,22,3,17
4735,0,0,1.0292827931339432,0.26322317330162925,4,3,0,1,2,1,3
4736,0,0,0.5957032773144917,0.3553273303007126,2,1,0,0,1,0,2
4737,1,1,0.7029194586049743,0.6688347355942217,11,13,5,3,10,7,4
4738,0,1,0.33748667335407423,0.5835798769539633,9,10,4,3,7,5,4
4739,0,1,0.04607447809709364,0.511516582257737,11,13,7,5,8,5,6
4740,1,1,3.609132729403232,0.9736384295956594,11,17,11,0,17,11,0
4741,1,1,5.839214588161501,0.9970973219052751,20,29,16,3,26,17,3
4742,1,1,2.1480583824691353,0.8954872006273606,5,6,3,0,6,5,0
4743,1,1,2.3883711239311056,0.9159362343944583,25,41,29,6,35,14,11
4744,1,1,5.501755008842416,0.995936970150036,13,21,15,0,21,13,0
4745,0,0,0.29578592938655324,0.42658796952063716,14,19,12,3,16,5,9
4746,1,1,3.100599995716639,0.9569174875104551,14,19,10,2,17,11,3
4747,1,1,2.5799774087089875,0.9295617899190618,33,51,31,13,38,15,18
4748,0,0,0.7790434509918324,0.31452608088044975,7,7,4,1,6,1,6
4749,1,1,0.6606879407549466,0.6594149078638258,25,36,21,10,26,10,15
4750,1,1,1.3855856693723392,0.7998865852123014,6,6,4,1,5,5,1
4751,0,0,0.5612637530980673,0.3632551020903413,16,22,10,4,18,5,11
4752,1,1,1.2803896764719909,0.7825161006790148,14,19,11,6,13,9,5
4753,0,0,0.23010079574044173,0.4427272769494336,18,25,17,8,17,9,9
4754,0,0,4.323247592064236,0.013083318578732128,17,20,10,4,16,4,13
4755,0,0,2.4042203652232823,0.08285143817056528,6,6,3,2,4,1,5
4756,0,0,4.439303227025087,0.011666447852388462,11,11,5,0,11,0,11
4757,0,0,0.5242919353025925,0.37184918458069727,12,15,8,4,11,4,8
4758,0,0,3.482732130094581,0.029807567544004154,21,27,15,6,21,5,16
4759,0,0,2.439608688529742,0.08020177426302455,18,23,15,6,17,8,10
4760,1,1,5.2367141667866015,0.9947104271283905,19,24,15,3,21,13,6
4761,0,1,1.8498203314854316,0.8641060064694521,20,30,19,9,21,10,10
4762,0,0,2.914240882129548,0.05145405852171547,25,35,21,7,28,7,18
4763,1,0,0.24390774218186762,0.4393235749860367,19,25,13,5,20,9,10
4764,0,1,1.0535593353087371,0.741457803288964,19,25,16,5,20,10,9
4765,0,0,4.80342339019886,0.008134902193911553,19,25,14,6,19,8,11
4766,0,0,2.8710117549631073,0.05360530069659386,8,8,4,2,6,2,6
4767,1,0,0.11779543988649133,0.47058514496802106,12,14,10,4,10,6,6
4768,0,0,1.3152623595462454,0.21160759328438994,38,62,40,16,46,17,21
4769,1,0,0.36853604954056784,0.4088948109163495,14,18,11,4,14,5,9
4770,0,0,2.2234757311582243,0.09766207965667184,31,46,25,11,35,12,19
4771,0,1,0.6172954460174873,0.6496031903658537,24,34,18,11,23,7,17
4772,0,1,1.3626311598567353,0.7961869973649155,18,25,14,7,18,11,7
4773,0,0,0.8106012489332906,0.30776238799610467,9,9,2,3,6,2,7
4774,0,0,3.0990153720858946,0.043147888153481695,34,52,30,16,36,14,20
4775,1,1,4.273964095205819,0.986264814868707,29,44,30,11,33,17,12
4776,1,1,0.01207010644458073,0.5030174899770274,10,12,5,3,9,7,3
4777,1,1,0.8075543411039923,0.6915881045041268,4,3,1,1,2,3,1
4778,0,0,3.177038829305669,0.04003899424310653,13,14,8,2,12,4,9
4779,1,0,0.2597033974641521,0.4354366210672628,1,0,0,0,0,0,1
4780,1,1,2.429669093740185,0.9190619210385393,15,20,12,6,14,11,4
4781,0,0,2.142367624682839,0.10504659661278826,22,30,16,7,23,7,15
4782,1,1,3.079946435024496,0.9560579343320457,8,11,5,1,10,7,1
4783,0,0,3.397565756334373,0.032371627494135136,34,50,27,11,39,12,22
4784,0,1,2.040429806688989,0.8849770263729873,14,17,9,6,11,8,6
4785,0,1,4.3265867589489275,0.986959727201482,33,54,31,16,38,19,14
4786,1,1,3.6650928478198326,0.9750372959078217,8,10,4,1,9,7,1
4787,1,1,0.31280710265277134,0.5775702947504712,3,2,0,1,1,2,1
4788,1,1,5.961769147763381,0.9974312636381498,15,22,15,1,21,14,1
4789,0,0,6.40292478660241,0.00165396454180744,28,38,23,5,33,7,21
4790,1,1,3.137472422293137,0.958412252632329,42,70,46,17,53,24,18
4791,0,0,2.4949843147323243,0.07621054707305042,8,10,5,2,8,1,7
4792,0,0,3.3999769667005593,0.03229618455365124,16,22,12,3,19,6,10
4793,0,0,6.383255725605142,0.0016867630986199256,33,46,29,7,39,8,25
4794,0,0,0.6724843223175125,0.33794078285935925,16,23,14,5,18,5,11
4795,0,0,5.510225894700719,0.004028895829042645,29,40,23,10,30,9,20
4796,1,1,4.428649573142875,0.9882100706272272,27,45,28,9,36,19,8
4797,0,0,5.1673178511819575,0.005667532139686959,24,34,20,4,30,5,19
4798,1,1,4.688913774061626,0.9908871375972468,19,31,22,3,28,17,2
4799,0,1,0.3739718647005039,0.5924183712007067,10,10,6,2,8,4,6
4800,1,1,1.2523590780508334,0.7777079617209571,6,6,3,1,5,4,2
4801,1,1,1.4197969606615035,0.805306584272393,6,6,3,1,5,5,1
4802,1,1,4.228138026720799,0.9856299956969009,9,13,8,0,13,9,0
4803,1,0,1.2966129339133052,0.21473560649960044,12,13,6,2,11,2,10
4804,1,0,0.836568204778882,0.3022580516377942,37,59,38,11,48,17,20
4805,1,1,0.8250493629349008,0.6953071272391826,6,5,2,2,3,3,3
4806,0,0,3.1989053241706853,0.039206938172216765,14,17,11,3,14,3,11
4807,0,0,1.641066084523922,0.16232005247681514,13,14,7,2,12,3,10
4808,1,0,4.705617962941102,0.008963256840039957,10,9,4,2,7,2,8
4809,0,0,0.5350647773836339,0.3693363858182922,7,7,3,3,4,4,3
4810,1,1,6.800583930143104,0.998888112698709,20,31,19,4,27,17,3
4811,1,1,2.9471941487599764,0.9501307084172739,14,20,13,2,18,12,2
4812,0,0,3.9922361443999326,0.018123855078548856,21,28,15,6,22,6,15
4813,0,1,0.3120086241765363,0.5773754676397855,10,11,6,3,8,6,4
4814,0,0,3.0158912889154776,0.04671309908683008,15,19,10,6,13,7,8
4815,0,1,0.16674836307712804,0.5415907660705387,9,9,5,2,7,4,5
4816,1,1,2.261512086426484,0.9056389287910527,15,21,11,6,15,9,6
4817,1,0,0.30140898279021044,0.42521308181487005,29,43,21,11,32,13,16
4818,1,1,3.0479486703155994,0.9546938820945279,14,18,9,4,14,9,5
4819,0,0,1.3608363019149705,0.20410441492968578,13,16,10,3,13,6,7
4820,1,1,0.4241920339200713,0.6044859303267085,5,4,2,1,3,3,2
4821,0,0,4.103518267977472,0.01624617377698334,14,17,10,2,15,1,13
4822,1,1,5.066784425156531,0.9937368204077912,11,16,9,0,16,11,0
4823,1,1,3.424429185773385,0.9684593459069294,19,27,19,3,24,14,5
4824,1,1,2.384329950144995,0.9156245524659468,14,21,11,4,17,10,4
4825,1,1,3.2590950253313298,0.9629985578502032,16,21,15,3,18,13,3
4826,1,1,3.3451182231066303,0.9659446115386316,10,14,6,2,12,8,2
4827,1,1,0.1302565185593363,0.5325181653087867,7,8,4,2,6,4,3
4828,0,0,0.7790936892331493,0.3145152496454189,13,15,8,3,12,4,9
4829,1,1,1.454234935322231,0.8106493391463034,14,18,9,4,14,10,4
4830,0,1,2.052121660325161,0.8861618252070275,18,25,18,3,22,14,4
4831,0,0,1.2501360186636274,0.2226765942316049,23,29,15,8,21,10,13
4832,0,0,3.071234689356177,0.04430951378348813,16,20,12,6,14,5,11
4833,0,1,2.0318350478083724,0.8840992437635903,9,11,6,2,9,7,2
4834,1,1,2.6693870199484673,0.9351958919305543,6,7,4,0,7,6,0
4835,1,0,0.3899930826325928,0.40371896591969947,15,18,10,3,15,4,11
4836,0,0,2.0865409390590686,0.11041186951806958,27,38,22,7,31,8,19
4837,1,0,1.10884240597726,0.24808676285049258,20,28,17,6,22,7,13
4838,0,0,7.366823110807523,0.0006314733718046917,21,26,14,3,23,4,17
4839,1,1,3.6099017334356205,0.9736581601563553,9,12,9,0,12,9,0
4840,1,1,3.406269916671632,0.9678999120932187,11,14,7,2,12,9,2
4841,0,0,1.1683445338932525,0.23715434789648993,30,46,30,12,34,16,14
4842,0,0,4.078273171102796,0.016654613202154667,9,8,3,1,7,1,8
4843,0,1,3.3393097168815027,0.965753019135932,19,25,16,5,20,13,6
4844,1,1,3.2481165230028326,0.962605373553983,26,38,23,10,28,15,11
4845,0,1,0.9058051165913426,0.7121409934391274,11,13,8,5,8,7,4
4846,1,1,6.280745341549412,0.9981314930627783,26,39,23,7,32,19,7
4847,0,0,4.0411875825705055,0.017272986234119103,7,6,3,0,6,0,7
4848,1,1,3.377380221646203,0.9669900834196563,9,10,7,1,9,8,1
4849,0,1,1.207024651641738,0.7697720720927173,15,17,8,4,13,8,7
4850,1,1,3.093655804439491,0.9566302933457498,10,13,8,1,12,9,1
4851,0,0,2.928262562807085,0.050773997123957026,12,13,6,1,12,1,11
4852,0,0,2.47986165319171,0.07728206700825224,13,14,9,3,11,4,9
4853,1,1,0.7126238857266363,0.6709806831925906,17,25,14,8,17,8,9
4854,1,1,1.5620486761758765,0.8266471281547184,8,10,6,2,8,6,2
4855,1,1,0.09158998679904151,0.5228815033810982,27,36,21,10,26,13,14
4856,1,1,4.761993407630951,0.9915239066681392,19,31,24,1,30,18,1
4857,1,1,0.5132044849150614,0.6255573795778856,9,9,5,3,6,5,4
4858,1,1,0.7847330643518855,0.6866993000709238,11,14,8,5,9,5,6
4859,0,0,1.4157832702725668,0.19532348501809726,5,5,3,0,5,0,5
4860,1,0,0.3951170615095485,0.4024860816079767,9,10,4,2,8,3,6
4861,1,1,0.16169612555385182,0.5403361850568517,5,4,1,2,2,3,2
4862,1,0,0.031523880194232134,0.4921196825327221,23,30,18,8,22,12,11
4863,1,1,2.312985398883361,0.9099467893001201,17,24,16,5,19,12,5
4864,0,1,0.9296228963479045,0.7169987730750171,30,48,33,15,33,13,17
4865,0,0,0.30126552141866036,0.42524814514251585,10,14,9,4,10,4,6
4866,0,0,3.2905532220085196,0.03589669499129855,19,24,12,5,19,6,13
4867,1,1,0.7554360971106058,0.6803620419925751,10,12,6,4,8,6,4
4868,0,1,1.2893178244372172,0.7840317015045412,20,29,19,7,22,11,9
4869,1,1,4.675157760785673,0.9907620808062878,25,42,27,9,33,18,7
4870,1,1,3.30173465010569,0.9644882715075345,6,8,4,0,8,6,0
4871,1,1,0.3469651639155136,0.5858814461301786,17,22,13,8,14,8,9
4872,1,1,4.766866725923576,0.9915647652976916,37,54,35,10,44,20,17
4873,1,1,0.2106408940381277,0.5524663742047604,7,6,2,2,4,3,4
4874,1,0,0.5754964389013804,0.3599695200274715,2,1,0,0,1,0,2
4875,0,0,1.835895372199214,0.13753746326359761,6,5,0,1,4,1,5
4876,0,0,1.6977081647070444,0.15476482904007627,20,29,20,6,23,8,12
4877,1,1,2.043084363386943,0.8852469648175024,16,22,14,5,17,9,7
4878,0,0,5.2222334226922005,0.005366313066092587,12,16,8,0,16,0,12
4879,0,0,0.7583530915515697,0.31900393460506415,14,17,9,2,15,3,11
4880,1,1,1.6815745140111447,0.8431129101730471,25,36,21,8,28,12,13
4881,1,0,0.5941080275365032,0.35569283815574104,22,29,13,9,20,10,12
4882,0,0,2.100498043026483,0.1090484234740643,29,46,28,13,33,11,18
4883,1,1,4.466316042636489,0.9886409455466644,12,16,8,1,15,11,1
4884,0,0,3.1778390304983866,0.0400082491292707,12,13,6,1,12,1,11
4885,0,0,1.6094873898684217,0.1666597949141223,17,26,16,10,16,7,10
4886,0,0,3.6244579642103956,0.025971065321086617,15,18,8,3,15,3,12
4887,1,1,0.21584963758557585,0.5537538671149032,13,19,11,6,13,7,6
4888,0,0,0.7430077261454033,0.3223467873081761,13,17,9,4,13,5,8
4889,0,0,6.0224906608288,0.0024177658825909054,39,61,38,13,48,12,27
4890,1,1,0.06325838299423969,0.5158093241871646,21,28,17,8,20,7,14
4891,0,0,0.3235103968956465,0.4198204762644119,6,6,4,2,4,3,3
4892,0,0,3.796682303109814,0.021952390629108143,18,20,10,1,19,2,16
4893,1,1,0.29094434583680906,0.5722273086931089,30,45,25,14,31,15,15
4894,0,0,3.163600590872783,0.0405587092427655,23,32,20,6,26,6,17
4895,1,1,1.046392159944321,0.7400814932698947,11,13,7,3,10,7,4
4896,0,0,1.0465335024473363,0.25989131888495587,11,12,7,1,11,1,10
4897,1,1,2.153402643791846,0.89598631326603,9,12,7,2,10,7,2
4898,1,1,3.43634978537225,0.9688214442899138,12,17,9,1,16,11,1
4899,0,0,7.098581016638423,0.0008255943951961386,23,28,14,4,24,4,19
4900,1,1,1.8525308608970268,0.8644239812976642,31,49,35,14,35,19,12
4901,0,0,6.098872446567109,0.00224036758187407,27,39,24,4,35,4,23
4902,1,1,4.072681636726624,0.9832535649915646,12,16,9,3,13,9,3
4903,1,1,1.752052655189529,0.8522115147822009,5,5,2,1,4,4,1
4904,0,0,1.0348485484931815,0.26214519227446087,4,3,2,0,3,0,4
4905,1,0,0.5238303184880726,0.3719570141984073,24,35,22,7,28,10,14
4906,1,0,0.6235733262309417,0.34896919103224,3,2,1,0,2,0,3
4907,1,1,5.283853762882577,0.9949527603187179,16,23,14,1,22,15,1
4908,0,0,2.4285827840661485,0.08101892318954673,12,14,9,2,12,3,9
4909,0,0,0.04003486893297703,0.48999261937579286,20,25,16,7,18,10,10
4910,0,1,2.493666013732629,0.9236965893736097,9,12,8,1,11,8,1
4911,0,0,1.0645206822041806,0.25644649470095726,20,30,19,5,25,5,15
4912,1,0,2.391485116593752,0.08382430770489979,8,8,4,0,8,0,8
4913,1,1,2.01079373669796,0.8819257012424798,13,18,11,2,16,9,4
4914,1,1,1.074885630561494,0.7455249168500089,7,7,3,2,5,5,2
4915,0,0,4.328799201532666,0.013011828822993454,44,74,45,17,57,16,28
4916,0,1,1.7774572023808335,0.8553825978464811,7,8,3,1,7,6,1
4917,0,1,0.13047086651782536,0.5325715252680828,9,10,4,4,6,4,5
4918,0,0,0.1209511094850737,0.4697990315822528,19,23,11,5,18,6,13
4919,0,0,0.8316407123140017,0.3032982619912007,31,48,28,11,37,11,20
4920,1,1,2.584188068051227,0.9298369916909708,12,16,8,2,14,8,4
4921,1,0,9.735591341995228,5.913719461880795e-05,20,23,11,1,22,1,19
4922,0,0,2.867433091301053,0.05378714294539988,19,24,14,5,19,5,14
4923,0,0,9.21681873730989,9.934438711545202e-05,33,50,30,5,45,5,28
4924,1,1,5.514703819077792,0.9959890327282577,21,30,15,4,26,16,5
4925,0,0,2.2350236268085655,0.09664914811039726,5,5,2,0,5,0,5
4926,0,0,1.6828054406953583,0.15672433956579435,14,19,10,5,14,5,9
4927,0,1,0.3788952766017206,0.5936066294760984,15,17,11,5,12,7,8
4928,0,0,8.163744838543618,0.00028471280375785835,28,38,20,8,30,6,22
4929,1,1,2.3478133740582745,0.912760265882547,11,12,5,3,9,7,4
4930,0,0,2.245427771511542,0.09574458627737936,21,27,16,5,22,9,12
4931,1,1,1.7753999680997599,0.8551279252612948,5,4,1,1,3,4,1
4932,1,1,1.8855266879147945,0.8682446445017903,16,22,14,4,18,10,6
4933,1,1,2.7759337343212502,0.9413613885052199,14,20,13,3,17,11,3
4934,1,1,1.0711303805766956,0.7448118235145529,22,30,17,8,22,11,11
4935,0,0,3.965261058050569,0.018610179082939604,12,15,10,0,15,0,12
4936,0,0,2.7669892202753994,0.05913430335508818,27,42,27,9,33,10,17
4937,0,0,3.384411335800637,0.032786217004785456,6,5,3,0,5,0,6
4938,1,1,2.2004060502085556,0.9002859683970225,14,18,8,6,12,9,5
4939,0,0,2.474486708986009,0.07766622376821575,12,14,5,4,10,3,9
4940,1,1,2.776222301419797,0.9413773154164548,10,13,6,2,11,7,3
4941,1,0,0.8460956518510558,0.3002525244795934,16,21,13,4,17,6,10
4942,1,1,2.6572206238858005,0.9344546375217718,17,24,16,3,21,14,3
4943,1,1,2.3901221378424298,0.9160709591424223,11,15,11,1,14,10,1
4944,0,1,1.0501140325268365,0.7407967959560374,17,23,13,9,14,6,11
4945,1,0,0.2597033974641521,0.4354366210672628,1,0,0,0,0,0,1
4946,1,1,6.650388410462324,0.9987081514400825,15,23,18,1,22,14,1
4947,1,1,0.9269890074627989,0.7164640213163769,5,4,1,2,2,3,2
4948,0,0,3.928298426215795,0.019297408621033907,24,33,20,4,29,5,19
4949,1,1,1.8067794192009055,0.858972187282593,13,19,13,2,17,11,2
4950,0,0,1.2118435030139676,0.22937502688477662,14,16,7,4,12,4,10
4951,1,1,2.3284463739734296,0.9112057133599565,4,4,2,0,4,4,0
4952,0,0,1.5367068786225575,0.17701450776590577,41,64,45,15,49,21,20
4953,0,0,4.206860112647695,0.014674509213449705,10,12,6,1,11,1,9
4954,1,1,1.2934942139220729,0.7847380339020634,5,5,2,1,4,4,1
4955,0,1,1.1482166673656484,0.7591850332295874,22,32,21,7,25,13,9
4956,1,1,3.2220758923136423,0.961656632593931,11,15,7,2,13,9,2
4957,0,0,3.429365112300895,0.03139023019274245,22,29,14,4,25,5,17
4958,0,1,0.728164553334437,0.6744023672881851,5,4,2,1,3,3,2
4959,0,0,3.713526701616292,0.02381057823627486,32,49,30,9,40,10,22
4960,0,0,1.7203583634494175,0.15182500994039305,14,18,10,4,14,5,9
4961,0,0,0.12077348290412271,0.4698432764517887,11,13,7,3,10,4,7
4962,0,0,7.800726323123547,0.0004092699165945124,14,13,6,1,12,2,12
4963,0,0,3.448369614714725,0.03081751814445355,26,35,22,8,27,10,16
4964,1,1,1.8831172299762238,0.8679687677926015,15,19,10,3,16,11,4
4965,1,1,1.3263128611241748,0.7902300847408581,18,22,13,5,17,11,7
4966,1,0,0.4192305510193659,0.39670088717110863,19,24,12,8,16,9,10
4967,0,0,0.7382373093299006,0.32338971587304666,25,36,19,9,27,9,16
4968,0,0,4.518947876028558,0.01078294693503612,25,32,16,5,27,7,18
4969,0,0,0.7477305410106356,0.3213160055306915,6,5,1,1,4,1,5
4970,0,0,3.314800050699714,0.03506693573906594,21,26,16,4,22,7,14
4971,0,0,1.6978292903404695,0.15474898493431677,12,14,8,3,11,4,8
4972,0,0,2.3151327526064667,0.08987740357174301,15,17,8,3,14,4,11
4973,0,0,0.5407738757728873,0.3680075774063538,20,29,19,7,22,8,12
4974,0,0,2.1554231859008013,0.10382553324294863,15,17,9,6,11,6,9
4975,1,1,0.2827285574236791,0.5702150388136589,17,22,12,7,15,8,9
4976,0,0,3.4198703786450517,0.031680204476139395,32,49,31,8,41,8,24
4977,1,1,0.43154848731719797,0.6062433722202876,12,16,9,5,11,6,6
4978,0,0,2.92339711459918,0.051009005448473976,12,15,9,2,13,3,9
4979,1,1,1.4432736884366903,0.8089610889996066,26,39,22,12,27,14,12
4980,1,1,2.4591904445372794,0.9212309378735296,20,29,18,5,24,15,5
4981,1,1,1.9352485502535548,0.8738292178175229,6,7,5,0,7,6,0
4982,1,0,0.7645199116763097,0.31766574986730123,2,1,0,0,1,0,2
4983,0,0,5.463901612107394,0.00421911599100655,18,22,11,3,19,3,15
4984,1,1,2.183667629588303,0.8987732410487501,13,17,10,4,13,7,6
4985,1,1,2.287783363591521,0.907860195859088,11,15,8,2,13,9,2
4986,1,1,3.2202677269597384,0.9615899041516461,12,19,12,0,19,12,0
4987,1,1,1.415937942523841,0.8047008240175846,6,6,3,1,5,5,1
4988,1,1,5.194742010235756,0.9944849377370931,16,23,15,2,21,14,2
4989,0,0,1.0852236822047905,0.25251875674777013,10,11,6,1,10,2,8
4990,0,0,2.661970088119174,0.06525506130670289,41,63,39,8,55,12,29
4991,0,1,0.1683506636900649,0.5419885429839569,13,14,8,5,9,5,8
4992,0,1,2.7094454262590975,0.9375817015892334,22,34,24,4,30,16,6
4993,0,0,6.214071825484623,0.001997076537908704,29,41,28,6,35,8,21
4994,1,0,1.0841358845426283,0.2527241371272412,18,22,14,5,17,7,11
4995,1,1,3.998412948088741,0.9819857369520678,20,28,18,5,23,14,6
4996,0,0,5.686931469625901,0.0033785261466260375,16,21,10,3,18,2,14
4997,1,1,2.812416915299072,0.943343134238772,9,11,7,1,10,8,1
4998,1,1,2.0444653628603797,0.8853871787200985,9,11,6,2,9,7,2
4999,0,0,3.179870434507339,0.03993030066285552,17,23,14,4,19,5,12
5000,1,1,1.2202345177761986,0.7721048175659935,14,15,6,6,9,5,9
5001,1,1,2.632037306404528,0.9328952008850847,8,11,8,0,11,8,0
5002,0,1,0.8641968175533125,0.7035367433832437,18,25,18,4,21,11,7
5003,1,1,1.1190640657137934,0.753815068982873,29,44,30,10,34,17,12
5004,1,1,0.7440981992138591,0.6778913687442156,9,10,5,4,6,6,3
5005,0,0,0.4737802808109033,0.38372189300471715,13,13,4,4,9,4,9
5006,1,1,1.9324156759343498,0.8735165576613764,13,16,8,4,12,6,7
5007,1,1,1.6758075065327187,0.8423485774379583,12,15,9,3,12,8,4
5008,1,1,3.013963018728613,0.9532009580489572,7,9,4,1,8,6,1
5009,1,1,1.8130320606742474,0.8597279270841016,14,16,10,3,13,9,5
5010,0,0,2.540282925638166,0.07308200543429333,20,28,18,5,23,5,15
5011,0,0,4.503198708959708,0.010952239037535172,24,32,19,3,29,4,20
5012,1,0,2.0352126285321925,0.11555511181063327,10,11,7,2,9,3,7
5013,0,0,4.678045998475993,0.009211521802073519,16,21,11,0,21,0,16
5014,0,0,2.936071696397104,0.050398945745320334,13,15,7,2,13,3,10
5015,0,1,0.13816012989168636,0.5344851948300031,13,19,11,6,13,7,6
5016,0,0,1.6860333620037884,0.15629820416428553,18,24,14,2,22,5,13
5017,0,1,5.389514578901828,0.9954565488155654,33,50,31,11,39,20,13
5018,0,1,0.09567720369995758,0.523901070918972,14,20,12,7,13,6,8
5019,1,1,1.9696972263317776,0.8775785885851987,4,4,2,0,4,4,0
5020,1,1,5.733064244306572,0.9967733026550191,22,33,20,4,29,16,6
5021,0,0,4.518919820944822,0.01078324619360349,22,28,16,7,21,6,16
5022,1,0,1.8251811229218589,0.1388133399366268,18,22,13,4,18,6,12
5023,1,1,3.354306511717603,0.9662455753660046,9,13,6,1,12,8,1
5024,0,0,1.6445536445822095,0.16184639936952872,17,22,12,5,17,5,12
5025,1,0,1.938929179598985,0.12576554451637112,23,32,19,6,26,8,15
5026,0,0,1.3645174112589857,0.20350708546743923,10,12,7,3,9,4,6
5027,0,0,0.7796547454802139,0.3143943010852389,16,20,9,4,16,5,11
5028,1,1,3.732025347712901,0.9766156309632089,16,19,11,5,14,11,5
5029,1,0,0.46248134721278933,0.38639734465792697,11,13,8,4,9,6,5
5030,0,0,4.1206786248055085,0.015974177532071754,14,16,8,2,14,3,11
5031,1,1,1.6372770130720886,0.8371640795083968,18,26,18,4,22,11,7
5032,1,1,2.974191773600128,0.9513944844531302,10,14,9,0,14,10,0
5033,1,1,3.866740836607409,0.9795024794084896,9,11,6,1,10,7,2
5034,1,1,1.1305787563659735,0.75594569071657,10,13,7,5,8,6,4
5035,0,0,7.290101131244808,0.0006817938915064659,17,23,12,1,22,1,16
5036,0,0,3.565596494048762,0.027502342228197696,23,32,19,5,27,6,17
5037,1,1,3.3592559381711258,0.9664066292393814,11,14,7,2,12,8,3
5038,0,0,3.176556085090313,0.04005755305905201,14,18,9,4,14,4,10
5039,0,0,0.5336445252631905,0.3696672622591234,21,31,20,7,24,10,11
5040,0,0,9.05821432675949,0.00011641714372156997,35,51,29,13,38,9,26
5041,0,0,0.8408451466184008,0.3013568162129123,13,16,11,3,13,4,9
5042,1,1,3.0471812549653725,0.9546606771300679,11,15,9,2,13,9,2
5043,1,1,2.5365577963597716,0.9266652488311995,21,30,19,7,23,15,6
5044,0,0,3.9906075060103543,0.01815286007589889,24,32,18,6,26,6,18
5045,1,1,1.756666858448076,0.8527917161070263,24,38,25,11,27,15,9
5046,1,1,3.287145305538401,0.9639851766983871,15,20,12,3,17,11,4
5047,0,0,2.6058955977489022,0.06875995217559039,19,24,14,6,18,5,14
5048,1,1,3.529384880393919,0.9715123931575839,12,16,11,1,15,11,1
5049,1,1,2.3149436578239704,0.910107127378325,10,11,4,3,8,6,4
5050,0,1,1.719731184268989,0.8480942079396662,13,17,11,2,15,7,6
5051,0,0,3.1822932600928056,0.0398375229936766,16,21,13,2,19,3,13
5052,1,1,0.8691099044270825,0.7045604538768518,30,43,26,11,32,14,16
5053,1,1,1.9303777968792881,0.8732912303802421,5,5,2,0,5,5,0
5054,0,0,2.111930794525796,0.10794260783840004,29,45,26,12,33,12,17
5055,1,1,0.11407147545994256,0.5284869854584333,10,12,6,5,7,6,4
5056,1,1,1.8172720934552737,0.8602384778211092,8,9,4,1,8,7,1
5057,0,0,5.911563671771495,0.002700636046021998,28,37,22,6,31,6,22
5058,1,0,2.197050942197288,0.10001562824790977,49,81,49,23,58,21,28
5059,0,0,3.2502110275289278,0.0373193051075853,14,16,11,2,14,3,11
5060,1,1,0.4634921904069649,0.6138422931007068,4,3,1,1,2,3,1
5061,1,1,3.6985540805076615,0.9758389111055291,20,31,18,5,26,16,4
5062,0,0,0.6100159595938455,0.3520555573288303,15,23,14,6,17,6,9
5063,0,1,0.7939497010312402,0.6886787781798128,15,18,12,4,14,6,9
5064,0,0,1.5096269712157142,0.1809940825777877,22,33,21,5,28,5,17
5065,1,0,0.09175170918689157,0.47707815084321537,10,11,7,5,6,5,5
5066,1,0,0.45719256603792835,0.3876520361700381,12,16,10,3,13,4,8
5067,0,0,1.1552477528127025,0.23953186535074167,11,12,6,2,10,3,8
5068,0,0,2.1929672512406744,0.10038381237466354,19,26,16,8,18,7,12
5069,1,1,5.5827550242348405,0.9962519146818787,38,63,39,15,48,22,16
5070,1,1,1.1934025205198808,0.7673490499278586,12,16,10,3,13,9,3
5071,1,1,2.1129379020364487,0.8921543292689456,18,27,17,6,21,12,6
5072,1,1,2.759122995513445,0.9404265192762163,11,16,9,1,15,10,1
5073,1,0,0.055625663839098616,0.4860971687171862,12,13,7,3,10,4,8
5074,1,1,1.7621542770325282,0.8534792629309296,29,44,26,14,30,13,16
5075,0,1,0.08362137817543047,0.5208931712767306,15,18,11,7,11,8,7
5076,0,0,0.30628443039814357,0.4240219253752475,12,14,7,3,11,4,8
5077,0,0,5.193530090016003,0.005521713201653844,20,29,18,0,29,0,20
5078,1,1,2.136657421927845,0.8944153649387933,13,18,11,2,16,11,2
5079,0,0,2.348133433841218,0.08721425145554851,9,9,3,1,8,1,8
5080,0,0,0.15100630501102663,0.4623199976735779,9,10,5,2,8,3,6
5081,0,0,0.9928330740463835,0.27035285580243407,6,6,3,1,5,2,4
5082,0,0,3.792577867777395,0.022040687964467565,25,36,23,4,32,6,19
5083,1,1,1.7235581105904214,0.8485865759745697,14,18,11,3,15,9,5
5084,0,0,4.438461320620116,0.011676159313151135,9,8,5,0,8,0,9
5085,1,1,3.071673617807142,0.9557090694428103,13,17,9,2,15,10,3
5086,1,1,4.0773676425725895,0.9833305502497487,25,38,22,8,30,16,9
5087,1,1,4.520312840060509,0.9892316029745062,20,26,17,5,21,14,6
5088,0,0,2.868179372863304,0.05374917427258841,15,17,8,4,13,3,12
5089,0,0,5.643671438199156,0.0035273618600515366,11,12,6,0,12,0,11
5090,0,0,1.6782048673495629,0.15733332038450465,12,13,6,3,10,4,8
5091,1,1,4.51817931754295,0.9892088520182631,26,37,24,8,29,17,9
5092,1,1,2.215050653885891,0.9015929463141061,11,13,6,3,10,8,3
5093,0,1,1.140471517469469,0.7577661996598756,18,24,14,5,19,12,6
5094,1,1,0.4896481932849408,0.6200235521702899,6,5,1,2,3,4,2
5095,1,0,0.5460383920135095,0.3667840197932023,10,12,7,2,10,3,7
5096,1,0,0.7870041769532903,0.3128122924093988,19,25,12,6,19,7,12
5097,1,1,5.475698608516912,0.9958301581452288,22,36,25,5,31,19,3
5098,1,1,3.5849216770520167,0.9730098357193073,20,30,15,7,23,11,9
5099,1,1,1.0421827441728166,0.7392709484200939,6,6,3,1,5,4,2
5100,0,0,1.965016708429049,0.12292514940963095,11,12,4,2,10,2,9
5101,0,0,1.4871151262229414,0.18435512607270876,10,10,3,2,8,3,7
5102,1,1,2.324512828978241,0.9108869355691518,13,18,10,4,14,9,4
5103,1,1,3.608005617241002,0.9736094849669531,19,26,16,3,23,15,4
5104,0,0,2.4882367651457504,0.07668695192138897,18,28,19,4,24,4,14
5105,1,1,3.513430520594793,0.97106750195254,18,24,15,4,20,12,6
5106,0,0,1.3792183083699436,0.20113457219375108,9,9,4,3,6,3,6
5107,0,0,5.88237889442984,0.002780392541020027,15,18,10,3,15,3,12
5108,1,1,0.3083235127190358,0.5764759969466589,19,28,16,9,19,8,11
5109,0,0,3.4557722286655492,0.030597184624401197,19,22,11,5,17,5,14
5110,1,0,1.4023158563797624,0.1974488771691736,4,3,0,0,3,0,4
5111,1,1,2.039812508715852,0.8849141750179372,15,21,11,4,17,10,5
5112,1,0,1.0299093680975617,0.26310167542857543,15,18,12,4,14,6,9
5113,1,0,2.49281389529997,0.0763634906438313,19,26,18,3,23,7,12
5114,1,1,3.069712594600687,0.9556259865920929,25,35,22,7,28,14,11
5115,1,1,0.3482746964504322,0.5861991348717799,12,14,7,3,11,6,6
5116,0,1,1.8337443903212447,0.8622071863242153,5,5,2,1,4,4,1
5117,1,1,6.529333409966246,0.9985421496976704,27,45,29,9,36,19,8
5118,1,0,1.4474376119401908,0.19039623330821787,21,28,13,6,22,7,14
5119,1,1,5.785546447010867,0.9969377745944416,28,43,27,8,35,20,8
5120,0,0,3.4667771500655604,0.030272448464947033,13,16,9,1,15,1,12
5121,1,0,0.25749269235665073,0.4359801595330707,16,23,13,8,15,9,7
5122,0,0,2.153974531033764,0.10396040186244837,19,29,19,4,25,4,15
5123,1,1,0.9325959009478051,0.717601640617443,5,5,2,1,4,4,1
5124,1,1,1.5988373186431049,0.8318558216423455,13,17,10,3,14,8,5
5125,1,1,4.270915146283192,0.9862234508971655,8,10,6,0,10,8,0
5126,1,1,5.358226030062804,0.9953128203389499,25,40,24,6,34,17,8
5127,1,1,0.31774253585995593,0.5787739925366098,13,16,10,4,12,6,7
5128,0,0,5.938393584684505,0.002629329582132134,19,24,14,2,22,2,17
5129,0,0,1.720053692908163,0.1518642478003812,17,21,11,3,18,5,12
5130,1,1,3.1051819141473014,0.9571059885886178,10,14,9,0,14,10,0
5131,1,1,2.124590006428579,0.8932703242039172,16,22,17,2,20,12,4
5132,0,0,4.94454595404621,0.007071781440375902,20,23,12,5,18,6,14
5133,1,0,0.4307602918978821,0.393944795504778,12,14,9,1,13,4,8
5134,1,1,2.488467826592244,0.9233294070298603,13,18,11,2,16,11,2
5135,0,0,1.250110011194179,0.22268109594191687,10,11,6,2,9,3,7
5136,1,1,1.4197093093177902,0.8052928412354293,26,42,28,9,33,13,13
5137,1,1,2.7900897809583567,0.9421379392409224,8,11,5,1,10,7,1
5138,1,1,4.474706256448135,0.9887347826048912,9,14,7,0,14,9,0
5139,0,1,1.2524879940906124,0.7777302477073178,17,23,12,6,17,9,8
5140,0,0,5.319156534022068,0.004873019733210748,16,22,14,2,20,3,13
5141,0,0,1.0959255436420743,0.2505041029881876,19,27,18,6,21,7,12
5142,0,0,1.9138230161691667,0.12855196505123478,14,17,8,3,14,4,10
5143,1,1,1.0882745719063154,0.7480566730228515,7,7,3,2,5,5,2
5144,1,1,0.5110344097959303,0.6250489329485248,14,17,10,5,12,6,8
5145,0,0,5.307555906514514,0.004929598690529113,15,17,11,2,15,3,12
5146,0,0,2.6615028512043337,0.06528356707106153,18,24,14,6,18,6,12
5147,1,1,1.5189795524141678,0.8203881653452969,4,4,2,0,4,4,0
5148,1,0,1.8138723327558783,0.14017077024312363,21,28,16,5,23,7,14
5149,1,1,3.8084315349919167,0.9782984592242193,12,15,8,2,13,10,2
5150,1,0,0.654194118369929,0.3420450257018103,7,6,2,2,4,2,5
5151,0,0,0.3134651536956774,0.42226916028189376,21,30,19,7,23,8,13
5152,0,0,2.7513759880275335,0.06000898656077902,18,20,9,4,16,6,12
5153,1,1,2.2925202322839175,0.9082556704239264,4,4,2,0,4,4,0
5154,1,1,1.4255184397960101,0.8062020762183981,9,10,6,2,8,4,5
5155,0,0,2.1623311841342496,0.10318452990633709,22,28,18,5,23,7,15
5156,0,0,1.9723560463269978,0.12213604930578603,14,17,9,5,12,5,9
5157,1,0,1.0688831068862905,0.2556155443789031,17,22,14,5,17,10,7
5158,1,1,4.275955871967147,0.9862917704158072,17,26,21,1,25,16,1
5159,0,0,3.991525318107647,0.018136508836975485,18,23,15,1,22,1,17
5160,0,0,6.290865697010851,0.001849727150437519,13,17,10,0,17,0,13
5161,0,0,6.726310393888369,0.0011975126989568485,41,58,32,7,51,10,31
5162,0,0,4.782909172409039,0.008302107058767882,51,85,54,23,62,22,29
5163,1,0,2.8392395540882234,0.05524021106937527,18,24,12,5,19,5,13
5164,0,1,0.2727397324498715,0.5677653812546984,8,7,3,2,5,4,4
5165,0,0,2.105489373056312,0.10856442695743773,26,33,18,6,27,10,16
5166,0,0,5.571624017719472,0.0037898793398389863,24,29,15,3,26,5,19
5167,0,0,3.0750505534527224,0.044148207196821554,28,37,21,8,29,9,19
5168,1,1,6.448797628470013,0.9984200764219621,19,30,22,0,30,19,0
5169,0,0,4.240930687484353,0.014189936486226906,42,63,38,12,51,15,27
5170,1,1,2.0664680035444367,0.8876010724771829,20,30,22,2,28,14,6
5171,1,1,7.1536413259724965,0.9992185997314719,27,42,27,7,35,22,5
5172,1,1,2.940312460040483,0.9498036259666323,7,9,4,0,9,7,0
5173,1,1,2.7795671739663805,0.9415616334817013,17,22,13,5,17,10,7
5174,1,1,4.24302588843743,0.9858393425915101,26,39,23,10,29,16,10
5175,0,0,1.6912472142006232,0.15561188973240958,11,12,6,2,10,2,9
5176,0,1,1.633697346481438,0.8366755088346665,5,5,2,1,4,4,1
5177,1,0,1.0625195553568483,0.25682825888761196,16,17,8,4,13,5,11
5178,0,0,0.1849442977373883,0.4538952660810921,36,55,36,9,46,15,21
5179,1,1,0.62327633185989,0.6509633318810515,9,10,8,1,9,5,4
5180,1,1,1.8082518687202302,0.859150464035239,8,10,4,1,9,7,1
5181,1,1,0.3628472709597874,0.5897295029083277,11,12,6,3,9,5,6
5182,1,1,1.4200157899915282,0.8053408917690081,10,14,7,4,10,8,2
5183,1,1,3.082837928921098,0.95617924928513,7,9,5,0,9,7,0
5184,0,0,0.9853036927664476,0.27184068361223035,12,15,8,2,13,3,9
5185,1,1,0.24012116140542705,0.5597435073748546,3,2,0,1,1,2,1
5186,1,1,2.24642090079031,0.9043413619194489,10,13,8,1,12,9,1
5187,0,0,1.960760205927925,0.12338479939483371,16,17,11,1,16,2,14
5188,0,0,0.4811689909756067,0.38197612305680484,10,14,9,4,10,4,6
5189,0,0,3.7492157738259504,0.022994981912874635,17,21,10,2,19,3,14
5190,0,0,2.366901152590018,0.08573172104191062,9,9,4,2,7,2,7
5191,1,1,4.349659191730357,0.9872533624619506,9,11,6,1,10,8,1
5192,0,0,0.48018224490566275,0.3822090916737054,11,14,6,5,9,5,6
5193,0,1,0.8749841449224154,0.7057817354794171,16,20,11,6,14,10,6
5194,0,0,1.9560755105496348,0.12389239532508123,26,37,20,8,29,12,14
5195,1,0,0.06753253236975865,0.4831232804777047,9,10,4,2,8,3,6
5196,0,0,2.7731154322372844,0.05879437577184332,32,50,31,11,39,11,21
5197,1,1,3.824656138885622,0.9786402571196112,9,13,8,0,13,9,0
5198,0,0,1.8355563511025776,0.13757768319634622,14,17,11,2,15,3,11
5199,1,1,4.298392999625701,0.9865918407742853,12,16,7,1,15,11,1
5200,1,1,4.0264607528687995,0.9824752460014804,7,10,5,0,10,7,0
5201,0,0,0.7669691457414812,0.31713510528502864,7,7,3,1,6,1,6
5202,0,0,7.814843849779009,0.00040353494626232944,23,31,19,2,29,3,20
5203,0,0,3.7904605515975285,0.02208637271008873,17,22,13,5,17,4,13
5204,0,0,0.9536349818260696,0.27815438566057005,14,18,11,2,16,5,9
5205,0,0,1.153514159028624,0.23984779304501969,17,20,12,3,17,4,13
5206,0,1,0.4681651624623379,0.6149493831139659,9,10,7,4,6,6,3
5207,0,0,2.7237542685134475,0.06158613730189377,19,26,16,5,21,5,14
5208,0,0,5.435870699335807,0.004338534448675158,18,23,13,4,19,4,14
5209,1,0,0.6496684094450864,0.343064264390082,15,20,9,8,12,8,7
5210,1,0,1.854452800026741,0.1353509344534065,20,23,11,5,18,6,14
5211,0,0,4.225729014027925,0.014404164318811197,21,27,17,3,24,2,19
5212,1,1,0.7063784203802308,0.6696004298283058,4,3,1,1,2,3,1
5213,0,0,0.5767787276845564,0.359674144714495,15,18,9,6,12,5,10
5214,1,0,0.42090020502983094,0.3963013590576855,24,34,18,11,23,10,14
5215,0,0,1.8746485849008856,0.13300475822571312,25,38,24,10,28,11,14
5216,0,0,5.022660836030988,0.0065438721738716454,25,35,22,5,30,5,20
5217,1,1,0.6445690790540264,0.6557855755855528,9,10,5,3,7,6,3
5218,0,1,2.7491633805480973,0.9398660833079366,22,28,16,7,21,12,10
5219,0,1,0.04986677336776579,0.5124641105787712,6,5,2,2,3,3,3
5220,1,1,1.8436313898828594,0.8633776197181253,8,11,7,0,11,8,0
5221,0,0,2.1812660751728217,0.10144546147812328,15,19,12,1,18,2,13
5222,1,0,0.47259247816232675,0.3840028226322393,16,20,9,6,14,7,9
5223,1,0,3.4301076401163346,0.03136766157483173,17,20,10,4,16,4,13
5224,1,1,3.047306806484616,0.9546661111502288,23,35,21,8,27,15,8
5225,1,1,0.7266514667707007,0.6740700303335536,10,11,4,4,7,5,5
5226,1,0,1.8392407070662773,0.1371411175612186,14,18,11,3,15,5,9
5227,1,1,3.130396234167676,0.9581292917728917,21,30,20,6,24,14,7
5228,1,1,1.898463499783717,0.8697175252873175,6,6,2,1,5,5,1
5229,0,0,2.3651121033796203,0.08587205389662567,6,5,1,0,5,0,6
5230,0,1,6.479409126849442,0.9984676345130465,22,33,21,4,29,16,6
5231,1,1,2.5520856657113056,0.927713506624175,7,9,5,0,9,7,0
5232,0,0,0.7845564298573144,0.3133387029228816,25,34,19,9,25,9,16
5233,1,1,3.3145548255154367,0.9649247655699883,12,16,9,2,14,10,2
5234,1,1,4.5945810850366495,0.9899946648171984,12,18,11,0,18,12,0
5235,0,1,0.8779957351765977,0.7064067160809062,9,10,5,2,8,5,4
5236,0,0,0.9885853697860837,0.27119158413961153,15,20,13,4,16,4,11
5237,1,0,0.5647446518897681,0.362450351170704,14,19,12,7,12,6,8
5238,0,0,1.7926467211457202,0.14274853418775513,6,6,2,0,6,0,6
5239,1,1,3.824046494966799,0.9786275097060523,21,33,21,5,28,17,4
5240,1,1,0.0059609307476060636,0.5014902282742519,30,44,25,14,30,12,18
5241,0,0,0.6140858347676769,0.3511277281057512,7,7,4,1,6,1,6
5242,0,0,4.711381175567288,0.008912207310268427,8,9,6,0,9,0,8
5243,0,0,1.7981707085412786,0.1420738892661556,16,20,10,5,15,5,11
5244,1,1,0.8018462367771597,0.6903692704965958,4,4,2,0,4,4,0
5245,1,1,3.2703488844513178,0.9633974763499735,30,45,28,9,36,18,12
5246,1,1,1.6556178042246845,0.8396488679645672,7,6,2,2,4,5,2
5247,0,1,0.17736580073951225,0.5442255712808504,14,18,9,5,13,6,8
5248,0,0,8.015108024510255,0.0003303233936966521,20,26,16,4,22,4,16
5249,0,0,1.2370201181089078,0.22495510319324485,28,42,24,9,33,11,17
5250,0,0,1.088368986693041,0.2519255332385423,12,14,7,2,12,3,9
5251,0,0,2.5953462141060664,0.06943853131033206,12,14,7,0,14,0,12
5252,1,1,0.32276839888840314,0.5799987836134499,19,21,10,6,15,8,11
5253,0,0,3.9314604515685523,0.019237658102488786,12,13,8,4,9,4,8
5254,0,0,0.7827123416977683,0.3137356089425014,6,5,2,1,4,1,5
5255,0,1,1.2749171429023152,0.7815833196281187,16,23,14,6,17,11,5
5256,1,1,5.241909367285224,0.9947376920251005,13,21,13,0,21,13,0
5257,1,1,2.725394412230745,0.9385085838597937,41,68,44,15,53,21,20
5258,0,0,0.08008489223240689,0.4799894707429909,18,23,13,5,18,6,12
5259,0,0,2.9248784006728066,0.050937348375997726,15,17,11,2,15,3,12
5260,1,1,2.083318362190812,0.889271207858858,19,26,14,7,19,10,9
5261,0,0,0.4510907762883205,0.38910145553496267,12,13,8,2,11,4,8
5262,0,0,5.139375736272454,0.005827192398008441,25,34,20,6,28,6,19
5263,0,0,3.020079257045296,0.046526958371424176,7,8,5,0,8,0,7
5264,1,1,6.122376800760628,0.9978115628849225,15,24,16,0,24,15,0
5265,0,0,1.24064816651634,0.2243231831189476,14,20,12,4,16,4,10
5266,1,1,5.411947276484304,0.9955568881826334,18,29,19,1,28,17,1
5267,0,0,0.5691929529685649,0.36142306758878207,14,15,8,1,14,4,10
5268,1,1,3.3294226601627877,0.9654245032692079,8,11,7,0,11,8,0
5269,1,1,6.743240309645423,0.998822566767683,18,31,22,2,29,17,1
5270,1,1,4.335903866726111,0.987079098010778,10,15,9,0,15,10,0
5271,0,0,7.2363328102726046,0.0007194291566930966,24,34,19,5,29,5,19
5272,0,0,1.4002844197695439,0.197770982198473,11,14,7,1,13,2,9
5273,1,1,1.9970962105503516,0.8804918614321919,14,19,13,3,16,11,3
5274,1,0,0.5533641203818176,0.3650842601244866,16,22,14,6,16,6,10
5275,1,1,4.106288772105186,0.9837980457795666,7,9,4,0,9,7,0
5276,1,1,3.654447192840613,0.9747768707376621,21,30,17,6,24,15,6
5277,0,0,0.5337510255985292,0.36964244660076084,18,25,15,6,19,7,11
5278,1,1,2.1032595068671993,0.8912195821861338,9,10,6,2,8,6,3
5279,0,0,3.459989048790359,0.03047235680324345,27,37,18,7,30,7,20
5280,0,0,0.6799801207972651,0.33626573944217053,19,28,16,9,19,8,11
5281,1,1,1.2326949331942076,0.7742899025194716,22,28,18,5,23,12,10
5282,0,1,2.9649447915814218,0.9509650868224302,20,26,15,6,20,12,8
5283,0,1,0.05733525957113805,0.5143298895158281,14,18,10,3,15,7,7
5284,0,0,1.1083619355045613,0.24817640052613332,29,42,25,9,33,10,19
5285,0,1,1.7255212611273716,0.8488386435032033,12,14,8,3,11,7,5
5286,1,1,0.7528357601786202,0.6797962829088389,21,30,18,9,21,11,10
5287,1,1,3.3221086810273603,0.9651795295893024,22,31,20,6,25,16,6
5288,1,0,4.626844273727265,0.009690761248192459,23,30,17,2,28,5,18
5289,1,1,6.340081845603681,0.9982389489296947,17,25,17,2,23,15,2
5290,1,1,1.9570500552849162,0.8762133459859305,18,26,15,6,20,10,8
5291,0,0,5.995464657416778,0.0024838349008573513,18,25,18,2,23,1,17
5292,1,1,0.6837470766321003,0.6645744923123353,3,2,1,0,2,3,0
5293,1,1,5.885273276309118,0.9972276210631893,25,39,28,8,31,20,5
5294,0,1,0.510601026357431,0.6249473585046972,8,9,4,5,4,5,3
5295,0,0,0.6069664396481904,0.3527515042139385,19,25,15,5,20,6,13
5296,1,1,1.9651842664501127,0.8770929146428268,22,32,18,6,26,13,9
5297,0,1,0.49352288133340316,0.6209359813004076,39,62,37,17,45,17,22
5298,1,1,1.5607759448456757,0.8264646678200841,9,11,8,1,10,7,2
5299,1,1,0.9174880939109349,0.7145300111747659,19,27,17,7,20,10,9
5300,0,0,2.262838381384392,0.09424779090293733,22,30,18,5,25,6,16
5301,0,0,0.33526049319613627,0.4169612173453189,41,64,40,11,53,19,22
5302,1,0,0.8054440585824678,0.3088621879806559,13,16,9,3,13,4,9
5303,1,0,0.19708069013570756,0.45088868488301037,8,9,5,2,7,5,3
5304,0,0,2.398261993316522,0.08330532424052839,35,55,32,13,42,16,19
5305,1,1,3.729555152702328,0.9765591513183912,39,63,41,16,47,24,15
5306,0,0,0.9082302708780792,0.2873621150319631,14,15,7,2,13,3,11
5307,0,0,1.1116726046953413,0.24755919486080347,15,19,11,7,12,7,8
5308,1,0,2.222956036281998,0.0977078869277147,23,32,19,12,20,9,14
5309,0,0,0.2597033974641521,0.4354366210672628,1,0,0,0,0,0,1
5310,1,1,0.21298856488676,0.5530467576808358,10,11,5,4,7,5,5
5311,1,1,3.0092946737636312,0.952992267206477,16,22,12,4,18,11,5
5312,0,0,4.091542338043688,0.01643868892761602,22,29,19,6,23,6,16
5313,1,1,4.304269893907391,0.9866693606651763,11,16,11,0,16,11,0
5314,0,1,0.6237043254341925,0.6510605700478951,9,10,4,3,7,5,4
5315,1,1,2.30662828413606,0.9094245048863554,29,44,25,12,32,14,15
5316,0,0,5.673364791924561,0.0034245158161243516,19,22,12,2,20,3,16
5317,0,0,6.551691267593474,0.0014256635160476705,32,49,27,5,44,5,27
5318,1,0,1.1009619120578313,0.24955970444917108,15,16,9,2,14,5,10
5319,0,0,1.1153786991328145,0.24686949321334872,4,3,1,0,3,0,4
5320,0,0,4.622746447461992,0.009730166591960132,17,21,13,2,19,3,14
5321,0,0,3.4172970686242583,0.03175924000349162,26,39,22,9,30,7,19
5322,0,0,2.1606504475616,0.10334016480069508,22,28,15,6,22,7,15
5323,1,1,3.245715407509817,0.9625188462861065,15,20,12,3,17,12,3
5324,0,0,2.436876755832092,0.08040353870484063,8,8,2,0,8,0,8
5325,1,1,1.0448214986013071,0.7397792455656685,15,20,14,2,18,12,3
5326,1,0,2.274832235150735,0.0932289044973662,11,11,5,2,9,3,8
5327,1,1,0.574737386891663,0.6398555822866918,2,1,0,0,1,2,0
5328,0,0,5.086612880738993,0.006140968686560666,21,28,18,3,25,4,17
5329,0,0,5.8628793979688965,0.002834985632308107,45,71,47,17,54,17,28
5330,0,0,5.470679787238355,0.004190734227096371,31,47,28,10,37,8,23
5331,0,0,4.085388759813332,0.016538479426397523,10,10,6,1,9,3,7
5332,0,0,1.0003786584234113,0.26886697911934154,18,25,17,4,21,7,11
5333,0,0,2.6848314284679944,0.06387437440247468,10,12,8,0,12,0,10
5334,1,1,3.356014177924574,0.9663012266850508,25,37,21,11,26,14,11
5335,0,0,7.291392973894622,0.0006809142890845665,19,26,13,0,26,0,19
5336,0,0,3.243911845211648,0.03754627390319387,23,34,21,3,31,4,19
5337,0,1,1.1547912468080979,0.760384969293972,23,33,20,11,22,10,13
5338,1,1,3.1373190295186926,0.9584061382414942,18,26,18,2,24,15,3
5339,1,1,3.80208923872555,0.9781633993182753,6,7,3,0,7,6,0
5340,0,0,8.597715507277119,0.0001844928189138617,22,30,16,3,27,1,21
5341,1,1,3.121346621946956,0.9577647345568264,26,36,25,7,29,16,10
5342,0,0,1.0392465458348683,0.26129539956587855,18,27,16,7,20,7,11
5343,1,0,0.3372675570799608,0.4164733724318148,11,12,6,2,10,3,8
5344,0,0,2.6924904844095012,0.06341793234102377,14,14,6,1,13,1,13
5345,1,1,3.6823546836597076,0.975454014083288,16,21,14,2,19,14,2
5346,1,1,1.325921469431528,0.790165197740734,25,37,26,7,30,15,10
5347,1,1,3.9289949170912877,0.9807157680696142,19,31,19,5,26,14,5
5348,0,0,0.15150057446127985,0.46219713435688425,26,37,22,9,28,10,16
5349,1,0,0.42093163723831983,0.39629383903344173,15,20,10,6,14,6,9
5350,0,0,3.838239620571135,0.021077638977704316,8,8,3,0,8,0,8
5351,0,0,0.8764739400349102,0.29390899765898093,33,48,28,9,39,15,18
5352,1,1,4.096092537285078,0.9836347191332504,37,56,31,17,39,19,18
5353,1,1,3.3283970894165114,0.9653902533397571,14,19,13,3,16,9,5
5354,0,0,2.201902682615942,0.09957975766638194,24,35,21,6,29,6,18
5355,1,1,4.5605807036284185,0.9896522109789377,11,15,10,1,14,10,1
5356,0,0,2.4454648253812667,0.07977083093118498,16,20,10,3,17,4,12
5357,0,0,0.6034084473588215,0.35356428243664473,5,4,2,1,3,2,3
5358,1,1,2.8280831687004717,0.9441746540255428,6,8,4,0,8,6,0
5359,1,1,2.753814045382554,0.9401283917174947,5,5,2,0,5,5,0
5360,0,0,5.651365943147906,0.0035004193502722325,29,41,24,6,35,8,21
5361,0,0,0.8632548531370992,0.29665976242740477,4,3,1,0,3,0,4
5362,0,0,1.021533506665531,0.2647287996789446,4,4,2,0,4,0,4
5363,1,1,2.035553524147036,0.8844797238808619,19,24,13,5,19,13,6
5364,1,1,3.255464180930467,0.9628689646710445,13,16,8,2,14,9,4
5365,0,0,3.2042048759020676,0.03900779214130956,7,6,2,1,5,1,6
5366,1,1,1.8105065085406813,0.8594230792616948,22,29,13,8,21,11,11
5367,1,1,6.397920171697438,0.9983377510489384,14,20,13,1,19,13,1
5368,0,0,0.6140328680507843,0.351139795981255,5,5,3,0,5,0,5
5369,0,1,3.241215846153802,0.9623561804303693,19,28,21,3,25,16,3
5370,0,0,6.346888577078401,0.0017491256678785483,24,34,21,7,27,5,19
5371,1,1,1.1887916370859886,0.7665248798281852,32,45,28,11,34,16,16
5372,1,1,2.6502249303775924,0.9340248526178594,14,18,12,3,15,10,4
5373,1,1,2.3555030101266485,0.9133706432967557,24,37,23,9,28,13,11
5374,0,0,0.5754964389013804,0.3599695200274715,2,1,0,0,1,0,2
5375,0,0,2.367700930457925,0.08566905378500211,20,27,15,6,21,5,15
5376,1,1,2.6232050304569006,0.9323401664598328,5,6,3,0,6,5,0
5377,0,0,3.9593921434113257,0.01871767138530467,29,44,25,9,35,10,19
5378,0,0,4.118735068302485,0.01600475706043225,18,22,14,2,20,5,13
5379,0,0,3.5703380813749783,0.027375807630889426,18,25,17,2,23,3,15
5380,0,0,4.43608482135326,0.011703615552724034,20,24,14,1,23,2,18
5381,1,0,0.8369975785258927,0.3021675052102283,2,1,0,0,1,0,2
5382,0,0,1.9147132639665876,0.12845226680824517,7,7,3,1,6,1,6
5383,0,1,0.38964683403557077,0.5961976788905383,20,25,15,9,16,10,10
5384,1,1,3.9074298228140707,0.9803036652843943,23,35,19,8,27,14,9
5385,0,0,4.539892531588188,0.01056181105031151,12,16,8,0,16,0,12
5386,1,1,3.9834767435652054,0.9817196083149249,9,13,8,0,13,9,0
5387,0,1,0.4043308360761,0.5997277438602419,12,13,7,3,10,5,7
5388,1,1,1.4585194723848791,0.8113061274982218,11,13,5,6,7,7,4
5389,1,1,2.82701163944956,0.9441181480339516,9,11,5,1,10,7,2
5390,0,0,7.05275516826329,0.000864274771857243,16,22,13,0,22,0,16
5391,0,1,0.686313439585988,0.6651463318822914,8,8,4,2,6,6,2
5392,1,1,4.748319980283051,0.991408216044686,31,46,31,8,38,17,14
5393,1,1,1.9678572017557665,0.8773807692515789,11,13,7,3,10,8,3
5394,0,0,4.421857207926106,0.011869329717953625,19,27,15,7,20,5,14
5395,0,0,8.577931668153397,0.0001881784460308067,35,55,34,7,48,6,29
5396,0,0,3.9717251895882892,0.018492485860461372,22,31,18,4,27,5,17
5397,1,0,0.36504661357307205,0.4097384743965633,11,12,7,1,11,4,7
5398,1,1,3.7450249417340125,0.9769106775086122,18,24,14,4,20,13,5
5399,1,1,1.3739373843162466,0.7980155524308264,11,15,8,2,13,9,2
5400,1,1,9.48364055431673,0.999923919353175,20,32,22,0,32,20,0
5401,0,0,1.2546813952402351,0.22189081899620977,23,32,19,5,27,5,18
5402,1,1,3.1641163947884516,0.9594613578402721,14,18,8,3,15,10,4
5403,0,0,2.276808787693309,0.09306194641920795,10,10,3,1,9,1,9
5404,1,1,0.07125458599131651,0.517806113344929,34,52,34,13,39,15,19
5405,1,1,3.0215393593417623,0.9535377721087727,12,17,9,2,15,10,2
5406,1,0,0.9098361776327542,0.2870333615409202,22,30,16,6,24,7,15
5407,0,0,2.92470107547625,0.050945921443620756,28,39,23,5,34,8,20
5408,1,1,2.000700303889337,0.8808705857884938,17,23,14,4,19,8,9
5409,0,1,1.8896733791835416,0.8687182849798053,18,21,10,6,15,11,7
5410,0,0,2.8926214860688413,0.052519516968300595,20,28,18,4,24,4,16
5411,0,0,2.08342531688405,0.11071826097271309,17,24,14,8,16,7,10
5412,0,1,0.8670978625302581,0.704141464946274,4,3,1,1,2,3,1
5413,1,1,2.1711827424028427,0.8976316987342158,21,32,21,5,27,15,6
5414,0,0,1.967383912757667,0.12267015805121961,24,37,22,8,29,8,16
5415,0,0,0.6297714196668989,0.347562369510223,14,17,9,5,12,5,9
5416,1,1,3.6278168618245985,0.9741137681116738,30,47,29,10,37,17,13
5417,0,0,4.409443269631119,0.012015811701389767,11,14,7,0,14,0,11
5418,0,0,2.025801748675144,0.11652040904487548,19,25,14,5,20,6,13
5419,1,1,2.169643607468494,0.8974901825335033,12,16,10,2,14,10,2
5420,0,0,3.5152398184828337,0.028881708385965488,35,55,30,14,41,12,23
5421,1,1,1.6361842796788575,0.83701506278571,6,6,2,1,5,5,1
5422,1,1,0.9224838071424086,0.7155479280950993,13,14,6,5,9,7,6
5423,0,0,4.2861729736242875,0.013570775297665594,20,28,17,2,26,1,19
5424,1,1,1.0262314392362994,0.7361846296912816,16,19,10,5,14,9,7
5425,1,0,1.896327740713041,0.13052466648286132,13,15,8,2,13,3,10
5426,0,0,2.5436579035879974,0.07285371011897945,21,30,19,4,26,5,16
5427,0,0,2.9991327515006345,0.04746506794919003,20,24,14,2,22,3,17
5428,1,1,2.005006036455942,0.8813216785607683,6,6,3,0,6,6,0
5429,0,0,0.0819206276441875,0.4795312889171093,13,13,4,3,10,4,9
5430,0,0,3.6525142007035987,0.025270699233245875,26,33,19,4,29,6,20
5431,1,1,0.9185532163467132,0.714747221866632,3,2,1,0,2,3,0
5432,0,0,3.6932607772599337,0.024286205702551356,15,16,9,1,15,2,13
5433,0,0,6.443905104076856,0.0015876600303237343,14,14,5,1,13,1,13
5434,0,0,2.271599986069249,0.09350250952334271,13,15,10,2,13,4,9
5435,1,1,1.134973249442378,0.7567555265019468,24,36,25,8,28,17,7
5436,1,1,3.7290937370208557,0.9765485865559419,24,36,25,6,30,18,6
5437,1,1,3.1420778763301085,0.9585954307222663,23,33,19,7,26,14,9
5438,0,1,2.760077451664716,0.9404799697139408,9,10,4,2,8,7,2
5439,1,1,1.9671693226145617,0.8773067454174798,20,26,17,4,22,11,9
5440,1,1,3.498416674741803,0.9706426852677619,17,23,14,3,20,14,3
5441,0,0,0.5430997780873246,0.3674667899633307,24,36,20,10,26,9,15
5442,1,0,0.37817436815473054,0.4065672926199202,5,4,3,1,3,2,3
5443,1,1,3.278999214029204,0.963701291260414,12,16,9,2,14,10,2
5444,0,1,0.9017393601148274,0.7113068104707205,5,5,2,1,4,4,1
5445,0,0,3.8120293465628614,0.021625288434749312,22,28,17,1,27,2,20
5446,1,1,3.9759936230728563,0.9815848293784529,14,20,12,2,18,12,2
5447,0,0,5.908414904094092,0.002709130049753372,14,17,9,3,14,1,13
5448,0,0,2.8133816994362713,0.05660532312373312,12,12,6,2,10,3,9
5449,0,0,8.472673725103506,0.0002090613500197458,27,37,22,5,32,7,20
5450,1,1,1.5689892910303187,0.8276394759738055,11,14,6,3,11,8,3
5451,1,1,2.677144753929459,0.9356644614925638,19,28,16,6,22,11,8
5452,1,1,2.1842023665579573,0.8988218809928825,11,15,8,2,13,9,2
5453,1,1,2.988804889621408,0.9520657989364172,12,16,9,2,14,10,2
5454,1,0,1.322067029651235,0.21047459917397482,14,17,8,3,14,4,10
5455,1,1,2.4831188982640953,0.9229498860889085,10,11,4,3,8,7,3
5456,0,0,1.9389430427665342,0.12576402028879896,6,5,1,0,5,0,6
5457,0,0,3.8217433004154127,0.021420716378018456,11,14,7,1,13,1,10
5458,1,1,3.18272951173191,0.9601791604979375,10,13,9,1,12,9,1
5459,1,1,4.206756138187361,0.985323987326496,16,22,14,4,18,12,4
5460,0,0,3.601778939524665,0.02655097632150627,38,61,40,9,52,12,26
5461,1,1,0.7452345754571894,0.6781394516164849,30,44,29,11,33,12,18
5462,1,1,2.3514111790938426,0.9130463302432705,28,40,25,10,30,14,14
5463,1,1,2.679600757775982,0.9358121461757039,16,23,14,4,19,12,4
5464,0,1,2.25294750141654,0.9049044774513941,15,19,9,4,15,11,4
5465,1,0,1.2099307073490073,0.22971331171924736,8,8,3,1,7,1,7
5466,1,1,6.92135297123118,0.9990144778732393,20,31,19,3,28,17,3
5467,1,1,1.375387206058358,0.7982491434887871,20,27,15,6,21,10,10
5468,1,1,0.41619700146850525,0.602572868537588,12,13,7,3,10,7,5
5469,1,1,3.197884436489007,0.9607545871439371,20,28,18,6,22,14,6
5470,0,0,4.086282487229576,0.016523949266596838,23,29,15,5,24,5,18
5471,1,1,0.6737580168359552,0.6623441306406546,24,35,25,9,26,14,10
5472,0,0,2.973172395194757,0.04865267637883641,28,43,29,9,34,7,21
5473,0,0,0.29654624212625513,0.4264019992981861,5,4,1,1,3,1,4
5474,1,1,4.688902304490301,0.9908870340285204,18,24,15,4,20,14,4
5475,0,0,2.06936913717399,0.11210982003990078,6,6,3,0,6,0,6
5476,0,0,3.262294700946841,0.03688759898453875,19,24,14,3,21,4,15
5477,1,1,0.526469918908967,0.6286594009461903,8,8,4,3,5,5,3
5478,0,0,3.488578973301082,0.02963894628232322,37,59,34,12,47,13,24
5479,1,0,0.6193018306165281,0.34994025580102206,17,23,14,6,17,7,10
5480,1,0,3.691132818926204,0.024336681702202267,13,14,7,2,12,3,10
5481,1,1,1.2135344576219806,0.7709237330551171,13,17,11,4,13,9,4
5482,1,1,2.178401001754355,0.8982930764362068,5,5,2,1,4,4,1
5483,1,1,1.5886347911969512,0.830423941049834,4,4,2,0,4,4,0
5484,1,1,3.5376899884053934,0.9717413479567981,6,7,3,0,7,6,0
5485,0,0,0.21811073256353875,0.4456874606658139,8,9,4,1,8,2,6
5486,1,1,2.3264602176177824,0.9110448824239157,14,19,12,2,17,11,3
5487,0,0,3.9942299986810093,0.018088407751256863,15,17,10,1,16,2,13
5488,1,1,2.6256238305124873,0.9324925896876356,20,29,17,7,22,12,8
5489,0,0,4.26729447793925,0.013825828940493112,15,18,10,3,15,3,12
5490,0,0,7.042448305806331,0.0008732209789026335,44,70,42,17,53,14,30
5491,1,0,0.144762672531783,0.46387240136831265,7,6,2,1,5,2,5
5492,0,0,2.9729784189677906,0.04866165546971579,15,18,11,2,16,3,12
5493,1,1,1.2694252908639958,0.7806443513121557,20,29,19,7,22,11,9
5494,0,0,6.00758261738718,0.002453990940816886,29,43,24,7,36,9,20
5495,1,1,2.217159308759664,0.9017798743590303,12,14,8,2,12,6,6
5496,1,0,1.0463806565744518,0.2599207195345282,25,39,22,8,31,8,17
5497,0,0,3.248453953219413,0.03738248211319806,18,26,16,5,21,5,13
5498,0,0,3.7707231339792218,0.02251671798662913,21,32,20,5,27,7,14
5499,0,0,0.8564321480362751,0.29808531077082034,8,7,3,1,6,2,6
5500,1,1,2.489245787941371,0.9233844625010946,26,40,27,6,34,15,11
5501,0,0,5.253694615237357,0.005200975044410194,18,22,16,2,20,3,15
5502,1,1,1.6751718498170682,0.8422641454751568,11,12,5,3,9,7,4
5503,0,1,1.857602372417944,0.8650172401901771,16,24,11,6,18,9,7
5504,0,0,4.313243739151458,0.013213120972142445,20,28,17,2,26,3,17
5505,1,1,1.2689901932864087,0.7805698366500418,6,6,3,1,5,4,2
5506,0,1,1.0882745719063154,0.7480566730228515,7,7,3,2,5,5,2
5507,1,1,0.78448335239344,0.686645573693816,14,17,8,6,11,7,7
5508,1,1,1.4631773826278476,0.8120181661979582,18,26,15,6,20,10,8
5509,1,1,2.29855079223353,0.9087569450850898,8,10,7,0,10,8,0
5510,1,1,2.3027689744107276,0.90910610475908,14,18,8,4,14,9,5
5511,0,0,2.7796535920316807,0.05843361169054839,11,14,7,0,14,0,11
5512,0,0,2.6149287824690255,0.06818378745133802,14,16,9,1,15,2,12
5513,1,1,1.3855856693723392,0.7998865852123014,6,6,4,1,5,5,1
5514,0,0,4.760408626742038,0.008489422605487462,11,12,6,1,11,1,10
5515,0,0,1.5266266984252264,0.17848777628692247,14,15,9,1,14,2,12
5516,0,0,1.4009266391163415,0.1976691089816991,10,9,5,1,8,2,8
5517,0,0,4.775053487481873,0.00836703480064982,13,16,10,1,15,1,12
5518,1,1,2.734965631828489,0.9390586282968315,27,40,24,9,31,18,9
5519,0,0,0.8127394956481262,0.3073070332128154,27,39,23,5,34,7,20
5520,1,1,1.9049998594845428,0.8704563652355071,14,18,13,3,15,8,6
5521,1,1,3.7492992204635254,0.977006892742415,12,15,10,2,13,10,2
5522,0,0,5.479042449628067,0.004155979703506563,24,30,15,6,24,7,17
5523,1,1,2.539159473902487,0.926841854282036,8,11,7,0,11,8,0
5524,0,1,3.8321406490902854,0.9787961504126133,16,22,13,3,19,12,4
5525,1,1,3.5268273230497877,0.9714415246159881,19,27,17,4,23,15,4
5526,0,0,2.9735246660322887,0.04863637390626718,15,18,10,2,16,3,12
5527,0,0,1.288560472543502,0.21609656544218625,6,6,4,0,6,0,6
5528,0,0,9.491708187599189,7.546937147695498e-05,36,51,33,4,47,8,28
5529,0,0,5.017715289853083,0.006576102004723472,16,19,13,2,17,3,13
5530,0,0,0.7447095166885389,0.32197516175459384,18,25,14,6,19,6,12
5531,0,1,0.9937935751931948,0.7298365729584113,10,11,5,3,8,7,3
5532,0,0,4.802932892723655,0.008138860838404538,20,25,14,5,20,6,14
5533,1,1,3.367521123216667,0.9666739253520091,7,8,5,0,8,7,0
5534,1,1,1.9059009145194814,0.8705579361653453,11,16,13,0,16,11,0
5535,1,1,0.23873750704132346,0.5594025043085135,3,2,0,1,1,2,1
5536,0,1,3.165615517159109,0.9595196264499491,50,83,52,25,58,25,25
5537,0,0,5.582376905682024,0.003749497491820186,26,42,27,2,40,1,25
5538,0,1,2.947493767898302,0.9501449031602368,8,9,5,1,8,7,1
5539,1,1,2.3092993921150073,0.9096442877680532,19,28,17,6,22,13,6
5540,0,0,2.1335584846709135,0.10587764581445347,25,33,17,7,26,8,17
5541,1,1,1.3966570969592547,0.8016528844215071,19,26,15,7,19,10,9
5542,0,0,1.5700730222961257,0.17220598207740478,11,13,7,2,11,3,8
5543,0,0,3.0674879368734804,0.04446844560925789,11,16,9,1,15,1,10
5544,0,0,1.0298867400549039,0.26310606255853464,37,55,30,12,43,14,23
5545,0,0,4.026341284097152,0.0175268110870318,10,10,5,1,9,1,9
5546,0,0,0.6167822447538507,0.35051363290050064,16,24,15,7,17,6,10
5547,0,0,2.438383764756086,0.0802921826942864,28,43,28,8,35,10,18
5548,0,0,2.769005463252988,0.05902222442646665,15,21,14,4,17,4,11
5549,0,0,2.9478337615887376,0.049838993950795274,38,59,36,11,48,13,25
5550,0,0,1.8742305692047294,0.13305296888886353,10,12,6,3,9,2,8
5551,0,1,0.5420485471775431,0.6322888332097591,6,6,2,2,4,4,2
5552,1,0,2.1062418270495726,0.10849162726594519,19,25,15,5,20,4,15
5553,1,1,1.9705763259076023,0.8776730027840604,8,9,4,2,7,6,2
5554,1,1,5.380911208251131,0.9954174710883922,16,28,21,0,28,16,0
5555,0,0,4.01254656187464,0.01776593873101362,17,21,11,5,16,5,12
5556,1,1,3.535168651983233,0.9716720293928589,12,16,8,1,15,11,1
5557,1,1,0.24400225140421505,0.5606997042381869,8,9,3,3,6,5,3
5558,1,1,5.585711398188585,0.9962629377121389,21,36,27,4,32,19,2
5559,1,1,0.8127454111590555,0.6926942260171329,10,11,7,2,9,5,5
5560,0,0,3.9962216038154907,0.018053068349421997,17,19,10,3,16,3,14
5561,0,1,2.3965604942031864,0.91656464768937,16,22,11,3,19,12,4
5562,1,1,3.3052262395968723,0.9646076669447886,12,15,10,2,13,10,2
5563,0,0,1.4157832702725668,0.19532348501809726,5,5,3,0,5,0,5
5564,0,0,2.916343347876368,0.05135154116355589,15,17,10,3,14,6,9
5565,1,1,1.4428895730913547,0.808901719599287,15,22,13,6,16,9,6
5566,1,0,1.292675624901754,0.2154002778663877,23,34,21,8,26,7,16
5567,1,1,0.7893941929610704,0.6877012372649451,22,33,21,7,26,15,7
5568,1,1,1.9124572784464127,0.8712949586947324,10,13,7,3,10,7,3
5569,0,0,0.8340623998069256,0.3027867829112647,42,69,41,16,53,19,23
5570,1,1,2.232239722496102,0.9031075214443464,26,37,23,9,28,15,11
5571,0,0,3.922734077805175,0.019402996171230757,25,34,19,4,30,5,20
5572,0,0,1.753590015076451,0.14759496410214,6,5,1,1,4,1,5
5573,1,0,1.3207128154160968,0.21069972401416248,29,43,26,8,35,10,19
5574,1,1,1.0070195973500267,0.7324364747153408,20,29,16,6,23,12,8
5575,0,0,0.5083397603218025,0.3755828050413289,12,12,6,1,11,3,9
5576,0,0,0.6836160235124913,0.3354547220548675,28,40,27,8,32,15,13
5577,1,1,3.299046631948044,0.9643960901123199,7,8,5,1,7,6,1
5578,1,1,4.790927277676138,0.9917636478716708,19,28,20,3,25,16,3
5579,0,0,4.791891360941792,0.008228480732514476,27,35,20,6,29,6,21
5580,1,1,1.4359777655112138,0.8078310124948946,10,11,6,2,9,7,3
5581,1,0,3.3650013513979085,0.03340734574911575,53,85,55,19,66,19,34
5582,1,1,1.0773183943595597,0.7459861790115746,4,4,2,0,4,4,0
5583,1,1,5.169572979960495,0.9943451622814227,24,38,27,3,35,21,3
5584,0,0,0.7371528305271187,0.3236270548209801,16,21,11,5,16,7,9
5585,0,0,3.0178952105033106,0.04662394349817778,16,20,11,3,17,4,12
5586,0,0,6.39881984083715,0.0016607566319937206,45,70,43,15,55,16,29
5587,0,0,4.7003759218301155,0.009009941516519238,8,10,5,0,10,0,8
5588,1,1,2.6910733551946446,0.9364978436182242,18,24,15,6,18,11,7
5589,1,1,2.3694070673606613,0.9144644932541804,26,42,25,12,30,12,14
5590,0,0,2.2766992443652527,0.0930711924438613,7,7,4,0,7,0,7
5591,1,1,0.8764566689168864,0.7060874181136083,2,1,0,0,1,2,0
5592,1,1,6.785737824756293,0.9988715011275474,20,32,20,2,30,18,2
5593,1,1,1.2518331638434428,0.7776170292945142,18,23,13,5,18,12,6
5594,0,0,1.5660441021590308,0.17278106771383217,13,16,7,4,12,5,8
5595,0,0,6.294049915677263,0.0018438574251230522,18,23,14,2,21,3,15
5596,1,1,1.7682262555106156,0.8542369499117077,31,47,29,12,35,15,16
5597,1,1,4.746428541730374,0.9913920898529305,19,25,14,4,21,14,5
5598,1,1,3.103932830674058,0.9570546792827458,7,10,5,0,10,7,0
5599,0,0,6.192955925836314,0.0020396080606237543,10,11,5,0,11,0,10
5600,0,0,2.2125772533939796,0.09862671954075708,15,20,9,5,15,5,10
5601,1,1,1.3706358216086387,0.7974828606918152,16,22,14,4,18,11,5
5602,1,1,4.888889729049409,0.9925264958968263,24,36,22,4,32,17,7
5603,1,1,2.22763323507922,0.9027036846927077,15,21,13,5,16,7,8
5604,1,1,0.29372461383502735,0.572907734559231,20,28,18,3,25,15,5
5605,0,0,1.719878278307917,0.15188684284344944,16,20,12,4,16,7,9
5606,0,0,0.026941094354527628,0.49326513376626413,37,58,34,12,46,15,22
5607,0,0,1.5915352435859584,0.1691680085420817,14,17,10,1,16,2,12
5608,1,1,1.627989242154605,0.835893998884255,5,6,3,0,6,5,0
5609,1,1,3.180473365781312,0.9600928068226438,18,27,15,5,22,12,6
5610,0,0,1.081465233239312,0.25322883503436744,17,19,10,6,13,8,9
5611,1,1,3.28312601561883,0.9638453754465688,19,26,14,6,20,12,7
5612,1,1,3.319982480523554,0.9651080015126386,15,20,12,2,18,13,2
5613,0,1,1.4599835136680959,0.8115301532317525,20,27,15,7,20,12,8
5614,1,1,4.659741219271204,0.9906199068243666,12,18,9,1,17,11,1
5615,0,1,0.24261924182290984,0.5603590189325354,9,11,6,5,6,6,3
5616,0,0,0.8110709596783106,0.30766232764799184,22,32,19,4,28,7,15
5617,1,1,7.863989717239331,0.9996158102476997,38,60,40,11,49,22,16
5618,1,1,4.387442796559721,0.9877201875464402,19,29,19,4,25,16,3
5619,0,0,6.429247866222837,0.0016110643527639246,39,56,37,9,47,14,25
5620,0,0,2.7866199826466875,0.0580515039326337,22,32,19,7,25,6,16
5621,1,0,0.30435285902319065,0.42449373699406034,4,3,0,1,2,1,3
5622,0,0,0.2597033974641521,0.4354366210672628,1,0,0,0,0,0,1
5623,1,1,1.741161805830694,0.8508345762814975,5,5,2,0,5,5,0
5624,0,0,4.128525367360997,0.015851301876261936,23,34,21,8,26,7,16
5625,1,0,2.0425264971484602,0.11480971808003426,9,9,5,2,7,3,6
5626,0,0,2.3472543718659056,0.08728425715410915,8,8,4,0,8,0,8
5627,0,0,3.1997746910565485,0.03917420245127501,15,16,8,4,12,3,12
5628,1,1,6.15873925035325,0.9978895454645228,16,24,14,2,22,14,2
5629,0,0,2.483029432288588,0.07705647638099378,7,7,3,0,7,0,7
5630,1,1,3.626586899862433,0.9740827351322117,13,21,17,0,21,13,0
5631,1,1,4.799629858731605,0.9918344316584107,13,18,12,1,17,9,4
5632,1,1,1.4639198770825437,0.8121314777581953,9,11,4,2,9,7,2
5633,1,1,0.9823843053686114,0.7275810583768125,19,26,14,6,20,8,11
5634,1,1,5.394421251016727,0.9954786868895954,12,14,8,2,12,8,4
5635,1,1,0.3811055564093082,0.5941397219996859,21,29,18,8,21,12,9
5636,1,1,2.779759941855527,0.941572239308902,28,43,25,10,33,18,10
5637,1,0,1.400798071229894,0.19768950013095232,46,75,47,14,61,21,25
5638,0,0,2.3401806618884544,0.08784943696852165,8,8,4,0,8,0,8
5639,0,0,5.43783090073684,0.004330075165725034,29,41,25,9,32,10,19
5640,1,1,0.8916549314674342,0.7092315742258577,13,16,9,4,12,5,8
5641,1,1,4.02304783100021,0.9824163866880777,14,18,8,3,15,9,5
5642,1,1,2.308341077921206,0.9095654915050353,11,15,9,1,14,9,2
5643,1,0,0.2811234861272305,0.43017836001715837,14,18,13,4,14,6,8
5644,0,0,3.667734643984339,0.024898484545898603,11,11,5,1,10,2,9
5645,1,1,3.9792989209300615,0.9816444811079515,14,20,13,1,19,13,1
5646,0,1,0.4438536202766836,0.6091768872619877,25,34,19,7,27,15,10
5647,0,0,4.8495246198817785,0.007771234801735805,26,40,25,5,35,5,21
5648,0,1,2.4585291054631226,0.9211829347654943,27,42,29,9,33,17,10
5649,1,1,2.954284907709572,0.9504656148595372,22,33,20,5,28,14,8
5650,1,1,3.116300560357369,0.957560141903563,16,26,17,3,23,14,2
5651,1,1,1.175090880658931,0.7640639832663498,21,30,19,6,24,12,9
5652,1,1,2.5012674547146703,0.9242306255127912,6,8,4,0,8,6,0
5653,0,0,1.2654100502469567,0.22004398819808169,5,5,3,0,5,0,5
5654,1,1,1.270687167730469,0.7808603570023788,11,14,7,4,10,7,4
5655,1,1,0.8910660716647185,0.7091101233320465,18,24,13,7,17,7,11
5656,1,0,0.10153971837360487,0.4746368584931153,28,42,26,7,35,12,16
5657,0,0,4.023590482077685,0.017574241777494226,36,54,36,12,42,18,18
5658,0,1,0.8478845014441205,0.7001231801659114,25,35,20,10,25,13,12
5659,0,0,0.20000257006646868,0.45016536655355954,7,7,4,3,4,4,3
5660,0,0,0.589077364767614,0.35684657766089434,26,40,24,7,33,8,18
5661,0,0,5.609856687836341,0.0036482357128438947,24,34,21,10,24,7,17
5662,0,0,1.8419649422951356,0.13681906800787835,29,43,24,8,35,10,19
5663,0,1,1.3266055692097756,0.7902786018131163,4,3,1,0,3,4,0
5664,1,1,4.778854977102897,0.9916644473872297,9,12,5,1,11,8,1
5665,1,0,0.7542930224892106,0.3198865931458035,18,25,15,5,20,5,13
5666,1,1,3.942492790282512,0.9809693950312028,17,24,15,4,20,13,4
5667,1,1,1.1425710031478031,0.7581513654998444,34,53,34,15,38,16,18
5668,0,0,2.333499908305517,0.08838625465420713,12,13,7,2,11,3,9
5669,1,1,3.4683291196379864,0.9697730779981746,9,12,7,1,11,8,1
5670,0,0,6.497551591383517,0.0015048567296669368,26,35,23,5,30,5,21
5671,0,0,6.968280998788676,0.0009403844042222831,11,10,3,1,9,1,10
5672,1,1,3.769786378388397,0.9774626550648006,12,15,10,1,14,11,1
5673,1,0,0.23932846893914372,0.4404518456364034,8,8,4,1,7,2,6
5674,1,1,4.064176806936569,0.9831129474439133,17,22,13,5,17,11,6
5675,0,0,2.9979939649813825,0.0475165814607873,8,7,3,0,7,0,8
5676,1,1,0.31280710265277134,0.5775702947504712,3,2,0,1,1,2,1
5677,1,1,2.301098440098145,0.9089679704695157,9,12,5,1,11,8,1
5678,0,0,1.3586104506554446,0.204466233275567,7,8,5,0,8,0,7
5679,1,1,3.349348116623164,0.9660834825965875,33,53,32,16,37,19,14
5680,0,0,6.6808343567790445,0.0012531582666049923,24,32,19,6,26,7,17
5681,0,0,3.718723384277055,0.02369008688307772,9,9,4,1,8,1,8
5682,0,0,2.231256352429421,0.09697856180749675,26,38,21,9,29,8,18
5683,0,0,1.9996402698830635,0.11924069655097769,16,23,14,4,19,4,12
5684,1,1,3.573356707866479,0.9727044528767016,18,27,21,2,25,16,2
5685,1,1,6.197824537774338,0.9979702777596267,20,26,12,4,22,15,5
5686,1,1,0.9389775419565598,0.7188930793964867,11,13,5,4,9,7,4
5687,1,1,1.628596342574722,0.8359772610373744,8,9,5,2,7,6,2
5688,0,0,1.400014117738543,0.1978138711790821,23,32,18,7,25,7,16
5689,1,1,1.5973577781677657,0.8316487741593299,20,28,18,5,23,13,7
5690,0,0,2.3507887820516085,0.0870030962613908,9,9,5,0,9,0,9
5691,1,1,2.7148177183358015,0.9378953621202314,9,11,8,1,10,8,1
5692,1,1,2.150492915388734,0.895714828977834,14,18,9,4,14,7,7
5693,0,0,2.7897282744772736,0.057881771089018264,15,16,8,4,12,4,11
5694,1,1,1.7966901350768172,0.8577455496111578,17,23,16,3,20,12,5
5695,0,0,2.8916068006611737,0.05257003188142739,22,28,15,3,25,6,16
5696,1,1,1.3729256592239616,0.7978524266009029,23,34,20,8,26,12,11
5697,0,1,0.5150700713782654,0.6259942634040951,7,7,4,2,5,3,4
5698,1,1,3.9271647109727974,0.9806811240999229,14,19,12,2,17,12,2
5699,1,1,2.4975226361701415,0.9239679649771967,14,19,11,2,17,11,3
5700,0,0,0.3441584846248247,0.41479968641895393,11,12,6,4,8,4,7
5701,1,1,2.249407680841138,0.9045994306204497,8,10,5,1,9,7,1
5702,1,1,4.034380910145421,0.9826110925765171,13,18,9,2,16,11,2
5703,1,0,1.182888112211197,0.2345333033915461,9,10,4,1,9,1,8
5704,1,1,4.363034573823385,0.9874205880846917,15,20,11,3,17,11,4
5705,1,1,3.928053693222078,0.9806979592575806,25,36,21,8,28,15,10
5706,0,0,7.273769369298304,0.0006930124303151652,22,33,20,2,31,1,21
5707,0,0,2.0708297701354614,0.11196450922393053,14,17,8,2,15,2,12
5708,0,0,1.355954600421113,0.2048985724102107,11,13,8,2,11,3,8
5709,0,0,8.202270438359177,0.0002739556210916705,20,25,17,2,23,3,17
5710,0,0,0.9868017826153297,0.2715442481024112,25,38,23,11,27,12,13
5711,0,1,0.09943320642131548,0.5248378407432717,17,23,12,8,15,9,8
5712,0,0,0.9169580363967418,0.28557812059366383,25,34,20,7,27,7,18
5713,0,0,3.6724528979864517,0.024784188603626744,28,39,24,10,29,9,19
5714,0,0,1.6998499522380637,0.15448486319962418,8,8,4,1,7,1,7
5715,1,1,4.684587008565343,0.9908479845935954,12,20,14,0,20,12,0
5716,0,0,6.580256262205096,0.0013855712157667677,16,20,13,0,20,0,16
5717,1,0,2.885860726966828,0.05285696015529939,28,38,20,8,30,7,21
5718,0,0,2.497814589118015,0.07601152752672236,37,59,40,14,45,17,20
5719,1,1,6.14419448327097,0.9978586912851338,31,50,33,7,43,23,8
5720,0,0,0.0766848651632997,0.48083817299207254,7,6,4,1,5,2,5
5721,1,1,0.8545837567347709,0.7015278051884095,10,11,8,2,9,5,5
5722,1,1,4.1222563782776085,0.9840506042494513,30,47,31,9,38,20,10
5723,0,0,3.033628052256956,0.045929583419494935,21,30,17,7,23,6,15
5724,1,1,5.645194371462458,0.9964779870825513,21,31,15,7,24,14,7
5725,0,0,4.266407634835922,0.013837925973299248,24,33,18,9,24,8,16
5726,1,1,1.8317940953831595,0.8619753159509238,32,49,31,16,33,16,16
5727,1,0,0.5348159156219614,0.36939435433148604,18,24,12,5,19,6,12
5728,0,0,3.6506689500343814,0.02531619145366515,39,55,30,13,42,15,24
5729,0,0,1.9789591186708673,0.12142984018537517,24,36,21,10,26,9,15
5730,0,1,0.1870833804670402,0.5466349051790025,17,24,15,8,16,6,11
5731,0,0,0.16457864165169767,0.4589479595228947,26,39,23,10,29,13,13
5732,0,0,6.587129298636902,0.0013760938454396854,19,25,14,1,24,1,18
5733,0,0,0.91149631875172,0.2866937417636606,3,2,0,0,2,0,3
5734,0,0,2.4746884951673467,0.07765177021208425,8,8,4,0,8,0,8
5735,1,1,0.35286648767183726,0.5873125216886619,14,19,14,4,15,7,7
5736,0,0,1.7547079896834137,0.14745436635201126,12,13,9,3,10,3,9
5737,1,1,1.1128374647893582,0.752657724057565,5,5,2,1,4,4,1
5738,0,1,1.0277728082646034,0.7364838804826791,8,8,3,3,5,5,3
5739,0,1,0.8939234105101168,0.7096991627119997,3,2,1,0,2,3,0
5740,1,1,1.3327082929718466,0.7912882653356632,16,21,9,6,15,9,7
5741,1,1,2.4282049767078933,0.9189529427643973,10,13,8,1,12,9,1
5742,1,1,5.252540529197909,0.9947930503900335,18,25,17,2,23,15,3
5743,1,1,6.486509529204504,0.9984784598918232,24,39,27,4,35,21,3
5744,0,0,2.675553147414367,0.06443141407289366,9,10,4,0,10,0,9
5745,1,1,2.312674446733187,0.9099213055038844,10,12,7,1,11,8,2
5746,0,0,3.262635619397476,0.03687548911952854,34,51,35,9,42,15,19
5747,1,1,3.371215090876439,0.9667927232446305,16,22,13,4,18,10,6
5748,0,0,3.972129146850211,0.018485155254557628,16,24,15,0,24,0,16
5749,1,1,4.503311158447185,0.9890489789806582,25,38,24,6,32,16,9
5750,0,0,0.033571374344091076,0.4916079445790422,12,13,7,2,11,4,8
5751,1,1,0.9446784301085249,0.7200437090824389,24,33,21,9,24,14,10
5752,1,1,3.5973179008136493,0.9733334797281211,15,22,11,2,20,13,2
5753,0,1,3.67704777306625,0.9753266270500541,28,40,23,9,31,16,12
5754,1,1,4.551261785635669,0.9895563418612257,10,13,9,1,12,9,1
5755,0,0,0.6572340757423666,0.3413612114858796,11,11,5,1,10,2,9
5756,0,0,0.5591379786756909,0.3637469382708436,10,11,7,3,8,3,7
5757,0,0,1.9928488007294987,0.1199557990664557,17,23,14,4,19,4,13
5758,0,0,2.1367891614028123,0.10557219469007806,14,20,12,6,14,4,10
5759,1,0,3.627788659011556,0.02588694306377326,31,48,30,10,38,10,21
5760,1,1,1.4669419730058466,0.8125921359566051,4,3,2,0,3,4,0
5761,0,0,3.812180514045095,0.021622090319562526,31,41,24,10,31,13,18
5762,1,1,1.6713471188464082,0.8417553444327543,5,5,2,1,4,4,1
5763,1,0,1.8793547105130095,0.13246301040549435,25,34,15,9,25,11,14
5764,1,1,5.845698671952967,0.9971160281215503,24,32,15,7,25,17,7
5765,1,1,5.18901534821666,0.9944534399133228,23,32,20,5,27,13,10
5766,0,0,2.775936027031088,0.05863848493703927,18,23,13,5,18,6,12
5767,0,0,1.277267618541156,0.21801569429417134,5,4,1,1,3,1,4
5768,0,0,2.725559735442994,0.061481875992586255,6,6,3,0,6,0,6
5769,0,0,3.661505520168443,0.02505016704877161,20,26,14,3,23,4,16
5770,0,0,9.05017327428184,0.00011735692356962257,19,22,14,2,20,3,16
5771,1,1,2.6487865281554583,0.9339361594254103,14,17,9,3,14,9,5
5772,1,1,2.8160861586452723,0.9435389250744892,6,8,4,0,8,6,0
5773,1,0,0.8682257235040525,0.29562362610376114,16,20,13,1,19,7,9
5774,1,1,0.9185532163467132,0.714747221866632,3,2,1,0,2,3,0
5775,0,0,4.773890695888401,0.008376688031854762,18,23,13,1,22,1,17
5776,0,0,0.10367469345505076,0.4741045171569428,12,15,9,5,10,5,7
5777,0,0,0.9022162089452261,0.2885952787603613,22,29,14,8,21,8,14
5778,0,0,1.7994112661278923,0.14192274619859147,19,25,12,6,19,6,13
5779,1,1,3.8159328092437006,0.9784571455700372,9,11,5,1,10,8,1
5780,0,0,6.101771118075463,0.0022338973813494922,47,73,49,15,58,15,32
5781,1,1,1.0329579961947786,0.7374889630732934,11,13,6,3,10,6,5
5782,0,0,0.8044683081756396,0.30907051668300556,16,20,11,4,16,5,11
5783,1,0,2.365544342887237,0.08583813001361407,11,14,9,0,14,0,11
5784,1,1,1.3494805351546713,0.7940446890782097,11,14,8,2,12,8,3
5785,0,0,6.841383038539646,0.0010674836892221595,19,25,15,3,22,2,17
5786,0,1,0.08211392214195445,0.5205169535320766,7,7,3,2,5,4,3
5787,0,0,1.5011391056663774,0.1822556916929643,12,15,10,1,14,4,8
5788,1,0,1.120796864322871,0.24586350331916162,26,36,20,10,26,11,15
5789,0,0,1.170881638558002,0.23669566093261163,11,12,7,1,11,2,9
5790,1,1,1.864596381700248,0.8658317947755898,11,13,5,3,10,7,4
5791,0,0,6.832809638378122,0.0010766651021797413,32,45,28,4,41,5,27
5792,1,1,3.350285177569641,0.966114173104742,24,33,18,8,25,12,12
5793,0,0,2.3355588554588413,0.08822049732603576,12,13,5,3,10,4,8
5794,1,1,1.4248892573801624,0.8061037536369283,5,5,2,1,4,4,1
5795,1,0,1.1960896108039778,0.2321715833228858,10,12,6,2,10,3,7
5796,0,0,1.9180346344961832,0.1280808904357802,20,30,18,6,24,6,14
5797,1,1,1.1964278410633775,0.7678887068263202,15,19,10,5,14,9,6
5798,1,1,2.1839650267355193,0.8988002950034887,11,15,8,2,13,7,4
5799,0,0,0.07577175652837975,0.4810661188520706,9,9,5,1,8,2,7
5800,1,1,1.3877344537440386,0.8002303152774604,7,8,5,1,7,6,1
5801,0,0,2.240828028000485,0.09614356202986085,33,48,30,13,35,12,21
5802,1,1,0.08165936715675226,0.5204035050725215,8,9,5,2,7,4,4
5803,1,0,0.2597033974641521,0.4354366210672628,1,0,0,0,0,0,1
5804,0,1,0.6111565808559962,0.6482045886450748,13,17,9,6,11,7,6
5805,0,0,0.19024068364708868,0.45258275141691084,7,7,3,1,6,2,5
5806,1,1,2.5125875047624175,0.9250195531369675,8,8,2,2,6,6,2
5807,1,1,1.8724595124440286,0.8667426071343232,10,11,5,3,8,6,4
5808,0,0,2.461483811680338,0.07860280577603518,25,36,22,11,25,10,15
5809,0,0,5.523331389056286,0.003976648240242464,21,25,14,4,21,5,16
5810,1,0,0.8452581566878732,0.3004285124359747,14,16,10,3,13,4,10
5811,1,1,2.7349178365498985,0.9390558930341275,16,21,11,5,16,10,6
5812,1,0,2.765078513273358,0.05924069978881763,19,25,14,4,21,5,14
5813,1,1,1.2030977423805977,0.7690753961957901,3,2,1,0,2,3,0
5814,1,1,2.395546148131281,0.916487043910986,24,35,22,10,25,14,10
5815,0,0,6.3459046763912195,0.0017508444661060718,24,35,22,8,27,7,17
5816,0,0,1.7874478127551647,0.14338591421644664,20,30,17,8,22,8,12
5817,0,0,0.2391308351539032,0.4405005538498076,12,14,8,2,12,3,9
5818,0,0,2.2051236473887545,0.09929132652466344,23,32,20,8,24,9,14
5819,1,1,2.3028790665359438,0.9091152015033236,34,55,36,14,41,21,13
5820,1,1,2.9900149586730493,0.9521209920698654,14,18,10,3,15,11,3
5821,1,1,1.3130717652925386,0.7880267193941175,12,15,8,4,11,7,5
5822,0,0,1.5913762907826445,0.16919035056417897,10,12,6,3,9,4,6
5823,0,0,3.6581212420564473,0.025132953097678268,24,31,16,7,24,8,16
5824,1,1,3.9845128547513387,0.9817381933154268,29,43,24,9,34,18,11
5825,0,0,2.140037279136866,0.1052658783363355,8,7,2,1,6,2,6
5826,1,1,1.1363229750912032,0.7570038933006896,7,8,3,2,6,5,2
5827,1,1,1.852743901828349,0.8644489467257512,10,11,6,3,8,6,4
5828,0,0,2.467700539856564,0.07815374080577253,12,15,7,3,12,2,10
5829,0,0,2.8516346072538057,0.054596883769483795,16,20,13,1,19,1,15
5830,1,1,3.1957174941409736,0.9606728005006013,12,18,14,0,18,12,0
5831,0,0,5.7523704356222485,0.003165194884717004,9,11,6,0,11,0,9
5832,1,1,4.944780102724387,0.992929862508354,17,28,18,2,26,14,3
5833,0,0,8.896504073653515,0.00013684783664069666,24,35,21,2,33,1,23
5834,0,0,1.0068688654019131,0.26759306575463115,5,5,2,1,4,1,4
5835,1,1,0.7245582112113218,0.6736099754094584,18,23,12,7,16,9,9
5836,1,1,3.561522773748963,0.9723884922243405,30,48,33,11,37,19,11
5837,1,1,3.2031712559092327,0.9609534429214662,11,12,5,2,10,8,3
5838,1,1,4.8462148765317385,0.99220320266599,21,31,22,5,26,17,4
5839,1,1,0.5799636883996946,0.6410590509932652,6,5,1,3,2,3,3
5840,0,0,7.115803154367475,0.0008115090710945072,25,31,18,3,28,4,21
5841,0,1,0.025773355885287286,0.5064429823208303,30,46,31,11,35,16,14
5842,0,1,0.32254633781618214,0.5799446885322832,20,27,16,6,21,8,12
5843,1,0,0.5475859668290606,0.36642466427879117,32,47,28,11,36,14,18
5844,0,1,0.28920273358600124,0.5718009377192719,28,43,26,12,31,12,16
5845,1,1,4.449814619976742,0.9884541320468362,13,17,9,2,15,10,3
5846,0,0,2.0354676051147083,0.11552905521564838,10,11,7,2,9,1,9
5847,1,1,4.143469979395853,0.984380155642051,14,21,13,1,20,12,2
5848,0,1,0.6046455922512806,0.6467184239179466,28,42,28,11,31,13,15
5849,0,0,2.8910362963773437,0.05259845391372764,19,26,17,2,24,3,16
5850,1,1,3.642275841554817,0.9744758790429121,22,34,25,5,29,18,4
5851,0,0,0.5217379067034817,0.37244594285506827,13,16,10,3,13,5,8
5852,1,1,4.461933676591605,0.9885916259262949,20,28,20,3,25,14,6
5853,1,1,3.8787771525282233,0.9797427474098039,18,25,17,3,22,15,3
5854,0,0,0.06849531883060189,0.48288286201191266,20,27,15,8,19,9,11
5855,1,1,5.161132894058644,0.9942975063026566,31,46,26,10,36,18,13
5856,0,0,1.4533730857625846,0.18948298758532867,16,21,12,3,18,5,11
5857,0,0,0.29260986187653515,0.4273650500663253,17,23,12,6,17,6,11
5858,0,1,0.376459041225363,0.5930187836500733,12,17,10,6,11,6,6
5859,1,1,4.35991152614851,0.9873817370687272,35,50,32,11,39,20,15
5860,1,1,7.284213568128919,0.9993141829251152,16,23,12,2,21,14,2
5861,0,0,2.6802565899401665,0.06414847070445084,10,11,6,3,8,4,6
5862,0,0,1.208886026050317,0.22989821515568043,16,21,10,4,17,5,11
5863,0,0,3.731096534342524,0.023405590242413954,14,16,11,2,14,2,12
5864,1,1,4.8079266626179145,0.9919013531085042,17,23,16,2,21,11,6
5865,0,0,0.7855198305312938,0.3131314572693351,10,10,4,1,9,3,7
5866,1,1,1.9407812537208222,0.8744379472888094,19,26,15,6,20,12,7
5867,0,0,2.4770690889611537,0.07748143872660673,27,42,29,9,33,8,19
5868,1,1,1.5729792025271412,0.8282079024889403,15,19,12,3,16,10,5
5869,0,0,1.1977549960112892,0.23187483096523243,4,3,1,0,3,0,4
5870,0,1,0.19863313711934616,0.5494956531028334,10,10,5,3,7,4,6
5871,0,0,5.580112318328452,0.003757966232770915,25,37,22,3,34,2,23
5872,0,0,0.361493498354287,0.41059808024295885,9,10,4,3,7,4,5
5873,1,1,3.728035026052771,0.9765243283086242,11,16,8,1,15,10,1
5874,0,0,2.4619398540163524,0.07856978352795296,20,28,18,7,21,7,13
5875,0,0,4.261120475764589,0.01391026262738948,28,36,21,3,33,6,22
5876,0,0,5.743646468201591,0.0031928401907328485,18,23,12,1,22,2,16
5877,1,1,3.372225671537822,0.9668251521850469,39,62,38,19,43,20,19
5878,0,1,0.12921098529534136,0.5322578787464252,20,25,13,7,18,11,9
5879,1,1,3.1464054209429224,0.958766851499408,14,21,13,2,19,12,2
5880,1,1,1.6169059000484372,0.8343679734668659,11,14,7,2,12,9,2
5881,0,0,2.2386277346256884,0.09633493745414579,5,5,2,0,5,0,5
5882,0,0,3.314960316308377,0.035061513196339766,10,10,5,1,9,2,8
5883,1,1,3.37144471341068,0.9668000943834556,43,72,50,20,52,25,18
5884,0,0,3.481162990955333,0.02985297909395379,7,6,3,0,6,0,7
5885,1,1,1.899213829328896,0.8698025207587778,14,17,12,4,13,8,6
5886,1,1,1.004689886244887,0.7319796664168743,9,10,4,2,8,6,3
5887,0,0,0.983142418549853,0.27226870431656136,7,7,3,1,6,1,6
5888,1,1,4.182960941281166,0.9849758903199982,8,11,7,0,11,8,0
5889,1,1,0.24159351885805247,0.5601063094931831,8,8,3,4,4,4,4
5890,0,0,3.9712548407565627,0.018501024867161986,15,18,11,2,16,3,12
5891,1,1,8.048884982320477,0.9996806440955706,22,32,17,4,28,17,5
5892,1,1,3.470271670960236,0.9698299685669485,11,15,6,2,13,9,2
5893,1,1,3.589714800862517,0.9731354262976772,21,31,20,7,24,16,5
5894,0,1,2.021583447894104,0.8830446417736256,21,32,25,5,27,17,4
5895,0,0,2.3758469351423015,0.08503312817706943,16,20,12,2,18,3,13
5896,1,1,4.600277185321227,0.9900509288035774,21,29,17,6,23,14,7
5897,1,1,2.2576923739282346,0.9053120012410854,23,33,18,7,26,12,11
5898,1,1,1.4117041043714207,0.8040345865011813,15,19,11,3,16,11,4
5899,0,0,0.03977309494082615,0.4900580368287747,10,11,5,3,8,4,6
5900,1,1,3.9360049509639357,0.9808478984874035,20,28,13,6,22,13,7
5901,1,0,1.5313474323054184,0.17779662589073608,17,22,14,2,20,3,14
5902,1,1,2.2254302846074876,0.9025100283991941,8,10,6,1,9,7,1
5903,0,0,3.695567230324043,0.024231611026759747,16,17,6,3,14,4,12
5904,1,1,2.2372512820695363,0.9035451695362989,9,11,7,1,10,7,2
5905,0,0,5.359376052076015,0.004681817621764117,18,22,12,2,20,3,15
5906,0,0,1.4451090312530555,0.19075543235804593,21,30,18,8,22,7,14
5907,1,1,1.7970620250794556,0.8577909208939624,4,4,2,0,4,4,0
5908,0,1,3.0714079734716537,0.9556978235575871,9,12,6,4,8,7,2
5909,0,0,2.406709619387006,0.08266248332800963,17,20,10,3,17,5,12
5910,1,0,0.1924612237513461,0.45203266718858703,7,7,3,3,4,2,5
5911,1,1,1.1307651762494701,0.7559800820160423,11,12,7,2,10,6,5
5912,0,0,1.2041358751136007,0.2307402845630394,22,32,18,11,21,9,13
5913,0,0,2.7467065261639556,0.06027292291971287,21,30,20,5,25,5,16
5914,0,0,0.4655510294896821,0.38566979435324156,20,27,16,4,23,5,15
5915,1,1,2.5250377488535327,0.9258785254597344,6,7,3,0,7,6,0
5916,0,0,1.1672152054228646,0.23735871779624929,12,14,9,3,11,4,8
5917,1,1,0.703277502944275,0.6689140357704557,6,6,2,2,4,4,2
5918,0,0,2.0507037266321166,0.11398129293007353,27,38,28,7,31,14,13
5919,0,0,3.3210457295087403,0.03485621176033704,15,18,9,3,15,3,12
5920,1,1,2.5263003652147606,0.9259651290606751,16,22,13,3,19,12,4
5921,1,1,2.2785225761596033,0.9070825989197382,9,11,4,2,9,7,2
5922,0,0,3.4300378869176917,0.031369781006562736,11,12,5,2,10,3,8
5923,1,1,2.3959902876266543,0.9165210314130088,13,15,7,3,12,9,4
5924,0,0,1.3418140927380504,0.2072118899637223,3,2,0,0,2,0,3
5925,0,0,5.725605873247816,0.0032507746955298122,19,21,11,2,19,2,17
5926,0,0,0.9562210278414809,0.2776354456505097,11,12,8,3,9,4,7
5927,1,1,1.883148876270596,0.8679723943836135,11,13,8,3,10,7,4
5928,1,1,6.025748569929896,0.9975900792100317,12,15,8,2,13,9,3
5929,0,0,7.407887683876309,0.0006060827982716788,15,17,8,1,16,1,14
5930,0,0,1.093698078471009,0.2509225459515554,18,25,16,6,19,8,10
5931,1,1,5.648742209414154,0.9964904166973716,18,25,16,2,23,15,3
5932,0,0,3.3942223478732503,0.032476519333038745,22,33,22,6,27,5,17
5933,1,1,2.5372624189419186,0.9267131183093748,18,24,14,5,19,12,6
5934,1,1,4.711908776392066,0.991092451664436,20,28,17,4,24,16,4
5935,1,1,1.1020448254704631,0.7506430481974079,7,7,4,1,6,4,3
5936,0,0,1.5668419927263542,0.17266705676664384,12,13,9,3,10,4,8
5937,0,0,0.6763660207943922,0.337072851099527,15,18,10,5,13,6,9
5938,0,0,5.6231529796348845,0.003600222253703933,19,25,15,7,18,5,14
5939,0,1,0.24193472248364012,0.5601903759849971,44,71,46,23,48,21,23
5940,0,1,1.552450423037824,0.8252673673165143,16,21,11,6,15,9,7
5941,1,1,2.927869264619582,0.9492070441278679,25,38,25,8,30,15,10
5942,0,0,4.287738846444913,0.013549829528300972,23,31,16,6,25,7,16
5943,0,0,4.219435421814225,0.014493786061984704,10,11,5,0,11,0,10
5944,1,1,2.1943316309848684,0.8997393333723469,32,49,28,16,33,16,16
5945,0,0,1.182734237891217,0.23456092918163307,27,40,26,7,33,11,16
5946,0,1,0.3752691400713639,0.5927315722187214,27,41,27,11,30,16,11
5947,0,0,3.921220166689237,0.01943182159855328,12,14,9,2,12,3,9
5948,0,0,0.39539508902245846,0.40241922029658295,14,20,11,7,13,7,7
5949,0,1,0.47514170967256275,0.6166000058704084,15,17,10,4,13,6,9
5950,1,1,0.703277502944275,0.6689140357704557,6,6,2,2,4,4,2
5951,0,1,0.31982034139965937,0.5792804673472469,10,13,8,4,9,8,2
5952,1,1,2.078706916072214,0.8888163125424131,5,6,3,0,6,5,0
5953,0,0,8.366936874412378,0.0002323724062682775,29,41,22,6,35,5,24
5954,0,0,1.7633659204931198,0.14636928301835261,24,32,17,7,25,7,17
5955,0,1,0.4644406187742862,0.61406708420886,18,24,12,9,15,8,10
5956,1,1,2.1701713090415335,0.8975387217161672,8,10,6,1,9,7,1
5957,1,1,6.76488381421454,0.9988477477006866,20,29,18,3,26,16,4
5958,1,1,0.6386064529916275,0.6544383795026811,7,7,3,2,5,4,3
5959,1,1,2.2843557599392392,0.9075730754974356,15,20,11,4,16,11,4
5960,1,1,3.102159133558729,0.9569817193941319,11,14,8,2,12,9,2
5961,0,0,2.561404076540461,0.07166407519129714,14,17,8,5,12,5,9
5962,0,0,1.4519655936511975,0.189699243555715,15,19,10,6,13,7,8
5963,1,1,1.4333666043792341,0.8074253298080972,3,2,1,0,2,3,0
5964,0,0,0.7790148978348534,0.31453223695728705,7,6,3,1,5,2,5
5965,0,0,2.71858927954555,0.06188531577677148,16,19,10,2,17,2,14
5966,1,1,4.719197894255837,0.9911565716734668,25,41,28,6,35,19,6
5967,0,0,0.024688917530156118,0.49382808411810564,25,37,23,8,29,9,16
5968,1,1,1.918367401142919,0.8719562670717674,15,20,13,6,14,11,4
5969,0,0,0.5322533856864369,0.3699914751215203,17,21,13,3,18,6,11
5970,1,1,2.3823602845383167,0.9154722588995011,9,10,4,2,8,7,2
5971,0,0,2.4798238685631278,0.07728476145611651,22,32,18,10,22,10,12
5972,0,1,2.482351356063049,0.9228952858357606,27,39,25,8,31,16,11
5973,0,0,2.5237820537841396,0.07420769582801179,5,4,1,0,4,0,5
5974,0,0,3.093577781334381,0.04337294385265089,13,15,9,1,14,2,11
5975,1,1,3.1593087467051504,0.959273949504305,7,8,3,1,7,6,1
5976,0,1,2.1600708090094605,0.8966061129755614,12,16,9,3,13,8,4
5977,1,1,2.584281402813662,0.9298430806215745,26,35,22,6,29,16,10
5978,1,0,1.9049634437716272,0.12954774113147516,17,24,15,3,21,4,13
5979,0,0,0.583638043285198,0.35809591026956855,9,8,2,1,7,2,7
5980,0,0,0.9969522933436634,0.26954105866735156,18,23,12,4,19,5,13
5981,0,0,1.3037719587319931,0.21353088692361244,20,30,17,11,19,9,11
5982,0,1,2.027464457197329,0.8836506467220345,9,11,4,2,9,7,2
5983,0,1,0.9732127655111906,0.7257594067359623,13,16,11,2,14,7,6
5984,1,1,2.211807621626929,0.901304839449161,19,25,15,8,17,11,8
5985,1,0,0.9564130372801576,0.2775969390327916,12,14,8,3,11,3,9
5986,0,1,3.0462448190463824,0.9546201274865411,11,15,8,2,13,8,3
5987,1,1,2.1830823423069177,0.898719979239496,10,12,7,2,10,7,3
5988,1,0,0.8784183118226789,0.29350565074484236,21,28,17,5,23,8,13
5989,0,0,1.6007810591494454,0.16787247938484073,21,29,18,9,20,10,11
5990,0,0,3.2467945398022184,0.037442242020753524,9,10,6,0,10,0,9
5991,0,0,1.4909659897911358,0.18377678190731717,26,38,24,8,30,10,16
5992,0,0,4.999420162443608,0.006696706820044196,25,34,21,6,28,7,18
5993,1,1,1.4188936647877393,0.8051649193596355,20,29,19,7,22,14,6
5994,1,1,3.5360273761454977,0.9716956566306059,7,8,5,0,8,7,0
5995,0,1,0.9514314037040783,0.7214029537390878,11,13,6,3,10,7,4
5996,1,0,0.07877605582155245,0.48031616426938506,10,11,6,4,7,4,6
5997,0,0,0.7050435006267433,0.330694968905343,14,18,9,5,13,6,8
5998,1,1,2.071115568710044,0.888063904136375,12,15,8,2,13,8,4
5999,0,0,1.5379496597474216,0.17683353161673054,10,10,6,2,8,2,8
6000,0,0,1.7096125893134184,0.1532139714622348,8,9,4,2,7,3,5
6001,0,0,5.081237864491783,0.006173861026655514,37,55,35,16,39,16,21
6002,1,1,2.732192252958865,0.938899721304192,18,22,11,6,16,10,8
6003,1,1,4.676831664904083,0.9907773887688232,10,14,10,0,14,10,0
6004,1,1,2.334266876544262,0.9116755236341536,10,14,9,1,13,9,1
6005,1,1,0.6935550216027553,0.6667572918481457,3,2,1,0,2,3,0
6006,1,1,3.5170298723054327,0.9711684559293042,14,20,12,2,18,11,3
6007,1,1,4.711460334261738,0.9910884918538749,22,33,20,4,29,17,5
6008,0,0,3.8614526465846386,0.020603963209595122,35,55,34,12,43,12,23
6009,1,1,4.979294923422928,0.9931680851273585,16,28,19,2,26,15,1
6010,1,1,1.6401632027476245,0.8375571432209763,24,33,19,6,27,15,9
6011,1,1,0.887673916170816,0.7084099173815193,27,37,19,13,24,12,15
6012,0,1,1.7608658165634201,0.8533180644486147,4,3,1,0,3,4,0
6013,1,1,0.8025979311107554,0.6905299293344407,11,13,7,4,9,4,7
6014,1,0,1.0671531329833472,0.25594485644874343,31,46,28,10,36,11,20
6015,0,0,2.2477686491551783,0.09554211049943118,8,8,5,0,8,0,8
6016,1,1,4.135637201014241,0.9842592618423788,21,29,16,7,22,13,8
6017,0,0,1.7153853942256003,0.15246650936674344,21,28,19,2,26,4,17
6018,0,0,1.117143808940625,0.24654146191728643,3,2,1,0,2,0,3
6019,0,0,2.15009507669492,0.10432233889556708,21,29,19,5,24,6,15
6020,1,1,7.467365710453492,0.9994288947153517,21,33,19,7,26,16,5
6021,1,1,0.06660668002564929,0.5166455165448112,38,61,39,16,45,18,20
6022,0,0,0.45869406746135777,0.3872956730447812,36,54,31,11,43,14,22
6023,1,1,1.2165148269120833,0.7714496422217543,15,20,12,4,16,8,7
6024,0,1,0.026368176968715185,0.5065916623252738,12,14,9,3,11,7,5
6025,1,0,3.8164149060971333,0.021532694769814564,30,42,22,6,36,9,21
6026,1,1,4.1853643352691705,0.9850114152469484,13,18,13,2,16,12,1
6027,0,0,1.6213450030772305,0.165019461346549,15,16,7,2,14,3,12
6028,0,0,0.8632548531370992,0.29665976242740477,4,3,1,0,3,0,4
6029,0,1,3.655533580338079,0.9748035678906296,17,25,16,6,19,12,5
6030,1,0,3.0632631922035607,0.04464830512043072,14,20,11,2,18,3,11
6031,1,1,2.4894241773968178,0.9233970818164665,10,14,8,2,12,8,2
6032,0,0,3.031373001877507,0.046028501100184194,11,12,4,1,11,1,10
6033,0,0,4.451503684862146,0.011526607292534075,15,19,10,5,14,4,11
6034,1,1,0.7093319465251686,0.6702535276112734,14,17,8,6,11,7,7
6035,1,1,0.9510676896612389,0.7213298483383124,23,34,20,8,26,14,9
6036,1,1,1.3343882148257444,0.7915655705936341,7,7,2,2,5,5,2
6037,1,1,4.418317028357592,0.9880890776359083,17,26,20,1,25,16,1
6038,0,0,6.110037436450537,0.0022155481317829295,17,19,12,2,17,3,14
6039,0,0,2.296292716993372,0.09143046235355767,11,13,7,3,10,4,7
6040,1,1,0.3839050115897127,0.5948145979213098,19,25,13,7,18,9,10
6041,0,1,0.45767917462826624,0.6124634676554871,12,16,9,4,12,5,7
6042,0,1,1.2781558444810592,0.7821356968448931,20,27,14,6,21,9,11
6043,1,1,4.16477035916751,0.9847043106826429,12,16,11,1,15,11,1
6044,0,0,2.1392100639751854,0.10534381501838885,9,9,3,2,7,2,7
6045,1,1,1.7215855492226788,0.8483329523834837,5,5,4,0,5,5,0
6046,0,1,0.35067550440755335,0.5867813773863199,9,10,6,1,9,7,2
6047,0,0,1.3177904802009062,0.21118613487719273,13,17,8,5,12,6,7
6048,0,0,1.7254017322538906,0.15117669407739676,24,32,16,6,26,7,17
6049,1,1,2.7901974192303634,0.9421438067590304,9,11,5,1,10,7,2
6050,0,0,6.781664396875855,0.0011330998871112996,18,27,17,2,25,1,17
6051,0,0,5.3849178155514235,0.004564288884670975,14,19,11,0,19,0,14
6052,0,0,2.0296326012777754,0.11612662700890863,23,32,15,9,23,8,15
6053,0,0,0.9109743449687571,0.2868004975158388,12,13,4,4,9,5,7
6054,1,1,0.6239206366049528,0.6511097101660912,12,15,7,3,12,7,5
6055,0,1,1.564429721509528,0.8269880705554982,8,9,4,1,8,6,2
6056,1,1,1.6544089891395257,0.8394860479080045,8,9,5,2,7,6,2
6057,1,1,2.391540044092844,0.916179910509386,18,24,12,6,18,11,7
6058,0,0,1.8224688839163936,0.13913789010786037,19,26,15,5,21,7,12
6059,1,1,3.483874909901619,0.9702254628409207,23,35,26,6,29,17,6
6060,1,1,5.009740956304267,0.9933715973036514,12,18,12,0,18,12,0
6061,0,1,0.5247875896056975,0.628266581691441,26,38,21,13,25,13,13
6062,1,1,2.7888788797646473,0.942071892769319,12,15,7,2,13,9,3
6063,1,1,4.221650848872108,0.9855378244561169,15,22,14,2,20,13,2
6064,1,1,4.1304319043707425,0.9841784127367416,12,16,10,2,14,10,2
6065,1,1,4.119779276225608,0.9840116794491219,21,30,15,6,24,15,6
6066,0,0,5.004326137650668,0.006664151807981411,28,44,28,4,40,8,20
6067,0,0,1.1970122250363362,0.23200715142815287,11,13,8,2,11,3,8
6068,1,1,0.38770646121196073,0.5957304548168314,5,4,1,2,2,3,2
6069,0,1,0.9373382144308338,0.7185616757037039,14,19,10,4,15,9,5
6070,1,0,0.13594211495787756,0.46606671316496506,9,10,6,4,6,4,5
6071,0,0,7.200074373365203,0.0007459733926136192,28,39,26,5,34,4,24
6072,1,1,3.7075254232782076,0.9760495308902701,9,12,6,1,11,8,1
6073,1,1,2.9550726158644753,0.9505026875777313,22,29,17,6,23,13,9
6074,0,0,3.956407899705928,0.01877256274261685,24,31,18,5,26,5,19
6075,1,1,2.194907548485699,0.8997912740472123,29,46,30,12,34,17,12
6076,0,0,1.4597300036341034,0.1885086239274737,9,10,5,1,9,1,8
6077,0,0,1.231929897399711,0.2258438270544323,20,29,17,8,21,7,13
6078,1,1,2.4304005094588135,0.9191163122635801,24,36,22,9,27,15,9
6079,1,1,0.30786795699095926,0.5763647684947252,23,31,17,8,23,12,11
6080,1,1,0.15464188700048886,0.53858361130829,16,20,13,5,15,8,8
6081,0,1,0.1277389985434585,0.5318913964292304,9,10,6,5,5,6,3
6082,0,1,0.008182667387880649,0.5020456554328997,11,13,5,4,9,6,5
6083,1,1,2.18589533342588,0.8989757373550061,15,19,11,4,15,10,5
6084,1,1,1.304580549117069,0.7866048726101347,7,8,3,2,6,5,2
6085,1,1,1.9250089398554837,0.8726959551255439,17,24,15,5,19,10,7
6086,0,0,2.392466851957541,0.08374894339349159,5,4,0,1,3,1,4
6087,0,0,2.706460982266705,0.06259318306015094,11,13,6,4,9,4,7
6088,0,0,2.0479796721980703,0.1142566833954558,6,6,3,0,6,0,6
6089,0,0,3.3710551471133203,0.03321241206186765,29,41,23,10,31,10,19
6090,0,0,5.682238015672635,0.003394366422928563,19,23,15,2,21,3,16
6091,1,1,4.3906164001352215,0.987758620723124,19,29,18,2,27,16,3
6092,0,0,4.597973930088951,0.009971784087535629,22,31,17,7,24,7,15
6093,1,1,1.9708545258112968,0.8777028680508723,10,13,7,3,10,7,3
6094,1,1,1.3075328217283,0.7871000148267985,11,11,5,3,8,5,6
6095,1,1,4.098377641120637,0.9836714628737572,24,33,19,8,25,14,10
6096,0,0,1.3326965654082734,0.20871367149152265,30,47,32,10,37,14,16
6097,0,1,1.4036596196960274,0.8027639727850573,11,14,7,3,11,8,3
6098,0,0,2.9601367763258795,0.0492596000308686,19,25,17,4,21,10,9
6099,1,1,0.2926680452478092,0.572649188750392,13,15,6,4,11,8,5
6100,0,0,1.1431504116176265,0.2417424112871438,22,31,18,7,24,7,15
6101,1,1,2.669265101698349,0.9351885027395701,21,34,25,3,31,15,6
6102,0,0,3.614248783722453,0.026230576195726885,27,39,24,8,31,7,20
6103,0,0,2.6602740216563037,0.06535859231287378,22,28,15,5,23,8,14
6104,0,0,2.038150858357473,0.11525515751050386,9,12,7,0,12,0,9
6105,1,1,0.6782320812310114,0.663344002100272,16,22,13,7,15,11,5
6106,0,1,0.29073869326870305,0.5721769676485592,19,23,12,6,17,9,10
6107,0,0,4.351487157995365,0.012723654593600253,24,30,15,6,24,7,17
6108,0,1,1.772048537690358,0.8547122417794913,8,9,4,1,8,6,2
6109,1,1,2.5372525101889067,0.9267124453445054,11,17,11,0,17,11,0
6110,1,1,2.223970412997084,0.9023815051080382,12,16,9,2,14,9,3
6111,1,1,1.9662988598621562,0.8772130183607096,33,52,31,12,40,14,19
6112,0,0,6.345160407379358,0.0017521457663656204,16,19,11,2,17,3,13
6113,0,0,5.475936616282181,0.004168853655032612,18,22,11,1,21,1,17
6114,1,1,6.1468337701404945,0.997864323307741,18,25,15,3,22,15,3
6115,1,1,2.563645449025797,0.9284848965052424,19,29,17,5,24,14,5
6116,1,1,0.887292211018742,0.7083310640679372,28,37,22,9,28,14,14
6117,0,0,1.128024485289569,0.24452585938240146,20,27,15,6,21,6,14
6118,1,1,2.0646171818971144,0.8874162919941058,11,13,8,2,11,7,4
6119,1,1,2.7557696930027915,0.9402383745515143,17,24,12,7,17,12,5
6120,1,0,3.541768767437814,0.02814686361084584,15,19,13,1,18,1,14
6121,0,1,3.6482796338618897,0.9746247845811078,30,48,34,11,37,20,10
6122,1,1,2.50616910605654,0.9245731672202846,7,9,4,1,8,6,1
6123,1,0,0.7739915153384269,0.3156162945180947,4,3,0,1,2,1,3
6124,0,1,0.9383656076459335,0.718769399586838,10,12,7,4,8,8,2
6125,1,1,2.923025007269749,0.9489729789100105,13,19,12,2,17,11,2
6126,1,1,5.385918430656799,0.9954402551131623,25,37,22,6,31,17,8
6127,0,0,0.9520264535954635,0.27847746845552257,10,10,3,2,8,3,7
6128,0,0,4.209576452926934,0.014635284926881598,11,12,7,0,12,0,11
6129,0,0,2.578167299085649,0.07055682222390225,19,26,14,4,22,7,12
6130,0,0,1.6014099300972964,0.1677846499257083,6,6,3,0,6,0,6
6131,0,1,0.41444755172667147,0.6021538373145002,14,18,9,5,13,9,5
6132,1,1,0.807055318945781,0.6914816558978134,13,15,7,4,11,6,7
6133,0,1,0.7645604293489598,0.6823430324443971,14,18,9,6,12,7,7
6134,1,1,3.0719561903016865,0.9557210289827677,19,26,11,7,19,11,8
6135,1,1,1.7268696214170385,0.8490115724053556,16,21,13,5,16,9,7
6136,1,1,4.537330252417608,0.9894113788609641,11,16,9,2,14,9,2
6137,0,0,3.5731714003382335,0.027300467561864994,25,35,23,6,29,6,19
6138,1,1,0.267673303965942,0.5665216155578827,23,31,19,8,23,12,11
6139,1,1,4.769462221316503,0.9915864465584405,23,34,22,5,29,17,6
6140,0,0,1.9196490635056318,0.12790070540657106,19,27,16,5,22,6,13
6141,0,0,1.4288044534726905,0.19328503258121732,9,10,5,1,9,1,8
6142,0,0,2.686967738693509,0.0637467538841836,19,25,14,6,19,6,13
6143,0,0,2.8783372267423215,0.05323487948234551,10,10,4,1,9,2,8
6144,1,1,4.191934944705156,0.9851081147337192,12,16,11,1,15,11,1
6145,0,0,2.6937507598737866,0.06334311806952675,22,31,20,4,27,6,16
6146,1,1,3.3521020431345137,0.9661736025370562,17,24,15,4,20,10,7
6147,0,0,2.1379299910392917,0.1054645183682672,8,7,3,2,5,3,5
6148,1,1,8.109506505301427,0.9996994231593395,16,26,16,1,25,15,1
6149,1,0,2.161241025889305,0.10328545405501222,15,17,10,2,15,3,12
6150,1,1,5.388272465464165,0.9954509275159804,18,29,21,3,26,16,2
6151,1,1,2.6203914761860556,0.9321624658442512,12,18,10,1,17,11,1
6152,0,0,4.6166312482842615,0.00978926653847656,12,14,7,0,14,0,12
6153,0,0,4.116743016090848,0.01603615936943492,20,26,17,1,25,2,18
6154,1,1,0.718744275074102,0.6723304379666448,6,6,2,2,4,4,2
6155,0,1,0.6690736879470485,0.6612957114176595,6,6,2,2,4,4,2
6156,0,0,4.363637770637295,0.012571921707378753,31,45,33,7,38,13,18
6157,0,0,6.4821119970278716,0.0015282356153671905,28,44,29,6,38,5,23
6158,0,0,1.4397951467923518,0.19157707325857898,20,27,18,5,22,12,8
6159,1,0,0.2597033974641521,0.4354366210672628,1,0,0,0,0,0,1
6160,1,1,4.478127459610002,0.9887728253870964,12,18,10,0,18,12,0
6161,0,0,2.543448489322229,0.07286785649017458,33,52,32,13,39,15,18
6162,1,1,2.357382165316797,0.9135192154558602,11,15,9,1,14,9,2
6163,0,0,4.122924204224375,0.01593891760152122,14,18,11,1,17,1,13
6164,0,1,0.30103699517323346,0.5746959993102543,9,9,4,3,6,4,5
6165,0,0,8.551842037331134,0.00019315159567068196,23,30,16,5,25,5,18
6166,0,0,1.1154849067117636,0.24684974710579155,5,4,2,0,4,0,5
6167,0,1,1.4847931794409304,0.815295470781209,18,25,15,2,23,13,5
6168,0,1,0.9551469335994802,0.7221490890064103,11,14,8,4,10,7,4
6169,1,1,1.9355811870337032,0.8738658870331765,11,14,7,3,11,6,5
6170,1,1,2.2834307618792957,0.9074954535278738,4,4,2,0,4,4,0
6171,0,0,2.54231807033884,0.07294426236859497,14,18,12,1,17,1,13
6172,0,0,1.9786947663151258,0.12145804534221305,10,12,8,1,11,1,9
6173,1,1,3.1979380689979746,0.9607566093190022,7,9,4,1,8,6,1
6174,1,1,2.303594911431585,0.909174330690946,9,13,8,0,13,9,0
6175,1,1,2.157607215906973,0.8963775057968439,5,5,2,1,4,4,1
6176,0,0,0.8091655973106378,0.30806833034945125,4,3,1,0,3,0,4
6177,0,1,0.1837827463508468,0.545816799732529,16,18,9,5,13,8,8
6178,1,1,1.2650725681777075,0.7798980860938816,11,16,8,4,12,9,2
6179,0,1,0.274441599464436,0.5681829845230058,6,5,1,2,3,4,2
6180,0,0,0.8261307880727089,0.3044638157034064,28,42,27,10,32,15,13
6181,1,0,0.2622723777462834,0.43480518968871906,46,77,47,18,59,20,26
6182,0,0,1.6568043091108642,0.16019144699451682,22,29,15,6,23,8,14
6183,0,1,1.4433723645397907,0.8089763382401791,10,11,6,2,9,6,4
6184,0,0,1.4437964739849556,0.19095813117905747,33,51,28,13,38,14,19
6185,1,1,1.9187967981653242,0.8720042009638282,14,18,7,4,14,9,5
6186,0,0,3.8642667923065654,0.020547251871245953,20,25,16,3,22,4,16
6187,0,0,3.7386643260255856,0.02323322989765164,25,37,25,5,32,7,18
6188,0,0,4.016418622446574,0.017698496088934146,22,30,18,4,26,5,17
6189,0,0,1.0398906363367248,0.26117109625956003,16,21,10,8,13,9,7
6190,1,0,0.12650706820825608,0.468415345218532,28,40,26,7,33,11,17
6191,0,0,8.004406689891004,0.00033387609003820984,24,32,21,3,29,4,20
6192,0,0,2.206679038488469,0.09915231058928542,19,27,17,6,21,5,14
6193,0,0,0.13076569594766796,0.4673550808655903,7,6,2,1,5,2,5
6194,1,1,2.643848524948317,0.9336308339188024,7,10,5,0,10,7,0
6195,1,1,1.5502238481561705,0.8249460601125577,9,9,4,3,6,4,5
6196,0,0,3.6706191876863627,0.024828547900607956,6,5,2,0,5,0,6
6197,1,1,3.705162677744668,0.9759942351861987,15,24,16,1,23,14,1
6198,1,1,2.2571469359194865,0.9052652347673955,11,13,7,3,10,7,4
6199,1,1,4.968037055973713,0.9930912721409061,27,42,27,10,32,19,8
6200,0,0,3.7984782582216265,0.02191386369283288,15,18,12,2,16,3,12
6201,0,0,2.098431878147706,0.10924932778896057,11,14,8,1,13,1,10
6202,0,1,0.3185089400966017,0.5789608265066287,4,3,1,1,2,2,2
6203,1,1,3.184121470973433,0.9602323481767611,16,25,19,3,22,14,2
6204,0,0,4.6430229446036755,0.009536722246521023,21,27,12,4,23,5,16
6205,0,0,2.7414017961055204,0.0605740851432468,23,35,22,5,30,5,18
6206,1,1,0.3995905636696335,0.5985892846607694,14,17,7,6,11,6,8
6207,0,0,2.7613447427175886,0.059449130219653035,18,24,15,4,20,6,12
6208,0,0,3.2658296579523047,0.03676221829535575,16,19,8,3,16,4,12
6209,1,1,1.9837626188999484,0.8790816883003503,19,24,13,5,19,11,8
6210,0,0,1.8015490170511836,0.14166260866596148,19,28,16,6,22,6,13
6211,0,0,6.303881088204246,0.0018258518951488334,14,14,5,1,13,1,13
6212,1,1,3.471009786376558,0.9698515581888586,25,37,27,4,33,17,8
6213,1,1,1.487267511997763,0.8156677868171126,14,18,9,4,14,8,6
6214,0,1,1.2015382698297314,0.768798320107994,10,10,4,4,6,6,4
6215,1,1,1.6408634188092925,0.8376523887234287,16,21,9,6,15,8,8
6216,0,1,0.7671313396501986,0.6829000184558001,22,32,20,8,24,10,12
6217,1,1,1.5174722963272314,0.8201659617536924,22,26,11,10,16,9,13
6218,0,1,1.6407228020060662,0.8376332652148654,31,45,25,12,33,16,15
6219,1,1,0.43112206253315666,0.6061415747493842,15,19,9,6,13,8,7
6220,1,1,2.2104233356682847,0.9011816326622785,5,5,4,0,5,5,0
6221,1,1,0.409640483157132,0.6010016703215861,12,16,10,5,11,6,6
6222,0,0,4.6211202047794675,0.00974584873768003,22,31,17,4,27,4,18
6223,0,0,2.3903303172408816,0.08391303637981207,32,47,26,9,38,9,23
6224,1,0,0.7142426580532193,0.328662046516654,16,20,13,3,17,5,11
6225,1,1,1.988636348079356,0.8795987950498659,11,12,7,4,8,5,6
6226,0,1,2.634226018434232,0.9330320883243989,14,18,10,4,14,10,4
6227,0,0,5.025393878750167,0.006526128467603809,12,13,6,0,13,0,12
6228,1,1,3.51752824660513,0.9711824072759796,13,17,9,3,14,10,3
6229,0,0,1.231895643654102,0.2258498159805039,17,23,10,7,16,7,10
6230,1,1,2.12064392817404,0.8928935269577991,14,17,10,3,14,9,5
6231,1,1,3.0888435470909847,0.9564301993775781,10,13,7,2,11,8,2
6232,1,1,2.672153460849131,0.935363349080951,14,20,13,4,16,12,2
6233,0,0,1.1205559590795628,0.24590817341299065,19,23,10,4,19,5,14
6234,1,1,3.0038646081121634,0.9527484118628871,9,13,6,1,12,8,1
6235,1,0,1.2725256697035345,0.21882520566219543,10,11,5,2,9,3,7
6236,0,0,2.3596826139061813,0.08629921763130222,22,30,18,6,24,7,15
6237,1,1,1.678601309124478,0.8427192325464326,8,10,6,1,9,7,1
6238,1,1,2.4325873541317984,0.9192787366799898,32,47,26,16,31,16,16
6239,0,0,0.5016796382860809,0.3771460288310011,11,13,8,6,7,5,6
6240,0,1,0.948952747901272,0.7209045184042657,9,10,4,3,7,5,4
6241,1,1,5.626820100687844,0.9964129087475213,9,13,10,0,13,9,0
6242,1,1,3.7632640992231883,0.9773185247515364,9,12,8,0,12,9,0
6243,1,1,2.537354594166185,0.9267193782278181,9,13,9,0,13,9,0
6244,1,1,0.7285248984394896,0.674481488267594,21,27,11,9,18,11,10
6245,0,0,4.428819487527843,0.011787949876899462,32,46,28,3,43,8,24
6246,0,0,2.890020644502635,0.052649088736587024,10,10,5,1,9,1,9
6247,1,1,2.445394260984176,0.9202239889630791,17,22,14,5,17,12,5
6248,0,0,0.868997769763423,0.29546288805178467,19,24,13,7,17,8,11
6249,0,0,1.8705387324177802,0.13347939900996375,10,11,5,2,9,3,7
6250,0,0,2.6094396558427686,0.06853336551133893,27,42,27,7,35,9,18
6251,1,1,0.09731403917083137,0.5243093286630496,30,47,31,13,34,14,16
6252,1,1,1.3593198290857482,0.7956491298826909,8,9,4,1,8,6,2
6253,1,1,1.4096529955351398,0.8037112061515019,10,12,6,4,8,6,4
6254,0,0,4.837134947348758,0.007867354579904728,40,61,39,8,53,11,29
6255,1,1,0.42880380306315047,0.6055879915028184,24,35,21,13,22,12,12
6256,1,1,0.30386713882943184,0.5753875977937022,31,46,27,12,34,14,17
6257,1,1,2.5998179842017253,0.9308498645107414,20,30,20,6,24,14,6
6258,1,1,3.1049128721328527,0.9570949419483069,10,16,11,0,16,10,0
6259,0,0,0.26503629089787273,0.4341260818384839,14,17,9,4,13,5,9
6260,1,1,1.0865771336610703,0.7477366257409647,26,38,23,13,25,14,12
6261,1,1,2.483084519052052,0.9229474412309123,12,15,10,2,13,9,3
6262,0,0,0.23656529716883012,0.44113295205682146,12,15,7,3,12,4,8
6263,0,0,6.51601376343296,0.0014773693703880042,22,28,14,1,27,2,20
6264,0,0,2.3822094633914266,0.08453941279480848,18,25,13,2,23,2,16
6265,0,0,3.251563922283478,0.03727073064629072,26,34,18,8,26,9,17
6266,0,0,0.7403360087397121,0.3229306722716718,10,11,6,2,9,3,7
6267,0,0,1.919496508049282,0.12791772273079016,6,5,1,1,4,1,5
6268,0,0,2.9330992027535747,0.05054139626877496,10,12,6,0,12,0,10
6269,0,0,2.632905556271793,0.06705046558336425,22,28,18,6,22,6,16
6270,1,1,1.3133978810625275,0.788081188854111,18,25,15,6,19,10,8
6271,0,0,2.5449087986106433,0.07276926223773206,12,15,10,3,12,4,8
6272,0,0,4.730123453281019,0.008748175464705965,15,17,9,4,13,4,11
6273,0,1,1.0709794917450335,0.7447831434418039,30,46,28,15,31,14,16
6274,0,1,0.35077237291996655,0.5868048647994709,13,16,9,4,12,8,5
6275,0,0,2.1077713319036055,0.1083437802917675,6,6,2,0,6,0,6
6276,0,0,1.152972094057913,0.2399466367164237,4,3,0,0,3,0,4
6277,0,0,0.7689728592553895,0.31670133930512157,12,16,10,4,12,4,8
6278,1,1,3.757652078062664,0.9771937891283176,14,18,8,3,15,9,5
6279,0,0,3.274061845670637,0.03647181935638033,10,10,5,3,7,3,7
6280,1,0,0.8699669220319093,0.2952611848856329,27,35,22,9,26,14,13
6281,0,1,0.7395876638117931,0.6769056830873452,19,27,16,7,20,9,10
6282,1,1,0.8588020569749759,0.7024103089668483,15,19,11,3,16,9,6
6283,0,0,1.2472676312139956,0.22317348329373543,6,6,2,0,6,0,6
6284,0,0,0.3341846404346054,0.4172227854007621,16,20,10,5,15,6,10
6285,0,0,1.272767371304254,0.21878389182081692,4,3,1,0,3,0,4
6286,0,0,1.1121220480191898,0.24747548491589932,14,18,12,3,15,4,10
6287,1,1,2.282946836913762,0.9074548212466548,11,16,13,0,16,11,0
6288,1,1,3.2565691598751085,0.9629084500343534,9,13,9,0,13,9,0
6289,0,0,0.6704527560424196,0.33839546855896196,13,16,10,4,12,4,9
6290,0,0,4.3242077313911516,0.013070926914335645,22,33,19,7,26,6,16
6291,0,0,4.325504974296267,0.013054202946250482,16,18,8,5,13,5,11
6292,0,0,1.8595199799820827,0.13475901200386975,24,34,19,5,29,5,19
6293,1,1,1.0536968044025892,0.7414841549823497,8,9,6,2,7,6,2
6294,0,0,0.8221490251306518,0.30530767201807507,14,19,13,5,14,7,7
6295,0,0,0.6382304561512417,0.3456466566635715,14,15,7,5,10,7,7
6296,0,0,5.10218185715018,0.0060466741434132,19,26,16,7,19,6,13
6297,1,1,4.930026060204235,0.9928255300200649,10,15,10,0,15,10,0
6298,1,1,2.670492869826338,0.9352628792036873,9,13,8,0,13,9,0
6299,0,0,0.7100397272818539,0.32959006197350893,25,39,26,8,31,9,16
6300,0,0,5.384335991001626,0.004566933141150975,17,25,17,2,23,1,16
6301,0,0,2.7931363897443813,0.05769620134213771,21,26,15,2,24,3,18
6302,0,0,6.948627271200342,0.0009590313793158556,36,53,35,12,41,12,24
6303,0,0,1.1929209669066623,0.2327369302508593,6,6,2,2,4,1,5
6304,1,1,2.227047452534483,0.9026522234246628,20,26,17,5,21,12,8
6305,0,0,0.4911458864741882,0.37962366326284935,11,13,8,5,8,5,6
6306,1,1,3.13418659774592,0.9582810881083973,23,33,16,7,26,13,10
6307,0,0,4.554179943032896,0.010413543227543176,12,15,9,0,15,0,12
6308,0,1,1.241817966227464,0.7758802990692154,21,29,17,10,19,12,9
6309,1,1,2.9755822397150373,0.9514587434622255,7,7,2,1,6,6,1
6310,0,0,5.023860546296249,0.006536077413026087,14,19,12,2,17,1,13
6311,1,1,1.0185131612504161,0.7346828801374868,17,23,16,5,18,8,9
6312,0,0,8.347622428399413,0.00023690310038604334,28,37,21,6,31,8,20
6313,1,0,1.9757787240391014,0.12176954814584418,14,20,12,6,14,5,9
6314,1,1,1.1896590274159498,0.7666800760067038,17,21,11,6,15,8,9
6315,1,1,0.5354955109936856,0.6307639380299818,31,47,27,15,32,16,15
6316,0,1,0.6385778982074433,0.654431921844399,8,8,4,2,6,4,4
6317,0,0,1.947931301732313,0.1247791039254107,26,33,19,6,27,7,19
6318,1,1,0.10031504963160953,0.5250577526896019,5,4,0,2,2,3,2
6319,0,1,0.5567419245289078,0.6356983498592577,17,20,11,4,16,7,10
6320,1,0,1.1462091161902404,0.24118218448698991,24,36,20,8,28,8,16
6321,0,0,2.156558182523302,0.10371997406013966,7,8,4,0,8,0,7
6322,0,0,0.6394936242014109,0.3453610153031553,18,23,13,6,17,8,10
6323,1,1,0.44004948298339386,0.6082708214877546,19,24,13,6,18,7,12
6324,0,0,0.6714793198025528,0.3381656755255604,4,3,1,1,2,1,3
6325,0,1,2.5267063963299288,0.9259929591857736,10,13,7,2,11,8,2
6326,0,0,4.66404167170243,0.0093402171068524,45,71,45,14,57,19,26
6327,0,1,0.16172734579109505,0.5403439393108267,15,20,11,7,13,7,8
6328,1,0,1.008138658192364,0.2673442763068773,15,19,12,3,16,5,10
6329,0,0,0.8417092589410514,0.30117491647371275,10,12,8,1,11,1,9
6330,1,1,1.149385593266184,0.7593986751570619,8,9,5,2,7,6,2
6331,1,0,0.5075994462145634,0.3757564397586375,6,6,3,3,3,3,3
6332,1,1,2.4872837171468802,0.9232455392711649,9,11,5,2,9,6,3
6333,1,1,1.1855404642418657,0.7659425312404924,8,10,5,1,9,6,2
6334,1,1,4.000812400626683,0.9820281336139395,12,17,9,2,15,10,2
6335,1,1,1.4004989280825244,0.802263048973713,15,19,8,6,13,7,8
6336,1,1,2.147016561389421,0.8953896565416691,28,44,25,12,32,16,12
6337,0,0,2.9677655028717362,0.04890354921425444,26,36,20,8,28,9,17
6338,0,0,2.8365728428680352,0.05537954851967597,16,19,10,2,17,3,13
6339,1,0,0.41709539602122736,0.39721200484561636,9,11,6,4,7,4,5
6340,1,1,0.8218235150649815,0.6946232845829675,38,63,43,18,45,20,18
6341,1,1,5.381123644893812,0.9954184400223919,19,27,13,4,23,14,5
6342,0,0,1.7255405777713797,0.1511588779639833,8,9,4,3,6,2,6
6343,0,0,3.4680410005129687,0.030235368854489852,9,12,8,0,12,0,9
6344,0,0,1.356467604469099,0.20481500893245785,10,10,4,1,9,2,8
6345,1,1,1.1248231646959483,0.7548822676167124,9,11,4,3,8,6,3
6346,1,1,4.718886044486744,0.9911538378222645,17,25,18,2,23,15,2
6347,0,0,2.0008190179352607,0.11911695720806514,11,13,9,2,11,3,8
6348,1,1,6.677677031613548,0.9987428838343055,33,50,32,10,40,21,12
6349,0,0,2.473167805982481,0.077760754947088,8,9,4,0,9,0,8
6350,1,1,3.393102994799504,0.9674882901717665,18,29,23,1,28,17,1
6351,1,0,1.6397152485174673,0.16250381248632928,14,16,9,4,12,4,10
6352,1,1,1.7866624681973575,0.8565175977256491,19,25,14,5,20,12,7
6353,0,1,0.30316882212648366,0.5752169783790043,25,38,23,10,28,12,13
6354,1,1,2.3008207206446363,0.9089449879078588,6,7,3,1,6,5,1
6355,0,0,4.423827017380859,0.011846249108787843,19,23,12,1,22,1,18
6356,1,0,0.4534018459473925,0.3885522517829463,23,31,16,8,23,9,14
6357,1,1,2.9412404843265914,0.9498478526356656,16,22,14,3,19,13,3
6358,0,0,0.7062561553061741,0.3304266201311098,9,10,5,5,5,4,5
6359,1,1,4.103841673102565,0.9837589941513654,20,29,19,5,24,14,6
6360,0,0,0.9000070194727645,0.28904905487332155,7,8,5,3,5,2,5
6361,1,1,4.702289667996527,0.9910071298224711,22,31,20,4,27,15,7
6362,1,1,0.7639676482714055,0.6822145326563636,6,6,3,1,5,4,2
6363,0,0,1.417501937865992,0.19505349965586094,12,13,9,1,12,2,10
6364,0,0,1.838707445003112,0.13720423250218183,32,50,31,6,44,9,23
6365,0,0,3.2894862125857003,0.03593364047587211,7,6,2,1,5,2,5
6366,1,1,4.331909867553136,0.9870280595138017,14,20,13,1,19,13,1
6367,1,1,2.023687297024978,0.8832617455475201,17,22,10,5,17,10,7
6368,0,0,0.14097925157979152,0.46481344597749663,5,4,0,2,2,2,3
6369,0,0,0.7264826139584424,0.325967067656206,8,7,2,1,6,2,6
6370,1,1,1.1887305244158064,0.7665139426522874,24,36,22,13,23,12,12
6371,1,1,1.223215288504461,0.7726288854578487,10,13,7,2,11,7,3
6372,0,0,4.628898583967642,0.009671066184876898,21,28,14,7,21,7,14
6373,1,0,1.1520227235372857,0.24011981829596063,31,47,27,14,33,15,16
6374,0,0,2.1566860451653675,0.10370808827743594,6,5,1,1,4,1,5
6375,1,1,1.8871131406537933,0.8684260221624303,8,9,5,1,8,7,1
6376,1,1,1.3998819311414739,0.8021651521454036,7,6,1,3,3,4,3
6377,1,1,1.4102397149224006,0.8038037502172052,19,25,16,6,19,10,9
6378,1,1,4.475523779397393,0.9887438847934861,15,22,15,1,21,14,1
6379,1,1,0.5374234341854986,0.6312128395608663,18,25,13,7,18,10,8
6380,0,0,6.454060715931535,0.0015716431800545383,28,36,20,3,33,4,24
6381,0,0,1.3046969672465742,0.21337558636860676,5,4,3,0,4,0,5
6382,1,1,3.3260575411262674,0.9653119993904994,43,69,46,17,52,22,21
6383,0,0,1.1081191311984115,0.24822170690716872,23,31,20,5,26,8,15
6384,0,0,3.8035239790732858,0.021805975982169934,14,16,8,3,13,3,11
6385,1,1,1.3929193552391717,0.8010578926300613,13,16,10,3,13,7,6
6386,0,0,2.0841770324840203,0.11064426891517998,17,20,10,4,16,4,13
6387,0,0,4.65128125574805,0.00945903123373193,14,17,11,5,12,4,10
6388,1,0,0.9047682406810567,0.2880716089270099,15,20,10,5,15,5,10
6389,0,0,1.9814353113819738,0.12116591601275306,14,20,12,6,14,5,9
6390,1,1,2.7558023276907004,0.9402402082739469,6,7,3,0,7,6,0
6391,0,0,5.967397449797396,0.002554356173663508,21,29,17,6,23,6,15
6392,1,0,3.9093172424523512,0.019659924700553777,38,63,37,14,49,12,26
6393,1,1,1.7139154436816728,0.8473434458773658,13,19,12,2,17,11,2
6394,0,0,5.281281686269272,0.0050601725028137645,23,31,19,5,26,6,17
6395,1,1,0.33694164188906117,0.5834474204266391,5,4,1,2,2,3,2
6396,0,0,4.864586968539048,0.007655948327895068,15,18,11,2,16,3,12
6397,0,0,1.1262132012519621,0.2448606180638142,26,38,21,8,30,10,16
6398,0,0,3.2654666591980055,0.03677507451794748,13,15,9,2,13,3,10
6399,1,1,4.401244235705874,0.9878864635760883,10,12,6,1,11,8,2
6400,0,0,2.568222375927728,0.07121178774988501,10,11,6,2,9,3,7
6401,1,0,2.5596994433417035,0.07177756443801175,29,42,28,8,34,14,15
6402,1,1,0.8867729543213443,0.7082237749818329,9,11,8,2,9,7,2
6403,0,0,4.801452467933616,0.00815082045121962,10,12,7,3,9,1,9
6404,0,1,0.8265473047865421,0.6956243810242939,8,8,4,1,7,5,3
6405,1,1,1.8571033389524814,0.8649589612232578,11,14,9,3,11,6,5
6406,0,0,7.798790958466186,0.0004100624449898671,30,47,29,6,41,6,24
6407,0,0,3.256670873062455,0.037087917372197854,11,11,6,3,8,4,7
6408,1,1,1.126751846266562,0.7552389658096552,22,32,19,7,25,9,13
6409,1,1,2.674298117317921,0.9354928913355253,30,44,25,11,33,15,15
6410,1,1,3.5048597091135374,0.9708257268316367,15,20,12,3,17,11,4
6411,0,1,0.5641206278720428,0.6374054369269093,23,35,19,10,25,11,12
6412,0,1,2.895892116055312,0.9476429955722111,9,11,7,3,8,5,4
6413,0,0,2.713842494058939,0.06216146666792022,7,7,4,3,4,3,4
6414,0,0,1.6494657768529606,0.16118116443292718,15,20,12,3,17,4,11
6415,1,1,7.466305730450831,0.9994282893804965,26,46,33,3,43,24,2
6416,1,1,3.6762927874948828,0.9753084521045885,24,38,26,4,34,18,6
6417,1,0,0.3655077774428306,0.4096269452415363,22,28,16,5,23,8,14
6418,0,0,1.5396650627053392,0.17658397008028415,5,4,2,0,4,0,5
6419,1,1,1.4763875664893482,0.8140263238121239,11,14,7,3,11,8,3
6420,0,0,3.9906836082152433,0.018151503730639673,13,15,6,3,12,4,9
6421,0,0,5.919313727100064,0.002679842735292981,16,18,9,2,16,2,14
6422,1,1,3.943923619657317,0.9809960880107635,17,25,17,4,21,14,3
6423,0,0,3.6607029497715393,0.025069775422915885,17,23,13,1,22,2,15
6424,1,0,0.27955826334441625,0.43056207701239324,14,15,9,3,12,5,9
6425,0,1,1.5904497998350244,0.8306793773400972,5,4,2,0,4,5,0
6426,0,0,2.2142541624202607,0.09847774348968763,7,6,2,2,4,3,4
6427,0,0,3.386376555837513,0.03272395454805954,11,12,5,2,10,2,9
6428,1,1,3.003676270160347,0.9527399323770537,9,11,6,2,9,7,2
6429,1,1,2.096446147697938,0.8905572830204047,16,24,14,3,21,12,4
6430,1,1,1.3266055692097756,0.7902786018131163,4,3,1,0,3,4,0
6431,0,0,4.691584694141271,0.009088776074556604,28,37,23,6,31,7,21
6432,0,0,1.140704043389876,0.24219112123420894,29,41,28,12,29,13,16
6433,0,0,2.4037406726325563,0.08288789590317291,10,11,6,0,11,0,10
6434,1,1,3.812840645596723,0.9783918700741134,20,31,24,6,25,17,3
6435,1,1,4.775888848119875,0.991639893363824,13,20,14,0,20,13,0
6436,0,0,2.632013570644174,0.06710628503020133,12,15,9,2,13,3,9
6437,1,1,3.9170875040803717,0.9804892771267977,9,11,6,1,10,8,1
6438,1,1,2.9460990746507,0.9500787956536672,11,14,10,1,13,10,1
6439,0,1,3.1921212561142664,0.9605367072574247,48,85,55,20,65,27,21
6440,1,1,3.4325759980400252,0.9687072496574981,12,15,9,2,13,8,4
6441,0,0,2.1660873928554176,0.10283745753379181,18,21,12,4,17,6,12
6442,1,1,1.4875415743990787,0.815708989589023,7,8,3,2,6,5,2
6443,1,1,0.4034005001612462,0.5995043919451553,18,25,18,7,18,11,7
6444,0,0,8.741380155140686,0.00015980759853040372,30,42,27,5,37,5,25
6445,0,0,2.156015241642131,0.10377045786759764,3,2,1,0,2,0,3
6446,1,1,3.799867759385638,0.9781158986076877,19,29,19,3,26,16,3
6447,1,1,2.962443519729162,0.9508483196382641,17,22,12,5,17,8,9
6448,1,1,5.287836049452733,0.9949727190603175,11,15,8,1,14,10,1
6449,0,0,2.2203651819547963,0.09793653757067078,12,14,8,2,12,3,9
6450,0,0,0.29693443600602487,0.42630705625846277,9,8,2,2,6,3,6
6451,1,1,4.406694801112923,0.9879515162420786,23,35,22,7,28,15,8
6452,1,1,7.6242705467961045,0.9995117870522533,19,28,15,2,26,16,3
6453,1,1,0.03863010538745293,0.5096563255442143,16,21,11,7,14,5,11
6454,1,1,2.232908184661688,0.9031659990160377,11,14,8,1,13,9,2
6455,1,1,2.837145796371578,0.9446504165644545,16,22,11,5,17,10,6
6456,0,0,1.7339251714158008,0.15008619559356462,36,50,30,9,41,12,24
6457,0,0,0.5230510081114397,0.3721390831526762,25,38,23,7,31,11,14
6458,1,1,3.565490191177013,0.9724948144562741,7,8,4,0,8,7,0
6459,0,0,1.6532189238126833,0.1606743772649677,11,11,7,1,10,2,9
6460,1,1,2.1685214293747976,0.897386894342781,7,9,4,1,8,6,1
6461,0,1,3.143990397146558,0.9586712725731312,21,30,19,5,25,13,8
6462,1,1,0.8449317558934527,0.6995028830421024,29,44,31,8,36,17,12
6463,0,0,0.8284708240989074,0.3039685034307723,15,19,9,3,16,4,11
6464,0,0,0.7251059432540482,0.3262696119088886,5,5,3,2,3,1,4
6465,1,0,1.120443300057079,0.24592906520088031,6,6,2,2,4,1,5
6466,0,0,2.5768769721963207,0.07064148690226302,7,8,5,0,8,0,7
6467,0,0,2.298935362073662,0.09121117225746889,14,17,9,2,15,2,12
6468,0,0,2.499082992818952,0.07592249064126999,6,5,1,1,4,1,5
6469,1,1,3.511342438910428,0.9710087787039576,11,14,8,2,12,8,3
6470,0,1,2.4499592236618275,0.920558468870132,17,24,15,4,20,11,6
6471,0,0,0.6980718452593744,0.3322398631057636,12,15,8,4,11,5,7
6472,1,1,4.1299091502969665,0.984170270734111,15,23,17,0,23,15,0
6473,0,0,3.1373255542786374,0.041593601657477164,15,19,12,2,17,3,12
6474,0,0,2.089790170366329,0.11009313024234291,5,5,2,0,5,0,5
6475,1,1,5.668340730416027,0.9965582952773268,13,20,12,0,20,13,0
6476,0,0,2.904673603296061,0.051923013161371045,3,2,1,0,2,0,3
6477,1,1,2.5219098548712644,0.9256635798187094,18,26,16,6,20,13,5
6478,0,0,2.0567450383648715,0.11337260487765444,18,21,10,3,18,4,14
6479,0,0,1.7686316814830874,0.1457125752433125,21,27,15,4,23,5,16
6480,1,1,2.1635402584201415,0.8969273011166274,15,20,8,7,13,8,7
6481,1,1,1.4197894843695658,0.8053054120776824,6,6,4,1,5,5,1
6482,1,1,1.8057128359607433,0.8588429330129761,9,11,6,2,9,7,2
6483,1,1,1.1299632764847192,0.7558321218364636,13,16,7,4,12,7,6
6484,1,1,3.1154983868892576,0.9575275306353994,5,6,3,0,6,5,0
6485,0,0,2.138714958980927,0.10539048604746992,11,12,6,2,10,3,8
6486,1,1,5.46311992825575,0.9957775986358031,22,32,16,10,22,11,11
6487,0,0,5.1307261379888,0.005877516354914958,9,10,5,0,10,0,9
6488,0,0,8.487569747478403,0.00020597088387486195,22,29,19,4,25,4,18
6489,0,0,4.585618547701339,0.010094502150983842,20,26,17,3,23,4,16
6490,0,1,0.2778141678464179,0.5690102568031323,30,46,30,12,34,16,14
6491,0,0,1.129490122705896,0.244255209227754,20,30,19,7,23,6,14
6492,1,1,3.9853076461852073,0.9817524371306617,8,12,6,0,12,8,0
6493,0,1,0.995662698447275,0.7302049592525195,9,9,4,2,7,6,3
6494,0,0,3.1811547490348713,0.039881094427297814,22,29,18,5,24,7,15
6495,0,0,0.4293555977904262,0.39428021935939417,30,47,29,11,36,15,15
6496,0,0,1.7034343873826927,0.15401724645817494,20,29,18,8,21,8,12
6497,1,0,0.9734090147040058,0.27420153498983457,15,19,10,6,13,6,9
6498,0,0,0.11939309505057016,0.47018713231126863,11,12,7,5,7,5,6
6499,1,0,2.3429627872320093,0.08762675542387877,12,12,5,3,9,4,8
6500,1,1,5.886845759816086,0.9972319650996806,34,52,33,11,41,21,13
6501,0,0,5.296022317797746,0.004986498641743831,21,28,16,6,22,6,15
6502,1,1,0.12633212096156088,0.531541092254891,12,15,9,3,12,8,4
6503,1,1,0.7054037365929828,0.6693847593492861,15,18,8,4,14,9,6
6504,1,1,1.5833165793873243,0.8296737137812891,8,10,5,1,9,7,1
6505,0,0,0.5957032773144917,0.3553273303007126,2,1,0,0,1,0,2
6506,0,0,1.9927320993955202,0.11996811935319296,9,9,3,2,7,3,6
6507,1,1,1.8409343697727276,0.8630591762179947,12,15,8,2,13,9,3
6508,1,1,5.163361969940752,0.9943101311921002,20,30,21,3,27,17,3
6509,0,0,4.587580266802604,0.010074918297938495,19,27,15,6,21,3,16
6510,0,0,5.6749207924971845,0.003419209616273511,39,60,36,13,47,14,25
6511,1,1,3.144890470384687,0.9587069193534763,14,19,12,3,16,11,3
6512,1,0,0.19378049382263418,0.45170590585858017,19,25,16,6,19,9,10
6513,1,1,5.241306473928292,0.9947345351683211,20,28,19,3,25,16,4
6514,1,1,6.0718810771621445,0.9976984794143944,21,30,20,3,27,17,4
6515,1,1,0.779879358352324,0.68565411231863,9,10,4,4,6,4,5
6516,1,1,3.1315297325510913,0.9581747413469311,12,15,6,3,12,8,4
6517,1,1,0.8313705030370602,0.6966446374771447,24,39,24,9,30,14,10
6518,1,1,7.617194186361858,0.9995083217336407,12,18,11,0,18,12,0
6519,0,0,3.8824794088698042,0.020183904651779994,14,18,10,4,14,4,10
6520,0,0,0.9502452941630062,0.2788354940151686,18,24,11,5,19,5,13
6521,0,1,2.8940534334067416,0.9475516928331865,8,9,4,1,8,6,2
6522,0,0,5.179907897131556,0.005597021817737469,22,29,17,7,22,6,16
6523,0,0,0.7403574909252835,0.32292597528585687,24,33,22,7,26,9,15
6524,1,1,4.716192221721814,0.9911301873560013,8,11,8,0,11,8,0
6525,1,1,0.6508351134150425,0.6571986288894391,17,23,13,7,16,9,8
6526,0,1,2.965050503821218,0.9509700160010293,19,29,19,6,23,14,5
6527,0,1,0.7227711312264247,0.6732169469264999,8,8,4,1,7,6,2
6528,1,1,1.2609522730164642,0.7791899927184637,12,14,8,3,11,6,6
6529,0,0,3.3436967018596375,0.034102181268022336,18,23,12,6,17,5,13
6530,0,0,3.3466884116387803,0.03400377391057885,35,57,38,13,44,13,22
6531,0,0,10.46510549832046,2.8513468248392293e-05,25,36,23,2,34,3,22
6532,0,0,8.03081578533124,0.0003251769653104253,22,29,18,2,27,3,19
6533,1,1,3.880521970116275,0.979777347652169,30,43,31,6,37,21,9
6534,0,0,0.9928330740463835,0.27035285580243407,6,6,3,1,5,2,4
6535,0,1,2.2150778608398936,0.9015953601731814,19,26,14,7,19,11,8
6536,0,1,0.11027938370427637,0.5275419388771767,13,17,10,6,11,5,8
6537,0,0,5.348524886954046,0.004732655691213172,16,19,12,2,17,2,14
6538,1,1,2.719502633567829,0.9381676882556533,6,8,4,0,8,6,0
6539,0,1,1.0076899489243056,0.7325678252444152,9,10,7,1,9,5,4
6540,0,1,1.5548775428523232,0.8256170844996854,10,13,8,1,12,6,4
6541,1,0,3.0231359425425985,0.04639154488186381,25,37,22,9,28,8,17
6542,1,1,1.0264714330200215,0.7362312378788349,16,19,9,3,16,10,6
6543,1,1,0.7418073515824937,0.6773909477727196,10,11,8,2,9,7,3
6544,0,0,0.01088081580172462,0.4972798228868178,12,16,8,5,11,6,6
6545,1,1,0.28956763321035983,0.5718902790893383,12,16,9,3,13,6,6
6546,1,1,2.5332939303231834,0.9264431379429154,6,7,5,0,7,6,0
6547,1,0,1.1867186060296167,0.23384632407687267,35,54,34,12,42,14,21
6548,0,1,0.8256746250881821,0.6954395760527603,5,4,2,1,3,3,2
6549,1,1,2.3792214867678627,0.9152290529717053,8,11,5,1,10,7,1
6550,0,0,6.895077231550854,0.0010117341120043921,15,18,10,0,18,0,15
6551,1,1,4.318028618627391,0.9868491217480068,25,38,21,8,30,17,8
6552,1,1,1.7952420571482894,0.8575687663116595,28,43,26,11,32,14,14
6553,0,0,0.4432567270855938,0.39096523056921895,9,10,6,2,8,3,6
6554,1,1,4.3745933231527525,0.9875633553423795,18,24,11,4,20,11,7
6555,0,0,1.61356299500695,0.1660945260519514,27,43,27,10,33,10,17
6556,0,0,3.4267110598174844,0.03147102679018443,13,15,7,1,14,2,11
6557,1,1,4.058446093303689,0.9830175429497345,15,21,13,2,19,13,2
6558,0,0,1.0713447291002267,0.2551474380058669,20,25,12,6,19,7,13
6559,1,1,2.3002614817148834,0.908898692472365,8,9,7,1,8,7,1
6560,0,0,2.313624103959026,0.0900008865895845,13,16,9,6,10,5,8
6561,1,0,0.6912645641591451,0.33375182371938594,21,28,15,8,20,8,13
6562,1,1,1.2548574615516674,0.7781395782941931,12,13,6,4,9,7,5
6563,0,0,1.3159577574749628,0.21149160343943407,12,14,7,4,10,4,8
6564,0,0,4.1256588154955285,0.01589608231189088,42,66,39,13,53,14,28
6565,1,1,1.2050480169813023,0.769421580128225,11,13,4,4,9,7,4
6566,0,0,0.8013627563384126,0.30973408757104537,6,5,1,1,4,1,5
6567,0,0,0.631290678309461,0.3472179380477818,25,37,24,9,28,11,14
6568,1,1,2.151170779220483,0.895778131102612,16,22,15,5,17,11,5
6569,1,1,9.827061007258168,0.9999460317677915,15,23,14,0,23,15,0
6570,1,0,1.9466637328397831,0.12491760006319419,29,41,25,7,34,8,21
6571,1,0,2.619722357625687,0.06787985850873568,23,35,20,8,27,7,16
6572,1,0,1.1598081118289274,0.23870215398637218,34,50,29,8,42,12,22
6573,0,0,3.4818173025624906,0.029834034894305583,27,41,27,7,34,7,20
6574,0,0,3.3626358468752593,0.03348381531935252,20,27,17,4,23,4,16
6575,0,1,2.730865301784328,0.9388235537014766,16,23,14,4,19,12,4
6576,0,1,1.208313873608117,0.7700004724464222,29,40,22,10,30,16,13
6577,1,1,1.0745654522548287,0.7454641686422414,10,12,7,2,10,5,5
6578,1,0,3.263729543041456,0.036836657346261736,24,37,24,8,29,8,16
6579,1,1,4.007960964909919,0.9821538639774895,17,25,14,2,23,14,3
6580,0,0,6.50457508243829,0.0014943401508681342,11,11,3,2,9,2,9
6581,0,0,2.3243279719661727,0.08912807077035423,13,14,6,2,12,2,11
6582,1,1,1.1543681189552992,0.7603078670460925,9,10,4,2,8,6,3
6583,0,0,2.396017598350103,0.08347687906101753,15,18,12,3,15,4,11
6584,0,0,6.043104390555987,0.0023685537225979214,17,23,17,2,21,3,14
6585,1,1,0.04986451995098795,0.5124635475746384,8,8,3,2,6,5,3
6586,1,1,0.9621254587936889,0.7235471555085153,5,4,2,1,3,4,1
6587,1,1,0.7905984514433553,0.6879598152659192,6,6,4,1,5,5,1
6588,0,1,1.830553068755734,0.8618275998712818,31,44,25,11,33,15,16
6589,0,1,0.7046053966773318,0.6692080558122906,46,77,52,19,58,23,23
6590,1,0,0.5782921513854635,0.35932566421267675,18,25,14,3,22,4,14
6591,0,1,0.4120754485573894,0.6015854279128412,12,16,10,5,11,5,7
6592,1,1,10.312336618574088,0.9999667803782065,27,46,33,2,44,25,2
6593,0,0,1.6144082926700327,0.1659774793382135,13,17,8,2,15,3,10
6594,0,0,8.502265787770062,0.00020296667092412068,43,65,42,12,53,13,30
6595,0,0,4.486994732505787,0.011129163337744163,22,30,19,9,21,8,14
6596,0,0,0.9258447423911458,0.2837684860626921,14,18,9,5,13,5,9
6597,0,1,0.16161713597519767,0.5403165661163521,15,18,12,3,15,7,8
6598,1,1,1.9529935288581237,0.8757726889666438,21,26,12,6,20,11,10
6599,1,0,1.6285903424499377,0.16402356169707488,17,23,13,5,18,5,12
6600,1,1,2.6155594846676746,0.9318562731488595,7,8,5,1,7,6,1
6601,1,0,0.05425073751572751,0.4864406410517744,17,20,13,6,14,8,9
6602,0,0,6.035299180155256,0.0023870688159663978,35,51,35,10,41,14,21
6603,1,1,6.105838400263656,0.9977751498835723,18,26,17,2,24,16,2
6604,0,0,2.6496134552516155,0.06601283796537605,3,2,0,0,2,0,3
6605,0,0,6.368144989024037,0.0017124009006104224,15,16,7,1,15,1,14
6606,1,1,1.1028582096846677,0.7507952648379401,30,43,26,10,33,15,15
6607,0,0,3.7164199218835083,0.023743421851165514,22,30,15,4,26,6,16
6608,0,0,0.1833817384618177,0.45428261227748823,27,41,23,9,32,11,16
6609,1,1,10.112152391750094,0.9999594182854881,19,33,21,0,33,19,0
6610,1,1,5.7209443713689385,0.9967340860436893,18,27,16,4,23,15,3
6611,0,0,2.0116347460744137,0.11798675025704153,9,9,3,1,8,1,8
6612,1,1,2.4539084220186766,0.9208467967642997,8,8,3,1,7,6,2
6613,0,0,1.0178492168374773,0.26544655869119105,9,9,4,3,6,4,5
6614,1,1,0.3024383892491205,0.5750384928539791,5,4,1,1,3,4,1
6615,0,0,1.7117189555970413,0.15294089223221619,26,36,22,7,29,9,17
6616,1,1,1.1403898801224992,0.7577512142718157,25,34,19,12,22,11,14
6617,1,1,2.8469181913366515,0.9451591613791578,16,24,14,2,22,14,2
6618,0,1,1.1416145782617093,0.7579759541714284,9,10,6,2,8,6,3
6619,0,0,1.972484580423715,0.12212226869902931,20,27,16,5,22,7,13
6620,0,1,1.247959797770654,0.7769464926074434,5,5,2,1,4,4,1
6621,0,0,5.361215501538732,0.004673253779554187,25,34,21,2,32,4,21
6622,1,1,4.883487431917199,0.9924863167329926,7,9,4,0,9,7,0
6623,1,1,1.8605132907333062,0.8653567650437837,5,5,3,0,5,5,0
6624,1,1,3.8716064010349824,0.97959993958491,18,25,16,4,21,14,4
6625,1,1,0.5547521915898113,0.6352374313531673,26,37,24,7,30,11,15
6626,0,0,1.2300472161046239,0.22617316191477,39,59,38,15,44,19,20
6627,0,0,1.5769389215742096,0.17122944234492032,9,9,4,2,7,3,6
6628,1,0,0.22295243182960967,0.4444916349415552,12,13,5,3,10,4,8
6629,1,1,1.764977732547305,0.8538319905813421,10,11,8,2,9,7,3
6630,0,0,5.0165894766762555,0.0065834608681836215,18,24,13,5,19,5,13
6631,0,1,1.7753639536521606,0.8551234635847618,4,3,0,0,3,4,0
6632,0,0,3.2692876489342355,0.036639964172195616,33,49,31,9,40,14,19
6633,1,1,3.374005192928357,0.9668821816566888,12,17,8,2,15,9,3
6634,0,0,4.34386080377786,0.012819811917635482,30,44,27,7,37,9,21
6635,1,1,3.7063525792546255,0.9760220981849229,8,10,5,1,9,7,1
6636,0,0,3.7833455179646696,0.022240570906071566,9,8,3,1,7,1,8
6637,0,0,0.5079085210453035,0.3756839448573349,4,4,2,2,2,1,3
6638,0,0,0.6463730752016876,0.34380732134389036,23,37,23,9,28,11,12
6639,1,1,5.769784887418251,0.9968892781004035,16,24,15,1,23,15,1
6640,0,0,4.797617903152754,0.00818187908697987,21,28,16,6,22,5,16
6641,0,0,6.117217505696452,0.0021997321834038575,19,27,17,5,22,5,14
6642,1,0,0.056250930806776456,0.485940974195202,35,56,36,14,42,17,18
6643,1,1,2.6690716056503607,0.9351767737693469,17,23,13,6,17,11,6
6644,1,1,1.1271939250759655,0.7553206762137179,9,12,6,4,8,7,2
6645,0,0,0.4427196793073984,0.39109311526324053,31,48,34,10,38,13,18
6646,0,0,3.504897628453931,0.029173199192942145,9,9,5,0,9,0,9
6647,1,1,5.063615791254968,0.993717068096536,16,23,14,2,21,14,2
6648,0,0,0.4905152626422531,0.3797721924601326,8,7,2,2,5,3,5
6649,0,0,1.2665278624271987,0.2198522041311486,16,21,13,2,19,6,10
6650,1,1,5.994358114230415,0.9975134219454145,33,52,39,8,44,22,11
6651,1,1,3.779039056534775,0.9776655881658898,9,13,7,0,13,9,0
6652,0,0,2.0271171989105863,0.11638506041664509,14,18,12,2,16,3,11
6653,0,0,6.927707963833498,0.0009792851132625069,17,22,11,2,20,1,16
6654,1,1,3.1615313110018572,0.9593606908217873,8,11,5,1,10,7,1
6655,1,1,1.6081391676167498,0.8331528740105302,9,11,6,1,10,7,2
6656,0,1,0.005830832106226591,0.5014577038965676,21,29,18,7,22,11,10
6657,0,1,1.615696177863541,0.8342007245793068,15,18,9,4,14,7,8
6658,1,0,0.7432983636512867,0.32228330392263294,27,40,24,10,30,12,15
6659,1,1,7.0072225054101915,0.9990954992423422,11,16,11,0,16,11,0
6660,0,1,0.12983965024317246,0.5324143876339718,10,12,7,4,8,6,4
6661,1,1,2.818326325177153,0.9436581474539928,8,11,7,0,11,8,0
6662,0,0,3.418708517312792,0.03171586579572738,10,11,5,1,10,1,9
6663,1,1,3.7547194629172607,0.9771283410674443,17,25,17,4,21,13,4
6664,1,1,5.857634644891556,0.9971501489934032,17,26,17,1,25,16,1
6665,1,1,0.7520990366359448,0.6796358966290463,16,22,14,4,18,7,9
6666,0,1,0.6655424720211589,0.6605043267054773,7,7,3,1,6,5,2
6667,1,0,0.08738309055566118,0.47816811759231803,32,52,36,11,41,13,19
6668,0,0,3.9426402422226685,0.01902785246615779,22,27,15,2,25,3,19
6669,1,1,4.18980025017985,0.9850767660637819,10,13,6,1,12,9,1
6670,0,0,4.077609752720113,0.016665481646958025,11,13,7,0,13,0,11
6671,0,0,2.030716200135697,0.11601545134154023,18,22,10,6,16,7,11
6672,1,1,4.338179670099299,0.9871080913468824,17,22,12,3,19,11,6
6673,1,1,3.122736123142874,0.957820906154111,27,40,26,7,33,17,10
6674,1,0,0.5419718102974302,0.367729008270238,35,56,34,16,40,16,19
6675,0,0,2.152349976164145,0.10411183082631159,8,8,3,1,7,1,7
6676,1,1,2.1356309877899005,0.8943183928210854,21,29,15,9,20,10,11
6677,0,0,2.5935070623277943,0.069557465599551,11,14,9,2,12,3,8
6678,0,0,1.3921051420141914,0.19907189557182148,14,17,9,2,15,2,12
6679,1,0,0.2597033974641521,0.4354366210672628,1,0,0,0,0,0,1
6680,1,1,1.2757577638072704,0.7817267887556885,20,28,16,8,20,11,9
6681,1,1,2.9417446538632905,0.9498718642679106,20,29,21,4,25,14,6
6682,0,1,0.3253606744191053,0.5806301311555376,9,9,3,3,6,6,3
6683,0,0,5.433654096106113,0.004348120062930949,42,62,40,13,49,18,24
6684,0,0,0.26459942927064384,0.4342334046265056,5,4,2,1,3,1,4
6685,1,0,0.4673207714475045,0.3852505767933829,12,14,6,3,11,5,7
6686,1,0,1.220731089553135,0.2278078179829136,15,21,13,4,17,5,10
6687,1,0,0.7509403550895382,0.3206164366912204,21,28,15,8,20,8,13
6688,0,0,2.478095517370363,0.07740810342053084,17,23,15,4,19,7,10
6689,1,0,0.09962583484933552,0.47511412121571717,16,21,11,6,15,8,8
6690,0,0,1.9180504065621782,0.12807912908209518,28,43,26,11,32,10,18
6691,1,1,0.4998168003808643,0.6224162776455191,24,33,19,9,24,12,12
6692,0,0,5.567351953965072,0.003806042824996858,14,14,8,3,11,4,10
6693,1,1,1.1821148061866518,0.7653278384640988,20,29,20,7,22,13,7
6694,1,1,1.4008803922691084,0.8023235563492707,3,2,1,0,2,3,0
6695,1,1,0.09183770263253788,0.5229433022939793,7,6,1,3,3,4,3
6696,0,0,2.788473209197867,0.057950249634621476,13,17,10,1,16,1,12
6697,1,1,0.802684841583094,0.6905485016510804,5,5,2,1,4,4,1
6698,1,1,1.3723047835023934,0.797752270804737,14,18,11,3,15,9,5
6699,1,1,1.688052335339018,0.8439678512701403,3,2,1,0,2,3,0
6700,0,0,1.0433852508329013,0.26049733582507173,5,4,1,0,4,0,5
6701,0,0,1.779307625512748,0.14438864936879403,13,15,9,2,13,3,10
6702,1,1,1.0182414413849816,0.7346299120518291,11,12,7,2,10,5,6
6703,1,1,0.9683087046191226,0.7247822584238086,3,2,1,0,2,3,0
6704,0,0,4.244439918087409,0.014140930921451855,16,19,12,5,14,5,11
6705,1,1,4.5888200650487985,0.9899374392160042,24,33,22,5,28,14,10
6706,1,1,1.5098900820095458,0.8190449164362794,4,4,2,0,4,4,0
6707,0,0,3.198723598786359,0.039213784296031506,17,23,12,5,18,6,11
6708,0,0,1.7521918596650745,0.147770953684506,28,40,23,6,34,10,18
6709,0,0,0.054193208701826645,0.48645501268942637,15,20,11,3,17,5,10
6710,1,1,2.307109823251294,0.909464162202243,6,7,3,0,7,6,0
6711,1,1,2.584848244211125,0.9298800494696603,22,31,18,7,24,13,9
6712,0,0,0.6791346131295994,0.3364544753388278,24,34,19,9,25,9,15
6713,0,0,1.7689567904989092,0.14567211019746573,9,9,3,1,8,1,8
6714,0,0,2.5350462860907768,0.07343753478411041,13,15,9,3,12,3,10
6715,1,0,0.2597033974641521,0.4354366210672628,1,0,0,0,0,0,1
6716,0,1,0.004886942267511518,0.5012217331354054,15,18,7,9,9,7,8
6717,0,0,2.9026097757222686,0.05202470323213082,12,12,5,2,10,3,9
6718,0,0,0.9569743298670257,0.27748439322191876,3,2,1,0,2,0,3
6719,1,1,3.5202973585426456,0.9712598057612256,7,10,5,0,10,7,0
6720,1,1,0.07841849544640489,0.519594583547587,8,7,3,2,5,4,4
6721,0,1,0.9418212397649399,0.719467392522052,18,27,16,7,20,9,9
6722,0,1,0.14310372199713534,0.5357150016319545,15,20,15,5,15,11,4
6723,1,1,1.1097512699747345,0.7520827375663629,22,34,24,5,29,14,8
6724,0,0,2.692698877993389,0.063405555701334,11,13,9,2,11,3,8
6725,0,0,1.1074697797434745,0.2483429006929334,9,9,6,1,8,4,5
6726,0,0,2.889046558879047,0.05269769453975215,12,14,7,1,13,3,9
6727,0,0,1.8196808893724592,0.13947216811171337,12,12,6,4,8,5,7
6728,1,1,1.8586150851991776,0.8651354432747973,15,19,12,3,16,10,5
6729,0,1,0.9508257236225557,0.7212812073905144,13,17,8,5,12,6,7
6730,1,1,0.9496660193893529,0.721048006864307,40,65,40,17,48,17,23
6731,0,0,2.340030951659134,0.08786143427590076,23,31,22,6,25,13,10
6732,0,0,1.722437478528761,0.1515574673779565,23,31,16,7,24,10,13
6733,0,0,2.04300433487846,0.11476116511126078,5,4,1,0,4,0,5
6734,1,1,2.45505262623579,0.9209301553419902,17,24,14,6,18,10,7
6735,0,0,5.00628529319146,0.006651195232895368,19,25,16,4,21,4,15
6736,0,0,3.5761790605390544,0.027220712137938863,20,25,16,4,21,6,14
6737,1,1,1.6432058538093786,0.8379706865873855,5,5,2,0,5,5,0
6738,1,1,4.694277087286505,0.9909354400547029,29,43,26,9,34,18,11
6739,1,1,5.560766657320437,0.9961689068849059,13,17,10,1,16,11,2
6740,0,0,2.414198344925954,0.08209638965768273,8,7,3,1,6,3,5
6741,0,0,1.1205375736081389,0.24591158278190062,13,16,9,2,14,3,10
6742,0,0,1.9953633357739973,0.11969060221170225,5,4,3,0,4,0,5
6743,0,0,6.324456136980729,0.0017887352485386199,23,30,17,4,26,5,18
6744,1,1,1.523136804106425,0.8209999265931964,8,10,6,1,9,7,1
6745,0,0,2.04782287475652,0.11427255258461932,17,20,12,3,17,6,11
6746,1,1,1.9518292014684213,0.8756459606685937,15,18,10,5,13,9,6
6747,0,0,6.744234447552839,0.0011762646591193526,23,30,18,4,26,4,19
6748,1,1,2.0133804817166157,0.8821948001326111,18,24,13,5,19,10,8
6749,1,1,1.688052335339018,0.8439678512701403,3,2,1,0,2,3,0
6750,0,0,0.6770974060704535,0.3369094390696622,16,21,13,6,15,6,10
6751,0,0,2.85974752447566,0.054179636932299324,25,37,23,10,27,9,16
6752,0,0,3.9570137173881705,0.018761406740556263,31,45,26,10,35,12,19
6753,1,1,2.097875621998431,0.890696528981948,19,26,15,6,20,11,8
6754,1,1,5.336496817300196,0.9952103501683095,21,32,22,4,28,18,3
6755,1,1,5.115401322721427,0.9940322597516333,9,14,7,0,14,9,0
6756,0,1,2.2007463018996676,0.900316509020547,16,24,17,4,20,11,5
6757,1,1,4.090633763549077,0.9835466143674259,14,25,18,0,25,14,0
6758,0,1,2.0709809692987924,0.8880505233937132,21,29,19,8,21,12,9
6759,1,1,2.2489429218402055,0.9045593147009312,9,10,7,1,9,8,1
6760,1,1,4.51650922451205,0.9891910097042208,14,19,12,2,17,12,2
6761,1,1,3.2103473134179135,0.9612218135264678,16,22,12,4,18,10,6
6762,0,0,2.5887934872238607,0.06986314415763639,14,17,10,5,12,6,8
6763,0,1,1.548641078166701,0.8247173746379508,7,7,3,1,6,5,2
6764,0,0,2.2787657525595937,0.09289690728833766,15,19,10,4,15,4,11
6765,0,0,5.045674699664807,0.006395944344255278,28,41,21,13,28,12,16
6766,0,0,1.160922551418182,0.2384996931730452,6,5,3,1,4,1,5
6767,1,1,0.9420076197805716,0.7195050088192059,14,17,12,3,14,6,8
6768,0,0,3.8112459906666714,0.021641868605504655,34,52,32,12,40,12,22
6769,1,1,1.7147682202531167,0.8474537220137484,5,6,3,0,6,5,0
6770,0,0,3.3030426456083384,0.035466956009857276,25,34,22,6,28,6,19
6771,1,1,0.735704487389619,0.6760558326563328,21,29,17,7,22,9,12
6772,0,0,3.8745414157740745,0.020341489867935825,19,26,16,1,25,1,18
6773,0,0,3.9705420098862145,0.01851397341917238,13,14,5,3,11,5,8
6774,1,1,1.651856126822983,0.8391417534941151,3,2,0,0,2,3,0
6775,0,0,2.6855379409796827,0.06383214189818853,14,16,8,3,13,3,11
6776,0,0,1.2322272495130389,0.2257918427270248,4,3,1,0,3,0,4
6777,0,1,0.3415687601211266,0.5845715431234049,12,13,7,4,9,4,8
6778,1,1,1.2046208872445503,0.7693457934619505,11,13,8,2,11,7,4
6779,1,1,1.4806538231060455,0.8146713165130641,18,24,14,5,19,11,7
6780,0,1,0.04811114489467094,0.512025466718605,25,36,20,11,25,13,12
6781,0,0,4.344823241292307,0.012807637533262972,21,29,16,8,21,6,15
6782,1,0,3.1925620786370947,0.039446586341834844,18,23,12,7,16,6,12
6783,1,1,2.580053346617537,0.929566761918148,21,31,19,5,26,14,7
6784,0,0,3.4066416670058035,0.03208853975457593,19,25,16,1,24,2,17
6785,0,0,1.216240886504538,0.2285986611979225,8,8,4,0,8,0,8
6786,1,1,0.9708126889564361,0.7252814542981653,12,16,8,3,13,9,3
6787,1,1,1.1529129458966516,0.7600425761345062,10,11,6,2,9,6,4
6788,1,1,2.049128963693341,0.885859575755989,16,21,12,5,16,10,6
6789,0,1,0.04754783520085004,0.5118847198067,15,19,13,7,12,8,7
6790,1,1,0.6981214196337091,0.667771135201753,8,8,4,2,6,4,4
6791,0,0,4.182870004155715,0.015025455462019721,27,40,27,10,30,12,15
6792,1,1,3.734220593191428,0.9766657125504489,10,13,8,1,12,9,1
6793,1,1,1.452412777876326,0.810369485132041,21,31,21,4,27,12,9
6794,1,1,5.599747223133358,0.996314832124628,18,28,17,3,25,16,2
6795,0,1,0.06572987453771262,0.516426554930457,7,7,5,1,6,3,4
6796,1,1,3.5782554520596825,0.972834216238439,28,40,25,10,30,13,15
6797,0,0,1.3045964559407994,0.21339245732003553,10,11,7,2,9,3,7
6798,0,0,2.688368049598878,0.06366323001858842,21,26,13,4,22,6,15
6799,1,1,3.145040626542115,0.9587128633203336,24,34,20,7,27,15,9
6800,1,1,1.3088308006243712,0.787317440744865,30,45,30,10,35,18,12
6801,1,1,1.2172150519664124,0.7715730789990526,12,13,7,3,10,7,5
6802,1,1,1.0943235151780923,0.7491949930814517,14,16,11,3,13,8,6
6803,0,1,2.2690584087631436,0.9062818442396177,14,18,10,5,13,10,4
6804,1,0,0.8811177376467718,0.2929462097611184,27,40,24,9,31,11,16
6805,1,1,0.7428159682117648,0.6776113237892469,10,12,6,3,9,6,4
6806,0,0,8.914523272816917,0.00013440436049938498,22,26,15,2,24,3,19
6807,0,0,3.1450685440845088,0.04128603164744393,28,37,20,6,31,7,21
6808,0,0,3.507618492595713,0.02909623718241261,16,20,11,5,15,6,10
6809,0,0,1.334928100934634,0.2083453678789957,16,21,12,4,17,5,11
6810,1,1,2.987139555172805,0.9519897416370283,12,17,11,1,16,11,1
6811,1,1,2.007166225311808,0.8815474348239467,12,15,10,2,13,9,3
6812,0,0,4.799333980479347,0.008167964976298903,15,18,8,1,17,1,14
6813,0,1,0.4550201803840057,0.6118321617239464,18,27,17,7,20,13,5
6814,1,1,4.359103655552815,0.9873716678106086,22,31,19,5,26,14,8
6815,1,1,2.690040074900524,0.9364363670968912,36,57,37,18,39,19,17
6816,1,1,0.7275002519968834,0.6742564805702043,9,10,5,3,7,4,5
6817,0,0,0.15412002167379768,0.46154608073351233,16,23,13,6,17,6,10
6818,1,1,3.3749072547425754,0.9669110544417854,15,25,16,1,24,13,2
6819,0,1,1.0646752849708838,0.7435829841058301,5,4,1,1,3,4,1
6820,0,0,2.310126754470958,0.09028773307495874,16,22,14,6,16,5,11
6821,0,0,3.169292556572065,0.040337792117296045,19,25,15,3,22,3,16
6822,0,0,2.6575538304625423,0.0655249568068299,24,34,18,7,27,7,17
6823,0,0,3.8126064533092903,0.021613081590981076,20,28,17,5,23,5,15
6824,1,1,2.5711849556418347,0.9289839105120704,9,10,4,2,8,6,3
6825,0,1,1.5667757302343595,0.827323477222714,35,57,36,15,42,19,16
6826,0,0,1.8096522000966968,0.1406801657517065,19,23,12,8,15,8,11
6827,1,1,0.23284266793094477,0.5579490906687531,7,7,3,2,5,4,3
6828,1,1,2.6910111830383614,0.9364941461625969,17,22,12,6,16,9,8
6829,0,0,0.418570649377638,0.39685883172557834,12,14,7,2,12,3,9
6830,0,0,4.08857784529812,0.01648668897894301,9,10,4,0,10,0,9
6831,1,0,0.5805933290765799,0.35879608008256125,11,14,6,6,8,6,5
6832,0,0,2.832915724177999,0.055571173479116553,11,13,8,0,13,0,11
6833,1,1,1.1930018559077735,0.7672775138223252,9,10,5,3,7,6,3
6834,0,0,1.7321464600455672,0.1503132298472889,27,37,19,9,28,11,16
6835,1,1,1.726653815701697,0.8489839059879716,7,8,5,1,7,6,1
6836,0,0,10.716702007835037,2.2171027719175562e-05,41,61,40,13,48,13,28
6837,1,1,5.315632049811083,0.9951098592195592,24,35,26,4,31,19,5
6838,0,1,1.410247300905899,0.8038049465489381,27,41,24,10,31,15,12
6839,1,1,0.48447287768747493,0.6188035219613985,37,58,36,16,42,17,20
6840,0,1,0.2873510421023125,0.5713475008553833,6,5,2,2,3,2,4
6841,1,0,2.502108788039409,0.07571047830514732,25,36,21,10,26,8,17
6842,1,1,2.6646472064439415,0.9349080445164591,25,34,24,9,25,17,8
6843,0,0,0.22692647957063372,0.44351058546081024,10,11,5,3,8,6,4
6844,0,0,3.487429796568979,0.029672015026703913,18,21,9,4,17,5,13
6845,0,0,3.111683971865663,0.04262786713769373,19,26,18,4,22,4,15
6846,1,1,5.074934170238938,0.9937873404676965,36,56,37,13,43,23,13
6847,0,0,5.255434136160551,0.005191982635939119,26,40,27,6,34,6,20
6848,1,1,1.007833375286897,0.7325959232823076,9,10,8,1,9,5,4
6849,1,1,1.1090769602216826,0.7519569882474738,14,20,12,7,13,9,5
6850,0,0,1.1475798589689021,0.24093140928246637,9,11,5,2,9,3,6
6851,0,0,5.965375978597327,0.002559511724060104,28,40,26,5,35,5,23
6852,1,1,0.33225971428896717,0.5823090983411308,24,35,17,10,25,11,13
6853,1,1,1.8467939572196437,0.863750237217148,20,26,15,6,20,12,8
6854,1,1,2.530501860251022,0.9262526421456717,15,19,10,3,16,10,5
6855,0,0,2.7861088910188525,0.058079457516630795,13,13,7,1,12,2,11
6856,0,0,0.5926298490396258,0.3560316725833218,10,11,5,3,8,3,7
6857,1,1,1.558398864374843,0.8261234803761844,16,23,13,4,19,10,6
6858,1,1,2.8665935639158535,0.9461701140661399,8,10,5,1,9,6,2
6859,0,0,3.5622527964348203,0.02759191407234529,19,26,16,6,20,5,14
6860,1,1,4.799056086977772,0.9918297834314328,26,40,22,7,33,19,7
6861,1,1,4.420296813756056,0.9881123553326785,11,14,9,1,13,10,1
6862,0,0,2.9801392727754075,0.04833122242170029,14,15,9,3,12,4,10
6863,1,1,2.276996649868817,0.9069539082031672,10,12,6,2,10,7,3
6864,0,0,4.024307967208593,0.017561858405294783,19,24,15,2,22,3,16
6865,0,0,3.5547688143598863,0.02779342530555795,18,23,15,5,18,6,12
6866,1,1,1.6738738846601107,0.8420916273671882,4,3,1,1,2,3,1
6867,1,1,1.764977732547305,0.8538319905813421,10,11,8,2,9,7,3
6868,0,0,2.8184300896134338,0.05633633590968501,3,2,0,0,2,0,3
6869,0,1,0.31351865229645437,0.5777438910710134,15,20,13,6,14,10,5
6870,1,1,2.6371969110553635,0.9332174805913657,34,51,30,13,38,16,18
6871,1,1,3.79711667971202,0.9780569337100502,13,19,14,1,18,12,1
6872,0,0,8.486520502847556,0.00020618706655339825,14,16,6,0,16,0,14
6873,1,1,0.4133743740977178,0.601896713788471,12,13,5,4,9,6,6
6874,0,0,0.797622678005871,0.3105342806314042,16,19,7,5,14,5,11
6875,0,1,0.005738918327898468,0.5014347256442306,10,12,7,3,9,6,4
6876,1,1,2.6537886552342056,0.9342441186131141,20,28,19,3,25,16,4
6877,0,1,0.22847792949236467,0.5568722926267887,7,8,5,3,5,4,3
6878,1,1,1.7573440058424021,0.8528767035339693,8,9,4,2,7,6,2
6879,0,0,5.878648525343251,0.002790754801512363,36,53,31,9,44,10,26
6880,0,0,0.5957032773144917,0.3553273303007126,2,1,0,0,1,0,2
6881,1,1,1.7656501468577963,0.8539158898877565,7,8,4,1,7,5,2
6882,0,0,3.051000944393903,0.04517427952354869,22,31,16,7,24,7,15
6883,1,1,0.7477473964826113,0.6786876701652304,5,5,2,1,4,4,1
6884,0,1,0.23873750704132346,0.5594025043085135,3,2,0,1,1,2,1
6885,1,1,5.423759589063993,0.9956088337422069,42,66,39,18,48,25,17
6886,0,0,6.300448803555003,0.0018321180043673335,38,58,37,10,48,12,26
6887,1,1,3.429180743079783,0.9686041635981977,23,32,18,5,27,13,10
6888,0,1,0.07533726218829506,0.5188254124349612,10,12,8,4,8,7,3
6889,1,1,4.443866348274678,0.9883860494234133,14,21,12,1,20,13,1
6890,1,1,0.9820937510253855,0.7275234647042823,13,16,8,4,12,8,5
6891,1,1,4.556967633552963,0.9896151450330227,23,35,26,5,30,18,5
6892,0,0,3.3767433895547767,0.03303025047404062,11,13,5,0,13,0,11
6893,1,1,4.971363322723141,0.9931140562577739,13,21,14,0,21,13,0
6894,0,0,3.867724053851096,0.020477789476839314,16,20,12,2,18,3,13
6895,1,0,0.46276329341217304,0.3863304989241053,23,34,24,8,26,14,9
6896,0,0,5.686768653633719,0.003379074410589711,19,24,16,2,22,3,16
6897,0,0,1.3490890912572397,0.20601933413298923,14,18,12,4,14,4,10
6898,0,0,0.5957032773144917,0.3553273303007126,2,1,0,0,1,0,2
6899,0,0,1.1809508083721192,0.23488128142936981,8,8,5,2,6,3,5
6900,1,1,1.9522759171103155,0.8756945954229185,9,11,6,2,9,7,2
6901,0,0,4.3834545928536155,0.012328279661384167,20,24,12,4,20,4,16
6902,0,0,5.509728082469184,0.004030893875454411,10,10,5,0,10,0,10
6903,1,1,3.0394954814235815,0.9543268437441967,7,7,2,1,6,6,1
6904,0,0,1.6758656163492767,0.15764370588001053,13,18,11,5,13,5,8
6905,0,0,3.212601213474104,0.03869426089417627,31,44,25,5,39,7,24
6906,1,1,1.2769245671429021,0.7819258149816638,13,16,7,4,12,7,6
6907,0,0,1.0803224807723408,0.25344499502113915,17,24,16,7,17,7,10
6908,0,0,3.0515719067401124,0.04514965827717077,13,16,11,2,14,3,10
6909,1,1,2.948765741752454,0.9502051215223734,11,15,12,1,14,10,1
6910,0,1,0.12356823040844311,0.5308528096832186,35,52,31,16,36,14,21
6911,0,1,1.2754822852044716,0.7816797801891247,8,9,4,2,7,5,3
6912,1,1,0.4140878563316548,0.6020676638679505,5,4,2,1,3,3,2
6913,1,1,4.353201354294865,0.9872978607576367,22,36,25,7,29,18,4
6914,0,0,0.43489299538371196,0.3929585367444822,27,40,23,10,30,9,18
6915,0,0,8.782663045687645,0.000153345593453591,21,25,12,1,24,1,20
6916,0,0,4.565464105040792,0.010297898907039249,37,54,32,10,44,12,25
6917,0,0,4.423674029370317,0.011848040107261593,14,18,12,5,13,4,10
6918,0,0,4.318251741104066,0.013147982898043198,18,24,14,6,18,6,12
6919,1,1,3.312536245262949,0.9648563826439905,16,23,15,4,19,12,4
6920,1,1,2.581498937034572,0.9296613494347109,19,26,17,6,20,9,10
6921,0,0,4.107975609709571,0.016175088886129174,17,20,10,5,15,4,13
6922,0,1,0.37529189496248927,0.5927370652573152,11,12,5,5,7,5,6
6923,0,0,2.670640011522699,0.06472821249246397,14,16,10,1,15,1,13
6924,0,0,1.604159537205649,0.16740106477510974,10,11,6,2,9,3,7
6925,1,1,0.8486072452434275,0.7002748987908683,14,19,10,5,14,8,6
6926,0,0,0.2072639025474443,0.44836872492245117,32,50,35,8,42,16,16
6927,0,0,2.6946267144698837,0.06329116688529146,12,14,5,2,12,3,9
6928,1,0,0.2597033974641521,0.4354366210672628,1,0,0,0,0,0,1
6929,0,0,2.2519260988691734,0.09518345301034259,7,7,3,0,7,0,7
6930,0,1,5.250570486426364,0.9947828359356575,19,27,14,4,23,14,5
6931,0,0,2.111022781098836,0.10803007249125918,21,29,17,6,23,7,14
6932,0,0,0.43438333497167525,0.3930801188525266,12,16,9,2,14,3,9
6933,0,0,0.7441616391211232,0.32209477901267747,10,10,3,3,7,4,6
6934,0,0,5.461752931095109,0.004228152900200288,18,18,7,2,16,3,15
6935,1,1,4.045755351422342,0.9828043792286584,22,34,21,7,27,16,6
6936,1,0,2.941394440636975,0.0501448138694226,18,22,12,4,18,5,13
6937,0,0,3.4748638365386793,0.03003595509401724,16,20,12,3,17,4,12
6938,1,0,1.2816290412884666,0.21727305230300242,7,6,1,1,5,1,6
6939,0,0,7.867190996865862,0.00038296229025125417,27,36,21,3,33,4,23
6940,0,0,2.2352103692413072,0.09663284521324622,17,18,8,4,14,6,11
6941,0,0,2.6697859085749442,0.0647799378056132,9,10,4,1,9,1,8
6942,1,1,0.16296146455326233,0.5406504450088241,5,4,1,1,3,3,2
6943,1,1,2.5673779262039966,0.928732339552791,10,14,7,1,13,9,1
6944,1,1,0.8396141802498971,0.6983839516823009,9,8,3,3,5,5,4
6945,1,1,0.5115156431454331,0.6251617093378186,8,8,2,3,5,5,3
6946,0,0,0.8382591770715329,0.30190154804840863,9,8,3,1,7,2,7
6947,0,0,5.987407720665047,0.002503877526368492,13,14,6,0,14,0,13
6948,1,1,1.6787335096948317,0.8427367540824979,13,15,9,3,12,9,4
6949,0,0,2.5120433835738507,0.07501819495567019,29,44,27,14,30,11,18
6950,0,0,4.371491022845957,0.012474804720046584,16,19,11,1,18,1,15
6951,0,0,6.612524567939453,0.0013416338689188345,20,25,16,1,24,1,19
6952,1,1,0.13065795749018605,0.5326180992416136,24,34,18,9,25,10,14
6953,0,1,1.1149957837465394,0.7530593063635174,8,9,4,2,7,5,3
6954,0,0,3.279594732500329,0.03627788259256526,11,13,8,0,13,0,11
6955,0,1,0.8960638780569508,0.7101399572170204,4,3,1,1,2,3,1
6956,0,0,3.0089656725990386,0.04702247358638034,26,41,24,10,31,9,17
6957,1,1,4.376239989040144,0.9875835634221606,25,39,25,9,30,16,9
6958,0,0,0.3565076086221348,0.41180523752624587,14,17,10,6,11,6,8
6959,1,1,1.1006920366226913,0.750389749955582,12,16,10,3,13,8,4
6960,1,1,1.688052335339018,0.8439678512701403,3,2,1,0,2,3,0
6961,1,1,0.9185532163467132,0.714747221866632,3,2,1,0,2,3,0
6962,0,0,3.2292730834785464,0.0380788642590133,12,14,9,1,13,2,10
6963,0,0,1.9659667023759857,0.12282276291750893,17,20,13,6,14,8,9
6964,0,1,3.0867253184335213,0.9563418442783149,19,28,16,6,22,12,7
6965,0,0,1.611100748035748,0.1664358452700797,17,22,12,5,17,5,12
6966,0,0,7.531218477456467,0.0005357974187296666,28,40,21,8,32,6,22
6967,1,1,4.258073781086513,0.9860478846207471,17,28,17,5,23,14,3
6968,0,0,5.7410661372319565,0.0032010630071617197,21,26,17,2,24,3,18
6969,0,0,3.265069124340428,0.03678915885680778,22,30,19,6,24,6,16
6970,0,0,1.810279117200038,0.14060439527988344,27,39,18,10,29,11,16
6971,0,0,4.602196538380079,0.009930183172975893,16,18,10,2,16,3,13
6972,0,0,1.9193323680921155,0.12793603444574797,14,17,8,2,15,3,11
6973,1,1,4.22718173754677,0.9856164449962739,11,17,11,0,17,11,0
6974,1,1,2.673787800039377,0.935462088913991,5,5,2,0,5,5,0
6975,1,1,3.33174646873701,0.9655019882339021,14,20,12,2,18,12,2
6976,1,1,2.483025009883626,0.9229432091023908,10,14,9,1,13,9,1
6977,1,1,1.9842036164977177,0.8791285572184263,10,12,8,2,10,8,2
6978,1,1,4.011740557290613,0.9822199907708113,10,13,7,0,13,10,0
6979,0,0,2.5073225361027625,0.07534643468800872,15,17,8,2,15,3,12
6980,1,1,1.4551875864461035,0.8107955249511689,8,8,4,2,6,5,3
6981,0,0,2.0230123942990073,0.11680786196807635,24,34,23,6,28,11,13
6982,0,0,3.2133398043436205,0.038666796877158016,5,4,0,0,4,0,5
6983,1,1,1.576225336476358,0.828669269092048,16,21,12,7,14,11,5
6984,1,1,1.3744292752496179,0.7980948270995807,20,27,17,8,19,9,11
6985,1,1,0.9505985494453357,0.7212355352187596,16,20,11,5,15,8,8
6986,1,1,1.6467599535492654,0.8384526679217603,14,19,11,4,15,10,4
6987,0,0,3.458946104351391,0.03050318443032629,18,24,14,4,20,5,13
6988,0,0,2.9078800195667442,0.051765397448052974,26,36,22,4,32,5,21
6989,1,1,2.6022572707885177,0.9310067125516748,10,12,6,2,10,8,2
6990,1,0,0.33103319545474563,0.4179892520449112,9,9,5,1,8,2,7
6991,0,0,3.759437814485495,0.022766447687760594,9,10,5,2,8,1,8
6992,0,1,1.1497344336813917,0.7594624068335447,26,39,24,11,28,13,13
6993,0,1,0.6171401545360033,0.6495678422707817,18,26,17,5,21,12,6
6994,1,1,4.3995452267751824,0.9878661150157905,21,27,12,4,23,15,6
6995,0,0,1.209507747760898,0.22978816090412635,20,26,14,6,20,7,13
6996,1,1,1.5494715746787338,0.824837397698818,7,6,1,2,4,5,2
6997,1,1,1.5620082440014518,0.8266413340807401,9,11,6,2,9,7,2
6998,1,1,3.8306979559772065,0.9787661877126218,16,25,20,1,24,15,1
6999,0,0,2.8029993560423336,0.057162311388578746,25,33,18,6,27,8,17
7000,1,1,2.481687309373803,0.9228480192823396,8,11,6,0,11,8,0
7001,1,1,7.375918648881766,0.999374240598974,27,43,29,6,37,22,5
7002,0,0,5.352654016715153,0.004713246146666128,21,28,14,6,22,6,15
7003,0,1,0.9380851699487216,0.7187127084471032,8,8,5,2,6,5,3
7004,0,0,3.1982900063454185,0.03923012361656619,20,27,16,5,22,7,13
7005,0,0,1.5201023307619856,0.17944645117679792,5,4,0,1,3,1,4
7006,0,0,5.1835441429676825,0.005576819922506804,31,46,28,8,38,7,24
7007,0,0,0.4924286954916697,0.37932159619094796,10,10,5,2,8,4,6
7008,1,1,0.26953650682194574,0.5669791145294513,36,56,33,18,38,17,19
7009,0,0,2.0199194792482826,0.1171273171499404,16,20,10,4,16,3,13
7010,1,1,1.9121828264046452,0.8712641784916535,24,38,28,8,30,18,6
7011,1,1,4.7954825989486585,0.9918007748462639,15,20,12,2,18,13,2
7012,0,0,0.7053537736110158,0.330626297992038,19,26,16,7,19,8,11
7013,0,0,3.4193279858588426,0.03169684745306511,20,25,13,4,21,5,15
7014,1,0,1.7333228629139887,0.15016304245812717,7,8,6,0,8,0,7
7015,1,1,1.25162288314268,0.7775806635856074,12,15,8,4,11,7,5
7016,1,1,2.874842481805899,0.9465887068725265,32,49,31,11,38,17,15
7017,1,1,2.371741253865122,0.914646894872501,18,25,13,6,19,10,8
7018,0,0,9.242940535661255,9.678318150818654e-05,33,44,24,6,38,6,27
7019,1,0,1.1268853220342407,0.2447363616254613,17,24,13,7,17,8,9
7020,0,0,1.115604226775151,0.24682756439231268,17,20,11,4,16,7,10
7021,0,0,5.5914493380916594,0.003715760100010179,25,34,19,4,30,4,21
7022,1,1,0.8867208551813022,0.7082130089497649,28,38,23,10,28,12,16
7023,1,1,2.791991174416488,0.9422415047885593,16,23,15,3,20,13,3
7024,0,0,2.4837246008664406,0.07700705137652664,24,35,20,8,27,7,17
7025,1,1,1.6162745189996368,0.8342806994100206,10,12,8,2,10,8,2
7026,0,0,0.3864217621684332,0.4045789845647265,6,6,3,2,4,3,3
7027,1,1,2.622910816492868,0.932321604499344,41,67,44,17,50,27,14
7028,0,0,1.4027185009207044,0.1973850807531108,13,17,11,5,12,4,9
7029,1,1,2.4717347170271866,0.9221364102746177,14,19,13,2,17,11,3
7030,0,1,0.7519832186444919,0.6796106789437333,17,22,14,4,18,8,9
7031,1,1,2.655387965234555,0.9343422992912234,15,20,14,3,17,12,3
7032,0,0,2.0257171154989555,0.11652912175483299,18,24,13,6,18,7,11
7033,0,0,5.20524421001187,0.005457759521342975,13,15,8,2,13,3,10
7034,0,0,0.2597033974641521,0.4354366210672628,1,0,0,0,0,0,1
7035,0,0,2.17426750644429,0.10208519276894057,9,9,3,1,8,2,7
7036,0,0,1.4999219244571331,0.18243716878529737,29,43,24,10,33,9,20
7037,1,0,0.2660790071708342,0.4338699451218594,4,3,0,1,2,1,3
7038,1,1,2.892213849463186,0.9474601948375068,10,12,8,1,11,9,1
7039,1,1,2.757796492612364,0.940352159207221,15,20,12,3,17,11,4
7040,0,0,5.772958149796493,0.003100896968987299,37,55,30,10,45,10,27
7041,0,0,0.3740964409050751,0.407551549119215,27,39,25,7,32,12,15
7042,1,1,4.562814142775292,0.989675057991461,13,19,10,2,17,11,2
7043,1,0,1.531419585971855,0.17778607835325433,12,14,8,3,11,6,6
7044,0,0,0.31458657886076735,0.42199560360946176,28,40,26,8,32,14,14
7045,1,1,1.1919684005464886,0.7670929262408174,7,8,5,1,7,6,1
7046,1,1,0.9559840876680059,0.7223170325451984,11,13,7,3,10,7,4
7047,0,1,1.306329642934366,0.7868983242009344,29,43,29,11,32,18,11
7048,1,1,3.158073459059991,0.9592256625904643,8,11,7,0,11,8,0
7049,0,1,1.5254108346970927,0.821333872049985,22,30,19,7,23,14,8
7050,1,1,0.23873750704132346,0.5594025043085135,3,2,0,1,1,2,1
7051,0,0,1.0426570575498135,0.26063763833094666,6,5,1,1,4,1,5
7052,1,1,0.574737386891663,0.6398555822866918,2,1,0,0,1,2,0
7053,0,1,0.19449322442346806,0.5484706083929165,8,8,3,3,5,4,4
7054,0,0,0.5830482790207462,0.35823148673039085,10,12,6,4,8,5,5
7055,1,1,3.464469075101368,0.9696597221150606,19,26,17,5,21,14,5
7056,1,1,3.7892181689946867,0.9778867776701441,19,31,22,3,28,16,3
7057,1,1,5.107336311976825,0.9939842259648042,12,18,12,0,18,12,0
7058,1,1,3.8740947235198817,0.9796496066692238,15,20,14,2,18,13,2
7059,1,1,7.363003619152775,0.999366111640725,26,40,27,4,36,22,4
7060,0,0,1.3801874121501907,0.20097890222460113,15,17,9,2,15,4,11
7061,1,1,2.0161246697384625,0.882479696748484,5,5,3,0,5,5,0
7062,1,1,0.4148072996317167,0.6022400170071416,17,25,18,9,16,10,7
7063,1,1,2.7257517486372103,0.9385292025920238,10,10,4,3,7,7,3
7064,1,1,5.548148936125976,0.9961204496894718,22,33,24,3,30,19,3
7065,1,1,1.376681695414607,0.7984575372107827,6,6,3,1,5,5,1
7066,1,1,2.8249653708746187,0.9440100906425338,18,27,19,4,23,15,3
7067,0,1,0.28387501945468596,0.5704959794435307,11,12,6,3,9,7,4
7068,1,1,5.328160685288415,0.9951704497687758,17,24,13,3,21,14,3
7069,0,0,6.859045645688485,0.0010488142796728495,17,22,11,0,22,0,17
7070,1,1,2.0015431756345943,0.880959006333475,10,11,7,2,9,6,4
7071,1,1,2.2431661824850857,0.9040594317670589,11,16,11,3,13,10,1
7072,1,1,3.6163385381059143,0.973822748610461,9,11,8,1,10,8,1
7073,1,1,3.2156875229213355,0.9614203772997449,16,20,13,3,17,11,5
7074,0,0,1.3581515723310091,0.2045408844511436,17,23,11,6,17,6,11
7075,0,0,3.3790757137714578,0.03295583885801345,9,10,4,0,10,0,9
7076,1,1,6.005977040924758,0.9975420755165275,14,20,14,0,20,14,0
7077,1,1,1.9413247836464027,0.874497612677605,9,11,6,2,9,7,2
7078,1,0,2.1071492459500574,0.1084038918014657,10,10,5,1,9,1,9
7079,0,0,3.6625179144322773,0.025025453576997703,9,9,4,1,8,1,8
7080,0,0,1.5623821970033471,0.17330508296590874,8,8,4,3,5,3,5
7081,0,0,3.0160018410646035,0.04670817633737778,21,29,18,5,24,7,14
7082,1,0,2.443455489793301,0.07991845572574263,18,22,12,5,17,7,11
7083,0,0,6.074899342200981,0.00229460037492335,26,32,18,4,28,5,21
7084,1,0,0.315405038035395,0.4217959816384602,12,13,6,3,10,4,8
7085,0,0,4.09556923349205,0.016373706860138615,23,33,19,5,28,5,18
7086,1,1,7.146233448516461,0.9992127942943576,23,36,25,4,32,21,2
7087,1,1,2.5369653712722235,0.9266929414878418,18,25,15,7,18,11,7
7088,1,0,0.9508934662943322,0.2787051741908636,29,42,25,8,34,12,17
7089,1,1,2.262239399292161,0.905701064475446,8,11,5,1,10,7,1
7090,1,1,5.084460972944981,0.9938458836993129,14,18,7,3,15,10,4
7091,0,0,3.977129657858331,0.018394646828278627,14,18,10,6,12,4,10
7092,0,0,4.0613176111646165,0.016934586207763558,18,21,10,1,20,4,14
7093,1,1,1.667523008355184,0.8412452943868014,8,10,7,1,9,7,1
7094,1,0,1.3110191605925445,0.2123163516496953,20,27,15,6,21,7,13
7095,1,1,6.276112011005862,0.9981228318543038,23,33,18,5,28,15,8
7096,0,0,2.3535318526080373,0.08678545111084635,10,11,7,2,9,3,7
7097,1,1,3.842320230944669,0.9790063934338075,14,19,13,2,17,11,3
7098,1,1,2.991100685369184,0.9521704623788959,10,13,5,2,11,8,2
7099,1,1,1.5581104575752498,0.8260820487245016,4,4,2,0,4,4,0
7100,1,1,1.676898327429288,0.8424933815829336,7,8,5,1,7,6,1
7101,0,0,3.4288941891759435,0.031404551715757734,22,28,17,6,22,6,16
7102,0,0,1.4418878309235064,0.19125317735051328,17,20,12,4,16,6,11
7103,1,0,0.5343285750981326,0.36950788371218746,20,28,16,4,24,5,15
7104,1,0,2.9725771709922375,0.048680234086935004,37,56,36,12,44,15,22
7105,1,0,0.2597033974641521,0.4354366210672628,1,0,0,0,0,0,1
7106,1,1,2.5952166045754272,0.930553093266361,19,27,16,7,20,9,10
7107,0,0,0.9906885413580291,0.2707760992944723,16,20,10,5,15,5,11
7108,0,1,2.8652134834963476,0.94609978019678,19,25,15,5,20,9,10
7109,0,0,6.341454220742459,0.0017586401526400453,15,17,10,0,17,0,15
7110,0,0,0.05966557563056418,0.4850880296907095,6,5,1,1,4,2,4
7111,1,0,2.5214155681731096,0.07437043946140454,27,37,22,8,29,10,17
7112,0,0,0.7090758915342952,0.3298030665258376,9,10,6,2,8,3,6
7113,0,0,4.656651747514421,0.009408844434891095,32,49,31,11,38,12,20
7114,1,1,1.261887315021198,0.7793508274535214,21,28,17,5,23,12,9
7115,1,1,1.6869551831368492,0.843823317025988,9,9,4,2,7,6,3
7116,0,0,2.754762517503963,0.05981824391427171,13,15,7,6,9,5,8
7117,0,0,4.226026902762373,0.014399935898158467,16,19,8,2,17,3,13
7118,1,1,3.325651078616102,0.9652983865232768,19,30,20,4,26,16,3
7119,1,0,0.030004622646060408,0.4924994070478894,25,37,20,9,28,9,16
7120,0,0,2.9788909175582443,0.048388673299414764,12,14,10,0,14,0,12
7121,1,1,1.61069226569157,0.8335074762284684,6,8,4,0,8,6,0
7122,0,0,4.005140550255079,0.017895638551908566,7,7,4,0,7,0,7
7123,1,1,1.0927432114630868,0.7488979341601678,8,10,6,1,9,7,1
7124,1,1,1.2237497162021496,0.7727227565577958,13,17,9,4,13,9,4
7125,1,1,1.3847883809383585,0.7997589343044679,16,22,12,4,18,10,6
7126,0,0,0.8774333038160065,0.29370994362394165,5,4,1,0,4,0,5
7127,1,1,2.742170274600108,0.9394696302576364,35,56,34,14,42,19,16
7128,0,0,4.219362752743048,0.014494824082998181,28,39,27,5,34,6,22
7129,0,0,4.970676923341209,0.006890639292423284,17,23,14,0,23,0,17
7130,0,0,1.236965390469405,0.22496464511749792,17,22,14,3,19,5,12
7131,1,1,2.3924494353078716,0.916249720129199,14,19,12,1,18,10,4
7132,0,0,1.9089905765685464,0.1290942980892298,18,24,14,2,22,3,15
7133,1,1,3.914356566409051,0.9804369655300814,19,28,18,3,25,15,4
7134,1,1,7.532803224722975,0.9994650505584455,17,28,18,1,27,16,1
7135,0,0,3.9970229713127363,0.018038867868749753,11,12,8,0,12,0,11
7136,0,0,4.233471199320276,0.014294663182368605,14,14,7,2,12,3,11
7137,1,0,0.9949431148028434,0.2699368262912213,28,41,25,9,32,10,18
7138,1,1,5.54793301320277,0.9961196151660706,15,23,15,1,22,14,1
7139,1,0,1.193996254496546,0.23254497084507453,17,20,11,2,18,5,12
7140,0,0,1.4878909976252945,0.1842384881688489,18,22,14,6,16,6,12
7141,1,1,2.7979672091216203,0.9425658770144337,31,50,36,11,39,21,10
7142,1,1,2.810892234527498,0.9432615897261456,14,17,12,2,15,10,4
7143,1,1,4.368817921310479,0.9874922218989554,23,34,22,5,29,15,8
7144,0,0,4.908684521760488,0.007328095644303367,26,33,20,8,25,10,16
7145,0,0,1.4060372314971072,0.1968598414597167,11,11,4,2,9,3,8
7146,1,1,2.2080608330868268,0.9009710445208342,6,5,2,1,4,5,1
7147,1,0,0.4209299188066429,0.39629425015975683,21,29,17,6,23,8,13
7148,0,1,0.7013597167107586,0.6684891698945767,10,12,8,3,9,7,3
7149,1,1,4.14780273306523,0.9844466358507619,13,19,12,1,18,12,1
7150,1,1,3.261723922845169,0.963092117675589,25,37,26,5,32,19,6
7151,1,0,3.4385041781639964,0.03111354483246509,14,14,6,2,12,3,11
7152,1,1,2.288064228367429,0.9078836875234142,7,8,5,1,7,6,1
7153,0,1,0.37240755272166837,0.5920405996997722,13,16,9,5,11,7,6
7154,0,0,0.6341710457741998,0.3465653683779535,11,11,3,2,9,3,8
7155,0,1,0.80073733269643,0.690132181643991,12,17,12,6,11,8,4
7156,0,0,3.3402028754826567,0.03421745271011889,15,18,10,0,18,0,15
7157,1,1,0.03564027485438914,0.5089091256809356,4,3,0,2,1,2,2
7158,1,1,0.012605265163543988,0.5031512745647835,5,4,2,1,3,3,2
7159,0,0,8.36211075379593,0.0002334963115424582,25,35,21,7,28,6,19
7160,1,1,3.9609540106786167,0.9813109943769905,17,23,11,3,20,13,4
7161,0,0,0.49921279446772804,0.3777256828464176,19,25,17,4,21,7,12
7162,1,1,2.832916878480861,0.9444288871021503,10,13,9,1,12,9,1
7163,1,0,0.9568051262843602,0.2775183175847441,4,3,0,1,2,1,3
7164,1,1,2.9708585825469864,0.9512401155164593,12,15,10,2,13,10,2
7165,1,1,2.5847497462221796,0.9298736268192505,13,18,11,2,16,10,3
7166,0,0,0.3431400330165273,0.41504692771799456,19,27,14,6,21,8,11
7167,1,1,0.9263277188489596,0.7163296657194782,24,37,24,8,29,13,11
7168,1,1,2.0004795092788474,0.880847414184162,14,22,14,2,20,12,2
7169,1,1,5.295324529340962,0.9950100379915346,16,24,16,3,21,13,3
7170,1,1,1.5483655776777618,0.8246775451027497,9,10,5,2,8,7,2
7171,0,1,1.0627805804169097,0.743221559151739,16,24,15,6,18,10,6
7172,1,0,0.18486606385938997,0.4539146583229605,17,21,11,4,17,6,11
7173,0,0,2.2990913649473335,0.0911982417395868,8,10,4,2,8,1,7
7174,0,0,1.5235999318153413,0.17893202271790432,22,32,17,7,25,7,15
7175,1,1,4.680603041448315,0.9908117862209572,10,13,5,1,12,9,1
7176,1,1,2.9216693512847325,0.948907293652609,24,33,18,9,24,11,13
7177,0,0,1.7956314915092455,0.14238367301631671,8,8,4,1,7,1,7
7178,1,1,0.9149882488687271,0.7140198272550514,22,30,18,5,25,12,10
7179,1,1,2.913705063754587,0.9485197837521004,7,8,4,1,7,6,1
7180,1,1,3.4225285200537567,0.9684012367516169,17,26,18,2,24,15,2
7181,0,0,1.1706599986677944,0.23673570713131653,11,11,4,1,10,2,9
7182,0,0,3.317134322082464,0.03498803608865886,7,7,2,0,7,0,7
7183,0,0,1.4009187370146898,0.19767036222666223,5,5,3,0,5,0,5
7184,1,0,2.107276702990833,0.10839157337620609,8,8,4,2,6,3,5
7185,1,0,2.191843757708151,0.10048531715720299,17,22,12,6,16,8,9
7186,0,0,2.5263832026935327,0.07402919232330352,23,33,21,8,25,9,14
7187,0,0,4.282611774952731,0.013618530347342062,29,44,29,7,37,7,22
7188,0,1,0.17355989465065713,0.5432813809498834,7,6,3,2,4,3,4
7189,0,0,0.618600220755394,0.3500998762656269,11,13,7,5,8,5,6
7190,0,0,1.5222365914655223,0.17913240602970448,30,42,25,9,33,12,18
7191,0,0,2.5392392482546278,0.07315273671991995,19,24,11,4,20,5,14
7192,1,1,1.4960862280562843,0.8169900253178388,8,9,4,2,7,6,2
7193,0,0,1.3304417731321816,0.20908630014613705,8,7,3,1,6,2,6
7194,1,1,0.5319297274506292,0.6299330776870815,6,5,2,1,4,3,3
7195,1,0,0.3986483961792734,0.4016371205014073,6,6,2,1,5,1,5
7196,0,1,1.9527217750657524,0.8757431205244431,6,6,3,1,5,4,2
7197,0,0,2.1678816849596174,0.10267203064026098,15,17,8,5,12,4,11
7198,1,1,1.6423283415752201,0.8378515063105598,7,8,4,1,7,6,1
7199,1,1,0.7080267002232561,0.6699649861697307,9,9,4,3,6,4,5
7200,0,0,1.7117962480100923,0.15293087927058557,5,4,2,0,4,0,5
7201,1,1,0.45877073315374606,0.612722519393149,17,23,14,6,17,8,9
7202,0,1,1.9296236520670358,0.8732077580037929,26,37,22,12,25,12,14
7203,0,0,6.331663219297481,0.0017759128422211168,29,43,26,3,40,6,23
7204,0,0,0.9148339935769946,0.28601167202330535,9,9,4,1,8,1,8
7205,1,1,2.6249795722892024,0.9324520222272967,6,7,5,0,7,6,0
7206,0,0,0.7188781938192168,0.3276400601173841,23,33,19,8,25,12,11
7207,1,1,1.954557940615794,0.8759427889356255,9,11,4,2,9,7,2
7208,1,1,3.208649871420472,0.9611584927702974,19,26,15,5,21,12,7
7209,0,0,7.582993195660913,0.0005087763131097489,27,36,25,3,33,9,18
7210,1,1,2.2584684463927207,0.9053785069430543,14,14,7,3,11,8,6
7211,1,1,1.2438224324512608,0.7762286630629126,25,34,19,10,24,12,13
7212,0,0,1.3676350930169616,0.20300220145558712,6,6,3,1,5,2,4
7213,1,1,3.9627169336992525,0.9813432984845063,7,10,5,0,10,7,0
7214,1,1,3.6884030874853173,0.9755984182136375,30,47,29,10,37,20,10
7215,1,1,2.6318285297770423,0.9328821299225931,10,13,6,1,12,9,1
7216,1,1,1.7498176915529355,0.8519298060696929,26,36,17,10,26,13,13
7217,0,1,0.11891496866164752,0.5296937593580813,8,9,5,4,5,6,2
7218,0,0,0.1268960569202675,0.46831848728316594,26,41,28,9,32,14,12
7219,1,1,4.264509816785452,0.9861361516613445,13,18,10,1,17,12,1
7220,0,0,1.3016594223839975,0.2138858713562387,14,19,11,4,15,4,10
7221,1,1,0.13997441503001928,0.5349365801495185,8,8,4,3,5,4,4
7222,1,1,2.304321849669809,0.9092343407574623,7,9,6,0,9,7,0
7223,0,0,6.24983734420759,0.0019270474793946502,35,52,32,9,43,10,25
7224,1,1,1.9362547261575669,0.8739401087178119,17,26,16,8,18,10,7
7225,0,0,1.7505298698885505,0.1479803784158964,11,14,7,1,13,1,10
7226,0,0,0.6859936745963253,0.3349248920757243,15,20,12,5,15,7,8
7227,0,0,1.8229153520064558,0.13908442142833766,26,35,20,5,30,9,17
7228,1,0,0.7996275013214916,0.31010520558979005,7,7,2,1,6,1,6
7229,1,1,1.096545120059545,0.7496122056148924,15,21,11,5,16,7,8
7230,1,0,1.0694590429244393,0.2555059728615212,5,4,1,1,3,1,4
7231,1,1,4.063957357118499,0.9831093037780816,22,31,21,6,25,17,5
7232,1,1,2.2955040518919603,0.9085040013867227,9,12,8,1,11,8,1
7233,0,0,5.757837806746715,0.0031479911390027704,31,44,28,8,36,9,22
7234,1,1,3.1491386409102753,0.9588747684333024,9,11,6,1,10,8,1
7235,1,1,1.87251313551163,0.8667488004693312,12,17,13,1,16,11,1
7236,0,1,0.49754581704371503,0.6218824160015579,11,14,6,4,10,6,5
7237,1,1,2.085862240553862,0.8895214503473994,20,29,18,4,25,14,6
7238,1,1,2.3041377367127236,0.909219145275759,6,7,5,0,7,6,0
7239,1,1,1.114819095989258,0.7530264478646012,12,13,6,3,10,7,5
7240,1,0,1.9363408704385021,0.1260504011762621,20,24,14,4,20,8,12
7241,0,0,2.4589482516315715,0.07878663852588808,16,18,8,3,15,4,12
7242,0,0,5.324133367968387,0.004848945078287592,14,17,11,0,17,0,14
7243,0,0,2.6157072069260128,0.06813434706259625,26,37,25,4,33,8,18
7244,0,0,3.761687647870372,0.022716446794254108,16,21,12,2,19,2,14
7245,0,0,3.163529553104123,0.04056147367543206,15,19,10,4,15,4,11
7246,0,0,4.159936096750632,0.0153686725497445,15,19,12,3,16,3,12
7247,1,1,0.502852587276486,0.6231294652515866,7,8,4,4,4,5,2
7248,0,1,0.34117291974930786,0.5844754110007695,4,3,1,1,2,2,2
7249,1,1,3.8338749225897235,0.978832114080129,24,34,21,5,29,15,9
7250,0,0,2.5468344769801345,0.07263943606360967,47,75,48,18,57,21,26
7251,1,1,0.5938751075907853,0.6442537805184934,13,16,9,3,13,9,4
7252,0,0,5.01342525679763,0.006604187585333765,12,16,9,0,16,0,12
7253,0,1,0.05204874714313901,0.5130092500020522,7,7,3,2,5,4,3
7254,0,0,1.0638141200287614,0.256581246353922,11,12,7,1,11,2,9
7255,0,0,2.0692126568679585,0.1121253972240962,13,16,9,1,15,1,12
7256,1,0,1.1586545643852695,0.23891184377237062,17,23,13,4,19,5,12
7257,0,0,4.575879597147693,0.01019228538635042,23,29,17,4,25,5,18
7258,0,1,0.28490244454519076,0.5707477114841006,12,13,7,3,10,6,6
7259,1,0,0.32601824945602176,0.41920975861880405,8,8,4,2,6,2,6
7260,0,0,6.4688409894648,0.0015486203979789837,38,60,35,13,47,10,28
7261,0,1,0.4393974849915234,0.6081154541201539,17,22,15,7,15,11,6
7262,0,0,4.112876508382698,0.016097283300282927,13,14,9,1,13,2,11
7263,1,1,1.3828649412400404,0.7994507282525173,4,4,2,0,4,4,0
7264,1,1,4.257393986381139,0.9860385292856947,16,24,15,1,23,15,1
7265,1,1,3.5225254111990134,0.9713219347979292,8,10,6,1,9,7,1
7266,1,1,0.5785586366775313,0.6407356812612175,7,8,3,2,6,5,2
7267,1,1,1.6333979088387236,0.8366345866748472,5,5,2,0,5,5,0
7268,0,0,1.1822323627734552,0.2346510488976652,14,15,6,3,12,4,10
7269,0,0,6.210856461301995,0.0020034953150003254,29,41,26,7,34,8,21
7270,1,1,3.6680222003936285,0.9751084959530526,30,47,29,14,33,16,14
7271,1,1,3.7424207006925196,0.9768518626978571,15,21,12,3,18,12,3
7272,0,0,3.6307067916719746,0.0258134587885942,28,43,29,7,36,8,20
7273,1,0,1.8823515137191622,0.1321190072411429,37,58,33,14,44,14,23
7274,0,1,0.28041321803295194,0.56964752693254,32,51,34,13,38,17,15
7275,1,1,0.23873750704132346,0.5594025043085135,3,2,0,1,1,2,1
7276,1,1,3.001960243237219,0.952662605541448,8,11,6,0,11,8,0
7277,1,0,0.8384200395077321,0.30186764624381446,18,24,16,4,20,6,12
7278,0,0,4.281833069840164,0.01362899470732093,15,19,10,1,18,1,14
7279,0,0,4.972565724110003,0.006877725960736325,15,16,7,4,12,5,10
7280,1,1,0.6837470766321003,0.6645744923123353,3,2,1,0,2,3,0
7281,1,1,2.785477207185734,0.9418859757914146,9,11,8,1,10,8,1
7282,0,0,3.9550554383339644,0.018797491509744857,11,12,7,1,11,2,9
7283,0,0,5.684403084603536,0.003387050200125752,30,43,26,7,36,8,22
7284,0,0,0.6640895300940268,0.33982155455035823,5,4,1,1,3,1,4
7285,1,1,2.380776262054321,0.9153496021041996,31,51,34,14,37,21,10
7286,0,0,2.5857220708671864,0.07006299568404728,20,25,15,5,20,6,14
7287,0,0,2.8217045277953696,0.05616251109492865,16,19,8,3,16,4,12
7288,0,0,2.5462251539226037,0.07268049255115361,13,13,7,2,11,3,10
7289,0,0,4.482987562644669,0.01117334996646735,14,15,10,1,14,1,13
7290,1,1,2.9848619330948827,0.9518855350654919,16,22,13,2,20,13,3
7291,0,0,2.6310420472210287,0.06716713092665494,22,28,16,4,24,5,17
7292,0,0,5.0905613683244795,0.006116916983293863,15,21,12,0,21,0,15
7293,1,1,2.214601185338482,0.9015530608699819,11,15,7,2,13,9,2
7294,0,0,4.246448052680202,0.014112962884375024,15,16,8,3,13,4,11
7295,1,1,2.0619160174271345,0.8871461398451933,15,21,13,5,16,11,4
7296,0,0,5.114190379747454,0.005974928014226166,10,12,6,0,12,0,10
7297,0,0,2.7443720958459266,0.06040528108812826,14,19,12,5,14,4,10
7298,1,1,0.8959040695222198,0.7101070609320617,8,8,4,2,6,4,4
7299,0,0,4.107485225627637,0.016182894443129148,32,50,28,13,37,12,20
7300,0,0,4.437850418180594,0.011683211124847714,19,22,10,3,19,4,15
7301,0,0,2.014673621808128,0.11767087392966291,11,12,8,2,10,3,8
7302,1,1,1.8906559102898084,0.868830298945122,6,7,5,0,7,6,0
7303,1,1,5.852044343093376,0.9971342186362052,15,20,11,1,19,14,1
7304,1,1,1.0234307230237911,0.7356403237978127,5,4,1,1,3,4,1
7305,1,1,1.3956429662833947,0.801491582697615,13,17,8,4,13,8,5
7306,1,1,2.880380329250478,0.9468680008346061,12,17,12,1,16,11,1
7307,1,1,2.911093685669795,0.9483921206974542,9,11,6,1,10,8,1
7308,1,1,4.2092720921509965,0.9853603252094898,8,11,7,0,11,8,0
7309,0,0,3.656678608917826,0.02516832369215627,13,17,9,1,16,1,12
7310,0,0,3.58448648214126,0.02700159558981219,32,44,24,7,37,9,23
7311,1,1,2.7430726069971048,0.9395209223491926,19,27,20,3,24,15,4
7312,1,1,4.376509946156793,0.9875868732731724,25,39,26,7,32,16,9
7313,0,0,5.326655305579576,0.004836790821743153,26,36,19,7,29,7,19
7314,1,0,2.125480506454957,0.10664480662937692,25,37,23,9,28,8,17
7315,1,1,2.8502761266606695,0.9453329543670541,13,18,11,2,16,11,2
7316,1,0,0.22684251944992528,0.44353130766798243,17,20,9,2,18,5,12
7317,0,0,0.7735307823793007,0.3157158225111246,11,11,5,1,10,2,9
7318,0,1,1.7960047322059374,0.8576618975320218,7,7,2,2,5,5,2
7319,1,1,0.5686589788527944,0.6384536839725308,6,5,2,1,4,5,1
7320,0,0,2.8143241701132857,0.056555015122584096,36,56,33,11,45,12,24
7321,1,0,0.11394772456983615,0.4715438519478853,13,19,13,4,15,9,4
7322,1,1,2.623108170594408,0.9323340560920036,11,14,10,1,13,10,1
7323,0,0,0.18226206355754515,0.4545602049745313,11,14,10,2,12,3,8
7324,1,0,1.5456700511980053,0.17571252736944654,23,30,20,4,26,5,18
7325,1,0,0.0755843525771569,0.48111290282295205,14,20,12,7,13,7,7
7326,0,0,3.3839174807242847,0.032801881395893795,25,34,22,7,27,8,17
7327,0,0,5.813073670223291,0.002979328184151031,20,26,17,5,21,4,16
7328,1,1,8.071670115647336,0.9996878361439097,24,40,27,6,34,21,3
7329,1,1,2.012737756410615,0.8821279871230595,25,38,22,9,29,14,11
7330,1,0,0.5619955965423629,0.3630858430384257,8,8,3,2,6,3,5
7331,0,0,0.8863514689375815,0.2918633296064137,11,12,4,4,8,5,6
7332,0,1,2.1137212828842062,0.8922296790913542,6,8,4,0,8,6,0
7333,1,1,2.234426926773514,0.9032987426089846,14,17,11,3,14,9,5
7334,1,1,1.8043432042364078,0.8586768085416361,5,6,3,0,6,5,0
7335,0,0,0.5802881129870134,0.35886630156544574,28,41,24,10,31,12,16
7336,0,0,6.217278972513738,0.0019906946094209177,24,33,22,6,27,5,19
7337,0,0,5.424562046212176,0.0043876594031743155,36,53,31,7,46,8,28
7338,0,0,1.384371364491564,0.20030785696803666,6,5,2,0,5,0,6
7339,1,0,1.2349384112343222,0.2253182572185699,23,31,18,7,24,11,12
7340,0,0,1.3000041134334417,0.21416432467414304,9,9,4,3,6,3,6
7341,0,1,0.804265298173289,0.6908861296764919,7,7,2,2,5,5,2
7342,0,1,0.035382709031507975,0.508844754521508,14,20,13,7,13,7,7
7343,1,1,2.396463819351342,0.9165572542892326,34,54,32,14,40,15,19
7344,0,0,4.287554115944735,0.013552298900855075,27,38,24,8,30,9,18
7345,1,1,1.5697832269585388,0.827752703359405,15,21,13,3,18,11,4
7346,0,0,2.1141469416102883,0.10772939815267035,9,9,2,1,8,1,8
7347,1,1,2.1710326351345546,0.897617904699308,15,20,11,3,17,12,3
7348,0,0,3.3517239833590655,0.03383875545550752,22,30,17,7,23,6,16
7349,1,1,4.554031773967906,0.9895849297644572,24,37,24,5,32,18,6
7350,1,0,0.44167427327248376,0.39134209583887447,12,15,10,3,12,5,7
7351,1,1,2.071657748225122,0.8881177889148484,18,27,17,6,21,14,4
7352,0,0,0.08966128226225578,0.4775996840408203,24,36,23,7,29,10,14
7353,1,1,1.8093633359860752,0.8592849100559687,9,10,4,2,8,6,3
7354,0,0,7.514319369872761,0.0005449238802737177,17,21,13,0,21,0,17
7355,0,0,6.425496325485505,0.0016171098854852461,24,33,21,1,32,1,23
7356,0,0,1.8036185335573514,0.14141115379108682,14,17,11,2,15,4,10
7357,1,1,3.1718350571783582,0.9597605148021946,17,26,18,1,25,16,1
7358,0,0,2.226946033080435,0.0973566887870847,12,13,7,3,10,3,9
7359,0,0,4.295679718082715,0.013444098974134233,24,31,18,8,23,7,17
7360,1,1,5.436710788406407,0.9956650929831258,14,17,8,4,13,10,4
7361,0,1,0.9133059147925671,0.7136761785337712,20,27,19,6,21,12,8
7362,1,1,4.550557100518075,0.9895490567178149,20,28,16,4,24,15,5
7363,1,1,3.7059699608120473,0.9760131421489388,22,33,19,7,26,14,8
7364,1,1,8.072171052864327,0.9996879924304648,23,33,23,4,29,17,6
7365,1,1,4.187857408712927,0.9850481783296531,18,27,16,6,21,14,4
7366,0,0,3.9785864087578613,0.018368361766312624,20,27,16,2,25,3,17
7367,1,0,0.04587508453489564,0.4885332398011548,31,50,31,14,36,14,17
7368,0,0,3.881333297796524,0.02020658320316948,23,31,16,8,23,6,17
7369,0,1,2.642780030663952,0.933564594734115,16,23,15,6,17,9,7
7370,0,0,1.250609806966224,0.22259459617078292,9,9,5,1,8,1,8
7371,0,0,2.621653131311665,0.06775779611990018,13,15,7,3,12,3,10
7372,1,1,2.462704409303659,0.9214855498229734,7,7,4,1,6,6,1
7373,1,1,2.008704462821204,0.8817079657276664,19,27,17,6,21,15,4
7374,1,1,2.1806919233654183,0.8985021901498811,15,21,16,2,19,11,4
7375,1,0,1.7159744449698708,0.15239040753239053,12,13,7,4,9,5,7
7376,0,0,2.7279878090169687,0.06134192073021516,25,37,24,9,28,8,17
7377,0,0,1.3359360099861624,0.20817917467209712,8,8,3,1,7,2,6
7378,1,1,4.376173320466188,0.9875827458876193,10,12,5,2,10,8,2
7379,0,0,9.175077646170884,0.00010357845324937553,38,56,33,14,42,12,26
7380,1,1,1.5169489497107391,0.8200887584607974,29,41,22,12,29,15,14
7381,0,0,4.579257512781387,0.01015826393496666,5,6,3,0,6,0,5
7382,1,1,4.014751918878208,0.9822725045327692,28,40,26,6,34,18,10
7383,0,0,4.736805439642912,0.008690421446457708,24,34,21,3,31,4,20
7384,0,0,3.513298623871645,0.028936203970042484,35,54,33,10,44,15,20
7385,1,1,1.9677761137501952,0.8773720452324949,12,16,12,2,14,10,2
7386,0,0,5.493122976599178,0.004098109511462278,10,11,6,0,11,0,10
7387,1,1,5.5521856217490955,0.9961360182586018,16,26,17,0,26,16,0
7388,0,0,2.622450819447927,0.06770742618085035,33,50,30,11,39,11,22
7389,1,1,3.0787879109038743,0.9560092376655955,14,17,10,3,14,10,4
7390,1,1,2.382210558078327,0.9154606719257095,33,57,37,11,46,20,13
7391,0,0,4.556418619522691,0.010390498706448481,28,39,25,6,33,6,22
7392,1,0,0.24230039215621924,0.43971953335858005,23,32,16,7,25,8,15
7393,1,0,1.836881148884912,0.13742057131240526,15,20,11,5,15,7,8
7394,0,0,1.7770554580667053,0.14466710631017354,7,7,4,1,6,2,5
7395,0,0,0.5927905672687519,0.3559948250660462,18,22,15,5,17,8,10
7396,1,0,0.6735107191981795,0.33771117830724817,7,7,4,3,4,3,4
7397,0,0,2.87879849569416,0.05321163588996103,19,26,16,4,22,7,12
7398,1,1,2.933233381131054,0.9494650421558362,17,25,17,2,23,14,3
7399,0,1,0.2847825431899711,0.5707183360310475,28,41,20,14,27,12,16
7400,1,1,4.394943794878503,0.9878108352455086,11,17,12,0,17,11,0
7401,0,0,1.2317085715620786,0.22588252565616673,14,17,9,4,13,5,9
7402,0,0,4.672206485791463,0.009264970134565842,19,25,15,5,20,5,14
7403,0,0,2.8888282258526967,0.052708594930303,30,41,22,5,36,7,23
7404,0,0,4.3086317881329945,0.013273389251883372,30,47,33,11,36,12,18
7405,1,0,1.703435740239867,0.15401707018646815,5,5,2,0,5,0,5
7406,0,1,2.7621116649169917,0.9405937376965046,10,10,2,4,6,6,4
7407,1,1,1.8605132907333062,0.8653567650437837,5,5,3,0,5,5,0
7408,0,0,3.99756798634003,0.018029216298461992,13,15,10,3,12,3,10
7409,1,1,2.262454863766964,0.9057194649650975,11,15,7,1,14,9,2
7410,1,0,3.067876924308126,0.04445192007149168,14,18,9,3,15,3,11
7411,0,0,3.195092871715197,0.03935080488282883,10,10,4,2,8,3,7
7412,0,0,2.60353348106974,0.06891135743770838,22,30,16,5,25,5,17
7413,0,0,4.056422169558191,0.017016277592052598,17,20,9,3,17,4,13
7414,1,1,2.773886573169237,0.9412482827984819,8,10,4,1,9,7,1
7415,0,0,3.562089027182449,0.02759630843966976,25,36,24,5,31,4,21
7416,1,1,0.764947121967853,0.6824268425528419,17,22,12,6,16,9,8
7417,0,1,1.1954612546252714,0.7677163820652375,9,9,5,2,7,6,3
7418,0,0,3.4110585468868537,0.03195163963222991,23,33,19,9,24,7,16
7419,1,1,1.947814248128853,0.8752081121734672,5,5,2,0,5,5,0
7420,1,0,0.29654624212625513,0.4264019992981861,5,4,1,1,3,1,4
7421,0,0,5.427388625686147,0.004375329032890063,29,42,25,5,37,5,24
7422,1,1,5.311244865020358,0.9950884637415215,21,35,25,1,34,19,2
7423,0,0,1.3967052816307504,0.1983394540602732,18,26,15,7,19,7,11
7424,0,0,1.5800140205350983,0.17079349638187402,12,15,9,3,12,2,10
7425,0,1,1.830521234129046,0.8618238089351848,10,12,7,1,11,8,2
7426,1,1,7.207741811505243,0.9992597202224323,18,25,13,2,23,16,2
7427,1,1,1.211386460463227,0.7705441753109878,15,19,11,3,16,11,4
7428,1,0,1.145445615180356,0.24132194296621745,18,25,13,6,19,7,11
7429,1,1,5.4956536836341865,0.9959122061496667,12,18,9,1,17,11,1
7430,0,0,0.14714270405888197,0.46328055108126154,21,29,16,5,24,6,15
7431,0,0,0.2058033813614506,0.44872998895645766,5,5,3,3,2,3,2
7432,0,0,3.6556600052515833,0.02519332710115363,18,25,15,5,20,5,13
7433,0,0,3.0404121248539218,0.0456332190443518,8,8,4,0,8,0,8
7434,1,1,2.8649450718709537,0.946086090910621,14,20,14,4,16,11,3
7435,0,1,0.7559132140866731,0.6804657914689285,12,14,7,5,9,6,6
7436,0,0,2.8599721259745565,0.05416812855970332,19,24,16,3,21,5,14
7437,1,1,2.5709668447039284,0.928969519775372,7,8,5,1,7,6,1
7438,0,1,0.4288718064747836,0.6056042340810289,8,9,5,3,6,5,3
7439,0,0,1.9054759352260575,0.12948996094016219,27,39,23,10,29,11,16
7440,0,0,8.15226328848367,0.00028799963948900054,25,35,19,4,31,4,21
7441,0,0,1.6876007304020415,0.15609162806892618,13,15,9,3,12,5,8
7442,0,0,4.147896782064393,0.01555192418763851,17,24,14,4,20,4,13
7443,1,0,0.5330352475481923,0.36980924338747756,12,14,7,2,12,3,9
7444,1,1,4.455706173607062,0.9885211766296318,14,20,11,2,18,12,2
7445,0,0,5.137101747695482,0.005840380965893455,12,13,5,1,12,1,11
7446,0,0,3.3401191757276467,0.03422021881184034,13,15,7,4,11,4,9
7447,1,1,3.3638696822014054,0.9665560918849481,18,28,18,3,25,15,3
7448,0,0,3.218140734755359,0.0384887329718977,21,31,19,5,26,5,16
7449,1,1,1.3336687137615384,0.7914468355564981,7,8,4,1,7,6,1
7450,0,0,3.5264270807016063,0.02856958135844534,20,27,17,3,24,5,15
7451,1,1,2.677002079606755,0.9356558724671165,5,6,3,0,6,5,0
7452,1,1,5.603305112651354,0.9963278721866675,52,84,53,17,67,32,20
7453,1,1,0.968553564148487,0.7248310985847013,27,40,22,14,26,13,14
7454,1,1,1.8051274854286767,0.8587719550371266,7,9,7,0,9,7,0
7455,0,0,5.192888766796623,0.005525235968054432,21,25,13,3,22,5,16
7456,0,0,0.5249336786382263,0.37169930019272857,11,12,6,3,9,3,8
7457,1,1,1.618072831172343,0.8345291781645319,12,15,6,4,11,7,5
7458,0,0,0.2288614100774251,0.44303307964360084,12,15,7,5,10,6,6
7459,1,1,3.5827293232111064,0.9729522010463642,12,15,10,2,13,10,2
7460,1,0,1.2365064411953153,0.22504467557286156,27,36,20,7,29,11,16
7461,0,0,1.509227823545837,0.18105325785633053,14,17,11,1,16,2,12
7462,1,0,1.7132168510468957,0.15274694077659312,14,17,10,5,12,5,9
7463,1,1,1.042061043175891,0.7392474899412749,4,3,1,0,3,4,0
7464,0,0,2.7396000211388136,0.060676696119255635,32,46,32,10,36,14,18
7465,1,1,1.6082357298824985,0.833166296618409,23,33,22,8,25,15,8
7466,0,0,2.7599420400166332,0.059527610729677494,40,66,40,14,52,15,25
7467,1,1,2.2359662330737518,0.9034331177588418,16,23,15,5,18,13,3
7468,0,0,5.733046796435194,0.0032267534628078742,16,22,13,2,20,3,13
7469,1,0,0.6699558523213764,0.3385067262713447,21,29,17,7,22,7,14
7470,0,0,1.7041453702722125,0.15392463106450804,19,24,12,4,20,5,14
7471,0,0,1.7013045264348192,0.1542949632233589,10,12,8,0,12,0,10
7472,0,0,6.543299844255631,0.0014376599260074174,15,17,10,0,17,0,15
7473,1,1,0.6532937436622415,0.6577523159585476,4,3,1,1,2,3,1
7474,1,1,2.8493817587043573,0.9452867163060356,27,40,26,10,30,15,12
7475,0,0,0.0070284861118543596,0.4982428857054282,24,33,19,9,24,11,13
7476,0,0,3.4206089628557366,0.03165755508185919,19,25,14,7,18,5,14
7477,1,1,0.15916570518642015,0.5397076331593949,11,12,7,3,9,7,4
7478,1,1,2.5131115163193063,0.9250558896358465,11,14,10,1,13,10,1
7479,0,0,3.205431689695187,0.038961829573335494,20,25,13,4,21,5,15
7480,0,1,0.24012311521145935,0.5597439888526126,13,18,10,7,11,8,5
7481,0,0,0.3232364272707988,0.41988720885222786,13,16,9,3,13,4,9
7482,1,1,3.753145671943442,0.9770931427040392,7,9,6,0,9,7,0
7483,1,1,2.3358425072470945,0.9118023162898983,14,19,11,3,16,11,3
7484,0,0,1.7320556104518943,0.15032483344995728,8,11,5,3,8,2,6
7485,1,1,2.910367243404309,0.9483565537558715,15,18,9,5,13,10,5
7486,1,1,6.229787391278508,0.998034002097788,26,41,29,4,37,19,7
7487,1,1,1.6968387231303073,0.8451214028383296,23,32,18,7,25,12,11
7488,0,0,1.8855314233373166,0.13175481378631926,14,17,9,2,15,3,11
7489,0,0,5.306108772450706,0.004936702402087767,16,18,10,3,15,3,13
7490,1,1,2.9441586653536778,0.9499866834142107,8,10,4,2,8,6,2
7491,0,0,6.625372930365415,0.0013245290226299167,13,16,9,1,15,1,12
7492,0,0,5.27586738642416,0.0050875043347724525,19,24,13,3,21,5,14
7493,1,1,0.8174153424671677,0.6936874137787743,2,1,0,0,1,2,0
7494,0,0,1.6649800994707213,0.1590946100589795,21,30,20,7,23,9,12
7495,1,1,0.574737386891663,0.6398555822866918,2,1,0,0,1,2,0
7496,1,1,7.681773994604552,0.9995390564826028,13,20,13,0,20,13,0
7497,0,0,2.2853740949884775,0.09234153774052378,21,29,17,5,24,6,15
7498,1,1,2.272004523102288,0.9065317733126707,12,14,10,3,11,9,3
7499,1,1,1.945864454595235,0.8749950020827884,8,9,4,3,6,4,4
7500,0,0,2.2843014361397405,0.09243148151127678,16,19,11,3,16,3,13
7501,1,1,0.035750176559901536,0.5089365923572172,12,14,6,4,10,6,6
7502,0,0,5.8838217848144,0.002776394762574075,17,21,12,0,21,0,17
7503,1,1,2.3458539024419327,0.9126041089413642,7,8,5,0,8,7,0
7504,1,1,6.382247629644885,0.9983115384974733,16,26,16,2,24,14,2
7505,0,0,2.2730976191168693,0.09337564771553541,18,23,15,3,20,3,15
7506,0,0,2.3107917812626506,0.09023312540955297,6,6,2,0,6,0,6
7507,0,0,3.706617021907552,0.023971713852689147,20,24,12,5,19,5,15
7508,1,0,0.9611634951884525,0.27664530423990985,13,17,12,4,13,6,7
7509,1,1,2.0139324694375924,0.8822521545335374,11,14,7,3,11,8,3
7510,1,1,4.120810314042292,0.9840278923595206,18,26,17,2,24,15,3
7511,1,1,1.7436789082467863,0.8511537525577615,14,18,12,2,16,9,5
7512,1,1,3.0330502896264293,0.9540450923462465,4,4,2,0,4,4,0
7513,1,1,3.762114268655213,0.9772930224337563,22,34,22,6,28,17,5
7514,1,1,0.3156731942316253,0.5782694160307277,24,34,22,13,21,12,12
7515,1,1,2.504306862646092,0.9244431960611569,9,11,6,1,10,8,1
7516,1,0,0.4421185031326682,0.39123628830047563,20,27,18,5,22,9,11
7517,1,1,7.29225128970919,0.9993196695022317,31,54,37,5,49,23,8
7518,1,1,2.3607604847657226,0.9137857363875308,13,14,7,4,10,8,5
7519,0,1,1.4565903248034155,0.8110106198212745,7,7,4,1,6,6,1
7520,0,0,2.7255756413619103,0.06148095819796218,24,33,19,8,25,9,15
7521,0,0,0.12235750013884528,0.469448731622112,13,16,9,5,11,7,6
7522,0,1,0.8692393628514519,0.7045874005842152,9,11,6,3,8,6,3
7523,1,1,0.574737386891663,0.6398555822866918,2,1,0,0,1,2,0
7524,0,0,6.4813520852848585,0.0015293956041220191,21,26,13,6,20,5,16
7525,0,1,3.1197202675946265,0.9576988971680329,15,20,12,4,16,9,6
7526,0,0,0.46573901204309465,0.3856252568666053,13,14,8,2,12,4,9
7527,1,1,1.5098900820095458,0.8190449164362794,4,4,2,0,4,4,0
7528,0,1,2.1415334278162543,0.8948749531882437,9,10,4,3,7,6,3
7529,1,1,3.7787528977581237,0.9776593388671835,10,15,9,0,15,10,0
7530,0,0,4.419390600569065,0.011898294055027736,16,18,10,1,17,2,14
7531,0,0,2.7293711146932167,0.061262319563427425,15,19,12,2,17,4,11
7532,0,0,0.4754893996974856,0.3833178019973833,6,5,2,1,4,2,4
7533,0,0,3.0110220147812896,0.04693041188119074,20,25,12,2,23,3,17
7534,0,0,3.879826317400062,0.020236440401067424,33,48,28,8,40,10,23
7535,1,1,2.764352911455367,0.9407188485873522,10,10,4,2,8,7,3
7536,1,0,1.1003031225829831,0.2496831026716474,15,18,6,4,14,5,10
7537,1,1,5.204298004829399,0.9945371020989965,12,18,11,0,18,12,0
7538,0,0,3.706974176477101,0.023963358902504672,18,21,12,3,18,4,14
7539,1,1,1.9289493271236509,0.8731330806733048,11,13,7,3,10,7,4
7540,1,1,3.248728177240293,0.9626273845952473,23,34,22,5,29,15,8
7541,1,1,2.883169480291318,0.947008145441337,27,38,23,9,29,14,13
7542,1,1,2.441962437441511,0.9199716890197661,10,14,10,1,13,9,1
7543,0,0,1.0663159765294228,0.25610431465507977,3,2,0,0,2,0,3
7544,0,0,2.4703066183399836,0.07796619026215534,12,11,4,2,9,3,9
7545,1,1,0.574737386891663,0.6398555822866918,2,1,0,0,1,2,0
7546,1,1,0.6441899775076971,0.6556999956163765,12,14,7,5,9,5,7
7547,0,0,1.3980015945584063,0.19813341971647336,32,45,24,12,33,13,19
7548,1,1,1.5351466815739938,0.8227580876001245,9,10,5,2,8,7,2
7549,0,0,0.1414523260013716,0.46469576504360266,12,14,7,5,9,6,6
7550,0,0,1.3467255760023775,0.20640621564673134,21,32,18,7,25,7,14
7551,0,0,0.26337400823497514,0.4345344838659654,11,14,8,5,9,5,6
7552,1,1,0.04413786269339082,0.5110326746218967,9,11,7,5,6,6,3
7553,0,0,3.512729145545795,0.02895220997796155,22,30,16,6,24,5,17
7554,0,0,4.605055013364274,0.009902119195422943,12,13,4,1,12,1,11
7555,0,1,1.7083595728942977,0.8466233922273452,9,10,6,2,8,6,3
7556,1,1,3.8865957435867373,0.9798973415193271,26,36,18,9,27,15,11
7557,0,0,1.7348454520505021,0.14996884209091066,17,21,11,3,18,5,12
7558,0,0,0.5745620066913604,0.3601848333908503,18,24,15,2,22,4,14
7559,1,1,1.8154162958766626,0.860015209348586,21,30,17,8,22,10,11
7560,0,0,2.0777595083281977,0.11127734656130805,21,30,19,5,25,7,14
7561,1,1,1.262493949306994,0.7794551284966459,6,6,2,2,4,4,2
7562,1,1,2.907057594184888,0.9481942183076477,7,9,6,0,9,7,0
7563,1,1,1.922669345081823,0.8724358047472807,13,16,9,3,13,6,7
7564,1,0,2.40114738423899,0.08308524454432398,12,14,6,3,11,4,8
7565,0,0,4.873460034339724,0.007588830328581597,15,18,10,3,15,3,12
7566,0,0,2.767502586369324,0.059105747444669454,12,16,10,4,12,4,8
7567,1,1,1.3306921944142636,0.790955108808862,17,24,15,4,20,9,8
7568,0,0,2.770808527052525,0.05892216437068032,9,11,6,1,10,1,8
7569,0,1,1.3740648688709511,0.7980361004686931,20,25,16,6,19,12,8
7570,1,0,1.0814900304680721,0.2532241458081096,17,22,12,3,19,4,13
7571,0,0,1.9975943857765666,0.11945572754533729,17,21,12,4,17,5,12
7572,0,0,0.3944659218271481,0.4026426848026107,12,17,11,4,13,4,8
7573,0,0,1.0874168417931713,0.25210501595111356,17,22,14,4,18,6,11
7574,1,1,0.3970742646940552,0.5979845182466301,6,5,3,1,4,4,2
7575,1,1,0.574737386891663,0.6398555822866918,2,1,0,0,1,2,0
7576,0,1,0.35196927086212604,0.5870950403749289,22,30,14,9,21,10,12
7577,0,0,7.120925033402832,0.0008073665932674112,23,30,20,3,27,4,19
7578,0,0,2.543796269005954,0.07284436463430366,14,17,9,1,16,1,13
7579,0,0,3.8369314986805056,0.02110464685972757,9,10,6,0,10,0,9
7580,0,0,1.26550976232594,0.22002687562698608,26,37,25,8,29,9,17
7581,0,0,0.2769145907986148,0.4312103669805588,13,15,7,4,11,5,8
7582,0,0,0.6624467829098872,0.340190190078284,14,18,9,3,15,4,10
7583,0,0,6.850788923178675,0.0010575007017730176,25,33,19,4,29,4,21
7584,1,1,7.875528140377635,0.9996202160412307,28,49,35,4,45,25,3
7585,0,0,6.837156597516078,0.001072000046918653,29,44,25,10,34,9,20
7586,0,0,1.8808945762166096,0.1322861544619166,14,17,9,4,13,7,7
7587,1,0,0.1425711803416564,0.4644174570085632,5,4,0,2,2,2,3
7588,0,0,1.2818686521420226,0.21723230553040784,11,14,9,4,10,4,7
7589,0,0,3.3124740087789766,0.03514572776559011,11,12,8,2,10,3,8
7590,0,1,0.16469283128444734,0.5410803953119769,16,20,10,6,14,6,10
7591,0,1,0.742183077941382,0.6774730507019129,6,6,2,2,4,4,2
7592,1,1,5.493034007265804,0.9959015273606411,20,28,15,5,23,15,5
7593,1,0,0.18059307960130067,0.4549740361754804,15,21,12,6,15,6,9
7594,1,1,4.668985147647149,0.9907054139904824,20,29,19,5,24,15,5
7595,0,0,0.5718811209522519,0.3608028794094572,16,23,13,5,18,5,11
7596,0,0,7.725896980324376,0.00044105625254053926,17,20,11,0,20,0,17
7597,1,1,0.5917847917261074,0.6437745549261186,30,47,30,13,34,17,13
7598,0,0,5.3284577706300205,0.004828122582056338,10,10,4,0,10,0,10
7599,0,0,4.021194111245441,0.017615663916345503,32,47,29,9,38,9,23
7600,1,1,2.8461684525528046,0.9451202869554404,7,10,5,0,10,7,0
7601,1,1,4.033521485202602,0.9825964018912717,15,24,15,3,21,13,2
7602,0,0,6.9160826673508895,0.000990724679499233,27,39,26,7,32,6,21
7603,0,0,1.597522186004801,0.16832820850400676,17,21,13,1,20,2,15
7604,0,0,1.5917378602898782,0.16913953263405102,19,22,9,7,15,6,13
7605,1,1,1.832341255444848,0.8620404008090947,27,41,27,9,32,16,11
7606,0,0,2.639098815357772,0.06666408537798163,18,24,12,4,20,3,15
7607,0,0,3.4271134368239458,0.031458764409027506,10,10,4,0,10,0,10
7608,0,0,7.579064188526443,0.0005107782079898371,22,29,18,2,27,3,19
7609,0,0,5.423333932564637,0.004393027571229613,20,25,12,4,21,4,16
7610,1,1,1.4760996736688905,0.8139827365067434,5,5,4,0,5,5,0
7611,1,1,6.743462609899996,0.9988228281742165,18,27,16,2,25,15,3
7612,0,1,1.4696078227265155,0.8129977697000506,9,10,4,3,7,5,4
7613,1,1,1.1876846406978077,0.7663267083371862,7,9,4,1,8,6,1
7614,0,0,7.092667213559648,0.0008304871963710214,27,37,21,4,33,4,23
7615,1,0,0.5454469371025263,0.36692139808812063,15,20,11,6,14,6,9
7616,1,0,0.2597033974641521,0.4354366210672628,1,0,0,0,0,0,1
7617,1,1,0.04621800042602464,0.5115524437450276,24,36,22,13,23,11,13
7618,0,0,5.994291514086108,0.0024867432547232005,29,44,28,7,37,6,23
7619,0,1,0.7267685282548046,0.6740957481735801,15,19,11,5,14,7,8
7620,1,1,6.260944535658325,0.998094197608889,24,40,29,5,35,21,3
7621,1,1,0.4127084078585457,0.601737126092682,14,17,8,4,13,9,5
7622,1,1,1.6978334924849152,0.8452515647126767,20,24,12,6,18,11,9
7623,1,1,3.0786875341470994,0.9560050160701259,30,45,31,7,38,17,13
7624,1,0,0.7964285067617416,0.3107900137986084,14,17,9,4,13,4,10
7625,0,1,3.3039716269203137,0.9645648098486574,15,19,9,6,13,9,6
7626,1,1,3.131765387076916,0.9581841843960301,16,22,15,2,20,11,5
7627,0,0,0.23206065597265702,0.44224379497986854,7,7,4,3,4,3,4
7628,0,1,0.5702495452592349,0.6388207544209531,11,12,6,3,9,5,6
7629,0,0,0.6879828754857589,0.33448194275861187,12,17,10,5,12,5,7
7630,0,1,0.819324610190566,0.6940929547928975,19,25,14,8,17,10,9
7631,0,0,7.857007744191369,0.00038688049945845293,27,37,24,2,35,3,24
7632,0,0,6.593326649324011,0.0013676037077654524,22,29,18,2,27,3,19
7633,1,1,2.392008693539049,0.9162158930883683,20,27,16,5,22,11,9
7634,1,1,0.39475640406737256,0.5974271804606577,15,21,11,7,14,9,6
7635,1,1,1.530942292856358,0.8221441410733812,6,6,3,1,5,5,1
7636,0,0,4.648447963671856,0.009485614857418168,19,27,16,9,18,7,12
7637,0,0,4.902746760046116,0.007371415866732067,18,21,10,4,17,4,14
7638,0,0,3.59726968075491,0.026667771872176282,15,22,15,2,20,1,14
7639,1,1,4.11922328174025,0.9840029298035582,17,26,19,4,22,13,4
7640,1,1,3.777533756788155,0.9776326954193372,18,22,13,6,16,13,5
7641,1,1,1.8876705713982578,0.8684897023827561,8,9,5,1,8,6,2
7642,0,0,3.058955803223948,0.04483239687087315,26,36,19,10,26,11,15
7643,0,0,1.6282753232937286,0.1640667616430188,7,7,3,1,6,1,6
7644,1,1,2.488772990667451,0.923351007479496,10,11,5,3,8,7,3
7645,0,0,1.1912396734821025,0.23303729447406896,9,10,5,3,7,3,6
7646,1,1,5.508556864092747,0.9959644013652438,17,22,10,5,17,12,5
7647,0,0,0.6937396060751818,0.3332016962202171,10,11,5,5,6,4,6
7648,0,0,7.5390273584064245,0.0005316319498025468,34,50,32,8,42,9,25
7649,0,0,1.4184451550318924,0.19490544995687487,10,12,7,1,11,1,9
7650,1,1,1.2670620477835097,0.7802394041406739,4,3,1,0,3,4,0
7651,0,0,0.6202571716241729,0.3497229640151095,11,12,6,3,9,3,8
7652,0,0,4.383812187092826,0.012323926248319461,13,16,9,5,11,4,9
7653,0,0,4.161526339284799,0.015344626778735049,13,15,10,2,13,3,10
7654,1,1,2.125435095011028,0.8933508668682478,8,9,7,1,8,7,1
7655,0,0,1.381820880379808,0.2007167175898661,9,9,3,1,8,1,8
7656,0,0,2.660292277946205,0.06535747710254014,20,28,14,5,23,5,15
7657,0,0,3.8650184528403053,0.020532130106546975,11,13,5,3,10,2,9
7658,1,1,4.456995809536628,0.9885358009902969,9,13,6,0,13,9,0
7659,0,0,2.375422760946578,0.08506613579738243,22,28,15,5,23,8,14
7660,1,0,1.3784883012104783,0.2012518949386063,31,46,29,11,35,13,18
7661,1,1,1.86246580680488,0.8655840991048264,22,33,21,6,27,14,8
7662,0,0,1.6448558085878944,0.16180541436287876,30,44,26,10,34,11,19
7663,1,1,1.5713513386543503,0.8279761669526587,13,16,10,4,12,8,5
7664,1,0,4.7888331729211915,0.008253475481110661,27,36,22,8,28,10,17
7665,1,1,0.27114098315009305,0.5673729931937019,8,8,3,2,6,5,3
7666,0,0,1.3765912675400833,0.201557015115716,9,9,3,3,6,3,6
7667,1,1,0.18662446723671455,0.5465211724904742,8,9,5,2,7,6,2
7668,0,0,1.8095214305747793,0.14069597512484178,5,4,1,0,4,0,5
7669,1,1,1.2605093918706094,0.7791137842899479,8,9,3,3,6,5,3
7670,1,1,1.5440362221099777,0.8240507072965134,25,35,22,9,26,16,9
7671,0,0,0.2622199890331717,0.43481806423990366,4,3,0,1,2,1,3
7672,0,0,2.0085368613874954,0.11830951605746454,6,5,2,0,5,0,6
7673,1,1,2.630165453324514,0.9327779246191805,12,16,9,2,14,9,3
7674,0,0,0.6140328680507843,0.351139795981255,5,5,3,0,5,0,5
7675,0,0,0.15000499147801838,0.4625689137800051,27,40,24,10,30,10,17
7676,1,0,0.41589379833631357,0.3974997444444164,23,36,23,9,27,12,11
7677,1,0,0.3790171664003419,0.40636396643269956,6,5,2,1,4,2,4
7678,0,0,4.331273662254592,0.012980088772884035,16,19,10,5,14,4,12
7679,0,0,6.3985647119896765,0.0016611796890304564,34,48,29,5,43,9,25
7680,1,0,1.530131448813072,0.17797445407029078,24,33,17,9,24,10,14
7681,1,1,2.9115697994483383,0.9484154188769232,7,8,5,0,8,7,0
7682,1,1,2.2199317538859162,0.9020251645652418,15,20,12,3,17,9,6
7683,1,1,4.605338459985977,0.9901006593483083,20,27,16,5,22,15,5
7684,0,0,5.560507485213835,0.0038320823508306567,18,22,14,2,20,3,15
7685,0,0,0.4264410026720946,0.39497650671963935,28,43,26,12,31,11,17
7686,0,0,2.7841716644460672,0.058185526659731535,12,13,5,2,11,2,10
7687,1,1,1.3330824979742377,0.7913500589845027,6,6,4,1,5,5,1
7688,0,0,6.2987054589814475,0.0018353089359862684,17,19,10,3,16,3,14
7689,0,0,0.13549400615460372,0.4661782260766335,21,31,19,8,23,9,12
7690,0,0,1.2057271396816405,0.2304579573926907,7,8,6,0,8,0,7
7691,1,1,1.1094944881753461,0.7520348563982973,23,36,23,8,28,15,8
7692,0,0,4.060604225374316,0.016946466609627175,17,20,12,2,18,3,14
7693,0,0,2.4795666920107973,0.0773031031798238,7,7,2,1,6,1,6
7694,1,0,1.3701631013050237,0.20259349623968903,4,3,1,1,2,2,2
7695,1,1,2.7979904718449684,0.9425671363393373,10,12,7,2,10,8,2
7696,1,1,1.842914763688376,0.8632930668387058,22,29,19,8,21,13,9
7697,0,0,1.1018520816108612,0.24939303096763943,11,13,6,2,11,2,9
7698,0,0,0.5432951737497946,0.36742137435888444,8,7,2,2,5,3,5
7699,1,0,1.5893781845665018,0.1694713999943258,7,6,3,2,4,2,5
7700,1,1,1.1377048034453119,0.7572579889642173,11,13,7,3,10,6,5
7701,1,1,3.232882348270196,0.962053118826556,18,25,17,5,20,14,4
7702,1,1,1.1940363746103773,0.767462189226842,17,25,14,7,18,10,7
7703,0,0,1.164557398871736,0.23784016855356882,21,31,19,4,27,5,16
7704,0,0,5.102149529440136,0.006046868439669728,12,14,7,2,12,1,11
7705,0,0,5.847506136635606,0.002878778901754031,21,27,15,3,24,3,18
7706,0,1,2.022301691701151,0.8831187992920041,6,6,3,1,5,4,2
7707,0,0,0.028392399176876193,0.492902376998957,6,5,2,1,4,2,4
7708,0,0,2.6645985533329606,0.06509491633090991,6,5,1,1,4,1,5
7709,1,1,0.8598926002524716,0.7026382149710968,23,36,22,9,27,12,11
7710,0,0,5.834643603692612,0.0029159377841000422,22,33,22,0,33,0,22
7711,1,1,6.446947349804348,0.9984171550483569,16,26,19,0,26,16,0
7712,1,0,0.09181762788608072,0.4770617058276928,15,22,13,5,17,7,8
7713,1,1,2.2104233356682847,0.9011816326622785,5,5,4,0,5,5,0
7714,0,0,2.8530255038679946,0.054525135620995924,34,51,33,11,40,13,21
7715,1,1,1.6607096699847217,0.8403332448068569,15,18,10,3,15,10,5
7716,0,0,4.050261420385376,0.01711963395666871,13,15,7,1,14,1,12
7717,0,0,3.209634922126665,0.03880474918566523,15,20,10,3,17,2,13
7718,1,1,2.2576040792779715,0.9053044321601679,20,26,16,3,23,12,8
7719,1,1,2.618460543551958,0.9320402602147899,9,12,7,2,10,7,2
7720,0,0,5.986938178517546,0.0025050505326378314,21,29,14,2,27,3,18
7721,0,1,0.7203881659192923,0.6726924881219238,21,27,15,7,20,8,13
7722,0,0,0.9067674856695315,0.287661764841587,5,4,1,1,3,1,4
7723,1,1,2.044304100197101,0.8853708132965188,37,56,38,14,42,20,17
7724,0,0,2.4943104819303663,0.07625800013566708,15,18,11,1,17,2,13
7725,0,0,5.616760375169729,0.0036232271148698425,21,30,19,3,27,3,18
7726,1,1,4.095446353863729,0.9836243139710495,12,16,9,1,15,11,1
7727,1,1,1.8550970299879619,0.864724442751134,9,10,6,2,8,7,2
7728,1,1,1.688052335339018,0.8439678512701403,3,2,1,0,2,3,0
7729,0,1,3.5284857248454955,0.971487497518738,29,42,30,7,35,19,10
7730,1,1,3.562200754459708,0.9724066895758898,9,12,6,1,11,8,1
7731,1,1,3.904111832746786,0.9802394980403,10,15,9,0,15,10,0
7732,0,1,0.5108270680447697,0.6250003385027778,28,44,28,12,32,15,13
7733,0,0,2.5977041278970825,0.06928632500979992,7,8,5,3,5,1,6
7734,1,1,0.35243258222876284,0.5872073492129684,27,39,21,11,28,11,16
7735,1,1,2.6456837308778836,0.933744460713047,19,24,11,6,18,11,8
7736,1,1,0.574737386891663,0.6398555822866918,2,1,0,0,1,2,0
7737,0,0,3.7474594224925704,0.02303447355102528,20,27,16,4,23,5,15
7738,0,0,4.016988612741075,0.017688589383543896,6,5,2,0,5,0,6
7739,1,1,1.7146745118747018,0.8474416073833196,23,34,21,8,26,12,11
7740,1,0,0.9355586309748354,0.28179835080828286,19,27,17,8,19,8,11
7741,1,1,0.7498890272460788,0.6791545182870827,28,44,28,12,32,16,12
7742,0,0,1.5243134146859338,0.17882722514053206,7,6,2,1,5,2,5
7743,1,0,1.8018725980431498,0.14162326761921262,20,25,13,3,22,4,16
7744,1,1,4.233949922846808,0.9857120806198939,13,21,14,1,20,12,1
7745,0,0,4.006256881815217,0.017876029150903694,22,28,16,5,23,7,15
7746,1,1,0.3477471967817607,0.5860711736151418,4,3,1,1,2,3,1
7747,1,0,0.5735644297603235,0.3604147587597196,14,18,13,4,14,7,7
7748,0,0,2.306384155051805,0.09059560642084286,10,11,7,2,9,3,7
7749,0,0,3.2926654388331418,0.03582366674892379,20,26,15,4,22,4,16
7750,0,0,1.1605159366126174,0.23857354942600906,22,31,18,6,25,9,13
7751,0,0,2.8908494811425087,0.052607764041839866,19,27,17,4,23,6,13
7752,1,1,2.262606326743719,0.9057323978537851,13,19,15,0,19,13,0
7753,1,1,3.1067560434173647,0.9571705665929602,17,24,12,3,21,13,4
7754,1,1,1.63003116482051,0.8361739079998638,22,32,17,6,26,13,9
7755,1,1,3.642330242383573,0.9744772321002274,35,55,34,15,40,20,15
7756,0,0,4.8950957407218825,0.007427610502314441,16,18,10,2,16,3,13
7757,0,0,3.0886207453982752,0.043579086041392934,21,31,19,5,26,4,17
7758,1,1,2.4826480575007315,0.92291639633566,20,27,18,5,22,12,8
7759,0,1,3.7077081090644084,0.9760538011360362,13,18,11,2,16,10,3
7760,1,1,4.361044517624286,0.9873958452654845,18,23,12,5,18,11,7
7761,1,1,1.1375308977348924,0.7572260204773066,9,10,3,3,7,6,3
7762,0,0,2.074576309282331,0.11159253781757072,15,16,6,2,14,3,12
7763,0,1,1.0325010545773239,0.7374004900371303,7,6,2,2,4,4,3
7764,0,0,0.1957524096137433,0.4512175727116372,16,20,11,4,16,5,11
7765,1,1,0.34478421515084445,0.5853521958740271,13,17,9,5,12,6,7
7766,0,0,3.2787180341294144,0.03630854600784117,31,44,30,4,40,8,23
7767,0,0,0.8409163950883516,0.30134181570926466,15,19,9,5,14,6,9
7768,1,0,0.96088709025638,0.2767006197862266,7,9,6,2,7,1,6
7769,1,1,4.597437300350834,0.990022916723785,12,16,10,1,15,11,1
7770,0,0,1.7773335355831739,0.14463270080559587,36,60,39,11,49,12,24
7771,1,0,0.13986164711725113,0.4650914742986446,15,19,11,4,15,8,7
7772,0,1,0.3611272122494933,0.5893132729450875,18,24,14,9,15,9,9
7773,0,0,5.099279537228868,0.006064142441312481,32,52,32,8,44,12,20
7774,0,0,4.656039977158283,0.009414548040843518,24,33,22,5,28,4,20
7775,1,1,0.93722338092291,0.718538452249387,25,36,20,11,25,11,14
7776,0,0,2.0466546642280345,0.11439084552856371,8,7,4,3,4,3,5
7777,1,1,0.36241237956260086,0.5896242774320222,12,14,7,4,10,5,7
7778,1,0,2.910124091975504,0.05165535622428752,14,17,10,1,16,2,12
7779,1,1,1.1265125734239205,0.7551947327888687,13,15,7,4,11,8,5
7780,1,0,1.7821080549450627,0.1440430271468106,38,57,32,11,46,12,26
7781,0,0,2.687827124454278,0.06369548229874722,13,15,6,3,12,2,11
7782,0,0,2.031461330428677,0.11593905572050567,7,7,4,0,7,0,7
7783,1,1,1.8434639987267545,0.8633578736077886,17,24,12,6,18,8,9
7784,1,1,3.5559727530513046,0.9722390877747417,13,19,10,4,15,11,2
7785,1,1,3.6656885473997436,0.975051790875747,9,13,6,0,13,9,0
7786,1,1,2.226105663112464,0.9025694358822298,10,13,6,2,11,8,2
7787,0,0,7.185170601752555,0.0007571659904377359,21,26,13,2,24,2,19
7788,1,1,1.8252316022389037,0.8611926944627507,9,11,6,2,9,7,2
7789,1,1,0.0052279890720023925,0.5013069942911188,9,10,4,3,7,5,4
7790,0,0,4.321575315721532,0.01310492884526393,21,27,15,3,24,4,17
7791,1,1,2.237803995462255,0.9035933284820411,14,17,11,3,14,10,4
7792,1,1,2.766323208768465,0.9408286305892807,18,27,20,4,23,15,3
7793,1,1,2.4796567964179728,0.9227033234824937,13,17,9,3,14,10,3
7794,0,0,3.5371980027604044,0.028272165154505813,20,25,16,4,21,7,13
7795,1,1,0.9272592690698025,0.7165189199465034,7,6,2,2,4,4,3
7796,1,0,2.5084680139430184,0.0752666688013901,10,11,8,0,11,0,10
7797,1,1,2.5217271308379487,0.9256510055055601,11,13,7,2,11,7,4
7798,0,0,6.141473530967,0.0021471305205444935,23,32,20,9,23,6,17
7799,1,1,2.334238594652282,0.9116732462574055,20,25,14,9,16,11,9
7800,1,1,5.843026017680651,0.9971083322707642,19,30,23,1,29,18,1
7801,1,1,2.469598657699331,0.9219829010346288,22,29,19,6,23,11,11
7802,0,0,2.349943230083416,0.08707028492124935,14,18,12,3,15,3,11
7803,0,0,1.971183914427166,0.12226177959463114,21,31,21,7,24,7,14
7804,0,0,3.993849117039259,0.018095173914701057,25,34,17,5,29,5,20
7805,0,0,1.8780020730412446,0.13261852814345387,24,35,23,6,29,10,14
7806,0,0,3.679249975978583,0.024620433259835206,14,17,11,3,14,3,11
7807,0,0,3.3830715354110747,0.03282873039728029,9,8,4,2,6,2,7
7808,1,1,3.198277643664876,0.960769410417491,21,28,17,3,25,15,6
7809,0,0,6.66131983559953,0.0012778216658200225,22,33,19,3,30,2,20
7810,1,1,5.436489384581762,0.995664137273747,16,23,15,2,21,14,2
7811,1,0,3.168168200474519,0.04038133917946496,29,42,26,9,33,13,16
7812,1,1,1.9228949242828326,0.8724609077019229,6,6,3,1,5,5,1
7813,1,1,1.5254520241002674,0.821339916290117,12,14,8,4,10,6,6
7814,1,1,1.1338219597140686,0.7565435383633141,15,18,12,4,14,10,5
7815,1,1,4.5065213522774705,0.9890836943677621,28,43,27,9,34,18,10
7816,1,1,6.473784040517142,0.998459003856459,27,38,23,4,34,22,5
7817,0,0,1.6998775384316476,0.15448125994494222,11,12,6,1,11,1,10
7818,0,0,4.406624911709696,0.012049315702069796,13,14,7,0,14,0,13
7819,0,0,3.71332661988231,0.02381522930611335,12,14,9,2,12,3,9
7820,1,1,3.390376363301324,0.967402415391271,24,39,30,5,34,19,5
7821,0,1,1.7499317139533133,0.8519441888951522,9,10,4,2,8,6,3
7822,0,0,4.208862685029285,0.014645581807163244,23,31,18,6,25,8,15
7823,0,0,2.3500619818655224,0.08706084591771923,28,41,26,7,34,9,19
7824,1,1,3.300198942427352,0.9644356349918093,13,17,9,3,14,9,4
7825,0,0,3.0992837510883966,0.04313680917674523,23,31,17,5,26,6,17
7826,1,1,2.895216541447387,0.947609466293838,19,23,12,4,19,10,9
7827,0,0,1.269684714104137,0.21931122861126295,9,8,3,2,6,2,7
7828,0,0,2.8702513111961467,0.053643892455152,19,27,15,5,22,4,15
7829,1,1,2.615297040160968,0.9318396059919336,10,13,7,2,11,6,4
7830,0,0,3.5113658355206314,0.02899056267163469,16,19,9,3,16,3,13
7831,0,0,0.8982821368876135,0.2894036466607913,5,4,1,1,3,1,4
7832,0,1,1.344811871099837,0.7932801382158241,15,20,12,5,15,10,5
7833,1,0,0.3549418799348536,0.41218454326585363,13,18,11,6,12,6,7
7834,0,0,2.3208379762030837,0.08941181006349652,19,24,14,4,20,4,15
7835,0,0,1.4578953183625751,0.18878944186799895,7,7,3,1,6,2,5
7836,1,1,2.7189037243560574,0.9381329369666033,19,27,16,4,23,14,5
7837,0,1,0.74131851450922,0.6772841117464529,5,5,2,1,4,4,1
7838,0,0,0.3956652420388807,0.4023542561547774,7,6,2,1,5,3,4
7839,1,1,0.583649998657932,0.6419068378263535,6,6,2,2,4,4,2
7840,0,0,1.394238082626129,0.19873203293983632,17,22,11,3,19,4,13
7841,0,0,0.37054308107492484,0.40840980055397713,9,10,5,3,7,4,5
7842,1,1,2.233256027095197,0.9031964160674553,7,9,6,0,9,7,0
7843,0,1,0.8406485152071741,0.6986017832186924,11,13,7,3,10,5,6
7844,1,1,0.6498722368967349,0.6569816709726399,12,15,7,4,11,7,5
7845,1,1,3.836669288122459,0.9788899353889454,31,50,31,9,41,20,11
7846,1,1,5.5083796785081285,0.9959636891384078,44,67,41,16,51,25,19
7847,0,0,0.8044535142690226,0.30907367587051127,18,24,13,5,19,8,10
7848,0,0,0.9063721255300363,0.28774278586651414,18,22,11,4,18,7,11
7849,0,0,2.1062856305985984,0.10848739060703572,24,35,22,6,29,8,16
7850,0,0,1.2844454202896225,0.2167944648752509,15,20,11,4,16,4,11
7851,1,1,3.219330466483828,0.9615552716800397,20,25,12,6,19,11,9
7852,0,0,5.897291408344809,0.002739350261634299,15,19,11,0,19,0,15
7853,0,1,0.5270414810991877,0.6287928204719224,35,56,36,17,39,17,18
7854,0,0,1.6138015731606097,0.16606148390791975,12,14,6,2,12,3,9
7855,1,1,2.298956041420859,0.9087905418741672,9,10,5,2,8,7,2
7856,1,1,2.296644268904095,0.9085987371973,10,11,6,2,9,7,3
7857,0,0,0.44330394234635984,0.3909539881343562,31,44,27,8,36,12,19
7858,0,0,1.5565571861371383,0.17414122359695017,11,14,7,1,13,1,10
7859,1,1,1.1499466411647867,0.7595011706049855,6,6,3,1,5,4,2
7860,1,1,6.693529678944851,0.9987626308596178,22,32,19,6,26,16,6
7861,1,1,5.931234453370575,0.9973518291875882,17,26,21,1,25,16,1
7862,1,1,3.5883264914859714,0.9730991080582672,26,35,21,7,28,16,10
7863,1,1,6.539859513996739,0.998557392678762,21,32,23,2,30,19,2
7864,1,1,0.85813100669339,0.7022700202318432,32,45,25,12,33,15,17
7865,1,1,1.2775041501419917,0.7820246280710161,8,10,6,2,8,6,2
7866,0,0,4.606278594420991,0.009890130315401646,21,28,18,4,24,4,17
7867,0,0,4.100781839846415,0.016289965959022767,46,75,49,17,58,18,28
7868,1,1,4.272876773874375,0.9862500776473642,14,21,10,2,19,12,2
7869,0,0,0.848299322344743,0.29978973512094553,9,9,4,1,8,2,7
7870,1,1,4.765169092093752,0.9915505542943251,22,32,18,7,25,15,7
7871,1,1,2.7595850992162614,0.9404524031279768,25,36,19,8,28,12,13
7872,0,1,0.47030115517753823,0.6154550333055429,12,14,7,3,11,6,6
7873,0,0,1.5729044937124645,0.17180272730993007,9,10,6,2,8,3,6
7874,1,0,0.15111083642704282,0.46229401333382614,17,22,10,4,18,5,12
7875,1,1,5.686038841940574,0.9966184669434864,25,35,21,6,29,17,8
7876,0,1,0.5546832875799235,0.6352214653985817,5,4,2,1,3,3,2
7877,1,1,5.311235525246338,0.9950884180939769,25,40,27,4,36,19,6
7878,1,1,0.5021330879436039,0.6229604836877212,19,25,14,8,17,11,8
7879,0,0,3.3854292667454295,0.03275395245810364,14,17,9,3,14,2,12
7880,0,0,2.3391402797636562,0.08793284053427342,20,26,15,2,24,4,16
7881,0,0,0.6999693093430572,0.3318190323806911,15,17,6,4,13,5,10
7882,1,0,0.41070308605599704,0.3987435462929151,15,19,12,4,15,6,9
7883,1,1,2.948624508775504,0.9501984386099276,12,16,9,2,14,10,2
7884,0,0,2.2528538538009544,0.09510358145289755,11,12,6,1,11,1,10
7885,1,1,1.0836299245679664,0.747180298025783,7,8,3,2,6,5,2
7886,0,0,4.408662590202126,0.012025083015643534,15,16,7,1,15,2,13
7887,0,0,4.781695390794502,0.008312106310266465,16,18,11,1,17,2,14
7888,1,0,0.265426274355703,0.4340302807200701,20,26,15,5,21,7,13
7889,1,1,5.072332494309849,0.9937712569051088,29,41,24,8,33,17,12
7890,0,0,1.354419965060947,0.20514870098357907,10,12,6,4,8,5,5
7891,1,1,2.209693280607288,0.9011165998074181,22,29,16,7,22,11,11
7892,1,1,1.399803163276781,0.8021526516854383,8,9,4,1,8,6,2
7893,0,1,0.5200725434671538,0.6271647292456011,5,4,1,2,2,3,2
7894,1,1,2.085353109360839,0.8894714065539651,18,25,15,5,20,13,5
7895,1,1,4.6450451951633305,0.9904823605400017,16,24,16,2,22,14,2
7896,1,1,2.1837842252427735,0.8987838484167895,13,17,12,3,14,10,3
7897,1,1,0.9784225764129753,0.7267951089175153,11,14,9,2,12,5,6
7898,0,0,1.3418140927380504,0.2072118899637223,3,2,0,0,2,0,3
7899,0,0,1.4016373990660813,0.1975564094958655,16,22,13,6,16,6,10
7900,0,0,0.5919273507411127,0.3561927528451403,13,15,7,5,10,5,8
7901,0,0,3.3894806857250295,0.0326258416127283,17,21,11,3,18,4,13
7902,1,1,1.3154016910093618,0.7884156504244675,26,38,24,8,30,15,11
7903,0,0,2.262711575435386,0.09425861626810728,23,30,18,7,23,10,13
7904,1,1,2.598646787169095,0.9307744383862382,24,35,25,6,29,15,9
7905,1,1,3.265792523899741,0.9632364667370903,10,14,8,1,13,9,1
7906,0,0,0.457423516814159,0.3875972149743655,9,9,5,1,8,4,5
7907,0,0,1.2535676975860217,0.22208316433551922,15,19,9,4,15,5,10
7908,0,0,7.680936940136142,0.00046132933568421297,28,39,26,5,34,8,20
7909,1,0,3.1518843973063158,0.04101709187423552,29,40,22,9,31,11,18
7910,1,1,1.883494415117999,0.8680119868283724,11,13,8,3,10,8,3
7911,1,1,2.6314740738948013,0.9328599329489878,12,16,9,2,14,10,2
7912,0,0,5.747604856169184,0.0031802667859665013,18,23,10,2,21,2,16
7913,1,1,2.4548812510618614,0.9209176752778655,26,38,25,5,33,17,9
7914,0,0,6.014293504984956,0.0024376176284276463,29,39,26,7,32,6,23
7915,0,0,0.4878841030027201,0.38039214543650535,14,14,7,2,12,4,10
7916,1,1,3.0747877401539405,0.9558407009784212,17,24,12,6,18,10,7
7917,0,0,5.769715152207182,0.0031109381591390983,22,29,15,2,27,3,19
7918,0,0,2.563165871376454,0.07154695432771918,12,14,7,2,12,1,11
7919,0,0,3.845127782122173,0.020935980852572755,15,19,10,0,19,0,15
7920,0,1,1.9841645439250752,0.879124405245294,6,6,4,0,6,6,0
7921,1,1,5.851153273572607,0.9971316712155772,12,17,12,0,17,12,0
7922,1,0,0.03805979801887238,0.490486198900865,21,31,20,7,24,11,10
7923,0,1,0.5071693343440407,0.6241426662893101,13,15,6,4,11,7,6
7924,1,1,2.3950272464208737,0.9164473193462819,17,24,17,4,20,11,6
7925,0,1,0.2332307748782938,0.5580448119507566,13,15,8,3,12,8,5
7926,1,1,1.6832913991315306,0.843339874872669,7,9,6,0,9,7,0
7927,1,0,6.560852533829047,0.001412680644446218,39,59,37,12,47,13,26
7928,0,1,0.4327831393712973,0.6065380602157227,31,46,25,14,32,14,17
7929,1,1,2.450685727139918,0.9206115822562371,21,31,19,7,24,12,9
7930,0,0,2.7412921378879216,0.060580325530051216,8,8,4,1,7,1,7
7931,1,1,4.298462453935862,0.986592759511277,21,29,19,6,23,13,8
7932,0,0,1.9259182078885275,0.1272030614927978,25,33,15,8,25,8,17
7933,0,1,1.0360694025148498,0.7380908829428368,7,7,4,1,6,5,2
7934,0,0,5.015829076084021,0.006588435844819829,16,19,11,2,17,3,13
7935,1,1,4.9225504432958935,0.9927720845700648,20,30,22,4,26,17,3
7936,0,0,2.2426644599167678,0.09598409445235656,6,6,4,1,5,1,5
7937,1,0,4.03722269444647,0.01734041771646111,29,41,24,6,35,8,21
7938,1,1,3.031871057664168,0.9539933635246262,14,18,9,3,15,11,3
7939,1,1,3.3900995902851188,0.9673936862299761,7,9,5,0,9,7,0
7940,1,1,6.818409956199034,0.9989077361576789,10,15,10,0,15,10,0
7941,0,0,0.5813424859167516,0.3586237462095927,6,6,3,1,5,1,5
7942,0,0,2.515598965908798,0.07477184395288472,13,13,5,2,11,3,10
7943,1,1,0.5618002536000355,0.6368689818163813,20,26,17,7,19,8,12
7944,0,0,1.6644059491533851,0.15917143694192104,9,9,3,1,8,1,8
7945,1,1,4.731458695589183,0.9912633956907281,20,30,20,3,27,17,3
7946,1,1,1.3054971112743436,0.7867586841614745,18,24,13,7,17,7,11
7947,0,0,4.678031205623055,0.009211656812535884,36,54,33,10,44,12,24
7948,1,1,8.38198904353994,0.9997710983153861,20,36,24,5,31,18,2
7949,0,0,0.10787408621205985,0.47305760036562694,9,10,5,3,7,2,7
7950,0,0,0.39648858451027547,0.40215628678032755,13,15,7,5,10,5,8
7951,0,0,1.2535994398579513,0.2220776805181346,15,18,9,4,14,5,10
7952,1,1,1.8489908598881888,0.8640085748404969,7,7,3,1,6,5,2
7953,1,1,0.38543247380123313,0.5951826785031142,29,42,23,10,32,13,16
7954,1,1,5.377749131845766,0.995403024564959,23,38,26,5,33,20,3
7955,0,0,1.199255859339746,0.23160762143857327,31,46,27,12,34,14,17
7956,0,0,5.76733064221598,0.0031183419138598456,21,29,15,4,25,5,16
7957,1,0,0.22040789603025202,0.445120017137718,17,22,10,8,14,8,9
7958,1,0,3.145355745406803,0.04127466528719259,20,27,14,3,24,4,16
7959,0,1,0.7968511899189978,0.6893005175149542,14,20,12,5,15,7,7
7960,0,1,2.0002459110991797,0.8808228946482153,25,35,18,9,26,13,12
7961,0,1,1.0190954769615843,0.734796371900654,16,19,9,5,14,9,7
7962,0,0,2.888080051405144,0.05274596408287269,16,21,12,4,17,6,10
7963,0,0,0.21948214545351918,0.44534867819555957,13,16,10,3,13,4,9
7964,0,0,1.19461710324609,0.23243418772902646,10,12,6,1,11,1,9
7965,0,0,3.618864368537106,0.02611293991476593,30,45,25,8,37,9,21
7966,0,0,0.9236439608502622,0.28421599433623546,7,6,3,2,4,2,5
7967,1,1,0.3329273667247693,0.5824714793170966,17,25,16,6,19,11,6
7968,0,0,1.6141317238969108,0.16601576800152384,17,23,15,3,20,4,13
7969,1,1,3.9697076606279977,0.981470859356196,14,17,9,3,14,11,3
7970,0,0,6.273809699594807,0.0018814868094273463,17,23,14,5,18,4,13
7971,0,0,6.747951534489992,0.001171905611515811,19,25,17,4,21,3,16
7972,0,0,1.717061595348203,0.15225003601923326,7,6,1,2,4,2,5
7973,0,0,4.857981346331564,0.007706297014129726,27,38,26,3,35,4,23
7974,1,1,1.794451709996568,0.8574722024085799,4,4,2,0,4,4,0
7975,0,0,2.8643051669216373,0.05394655816744043,24,34,23,5,29,7,17
7976,1,1,2.146586965430466,0.8953494107331592,10,13,7,2,11,8,2
7977,1,1,4.398859421794514,0.987857891757876,9,11,4,2,9,7,2
7978,1,1,2.9217310292300294,0.948910283854868,9,12,7,1,11,8,1
7979,0,0,1.8227768990583542,0.1391010006051805,11,13,9,1,12,3,8
7980,1,1,4.929021140871544,0.9928183684365418,15,22,13,2,20,13,2
7981,0,0,3.5194579804305395,0.028763634074078226,7,8,4,0,8,0,7
7982,1,1,4.827754369984191,0.992059086661403,24,40,26,5,35,18,6
7983,1,1,1.6110286662939668,0.8335541542322945,16,23,15,5,18,9,7
7984,1,1,4.032852527357898,0.9825849585413335,15,21,15,2,19,13,2
7985,0,0,2.8288242493022198,0.0557862973037867,17,24,14,4,20,3,14
7986,1,1,2.1495557263428458,0.8956272538890906,9,11,4,3,8,6,3
7987,1,1,3.6340496259881547,0.9742704707637548,35,57,41,11,46,21,14
7988,0,0,3.7652503171566103,0.022637488420584773,9,11,6,0,11,0,9
7989,1,1,3.1089869047253877,0.9572619276995945,5,5,2,0,5,5,0
7990,1,1,6.970602288250028,0.9990617939229286,13,20,11,1,19,12,1
7991,0,0,2.2764724663357874,0.09309033630477104,20,27,16,5,22,5,15
7992,0,1,0.39239277876162615,0.5968585791232219,9,11,5,4,7,4,5
7993,0,1,0.6122535472126125,0.6484546951206351,30,44,28,11,33,17,13
7994,1,1,1.843777535226569,0.8633948576259256,15,20,12,3,17,10,5
7995,0,0,1.5623404832217644,0.1733110593988264,21,27,15,4,23,7,14
7996,1,1,4.5621268513714375,0.9896680326517822,19,25,12,5,20,13,6
7997,1,0,1.653502737080855,0.16063610642662718,13,16,9,5,11,5,8
7998,0,0,2.999412515429116,0.047452420825856434,16,19,10,5,14,5,11
7999,1,1,2.09447077269925,0.8903646044907407,28,42,26,10,32,17,11
8000,0,0,1.3036880548574583,0.21354497769698444,8,9,5,0,9,0,8
8001,1,1,4.77092927636709,0.9915986770321711,13,17,11,2,15,10,3
8002,1,0,0.6966671930836701,0.332551567772693,22,29,19,5,24,8,14
8003,0,0,1.1532409646519206,0.23989760561029239,5,6,3,0,6,0,5
8004,0,1,0.4540098743450025,0.6115921934460372,5,4,2,1,3,3,2
8005,0,0,1.597379883622152,0.16834813089879408,27,38,20,7,31,8,19
8006,0,0,3.4498931237066954,0.030772046796417762,10,10,7,1,9,2,8
8007,0,0,5.476583906158541,0.004166167310003743,21,27,18,7,20,6,15
8008,0,0,1.4695764869994519,0.18700699439234636,15,19,10,5,14,5,10
8009,1,1,5.209178540713933,0.9945635544191787,12,16,10,1,15,11,1
8010,0,1,1.4690802463998054,0.812917547761737,36,57,38,12,45,19,17
8011,1,1,5.652324393815237,0.99650292229471,19,31,23,3,28,17,2
8012,0,0,6.69043918059586,0.0012411943891498245,24,32,17,5,27,5,19
8013,0,0,6.295935189208679,0.0018403909157316267,19,23,13,2,21,4,15
8014,0,0,3.506251412908904,0.029134881571651672,19,23,11,4,19,4,15
8015,1,1,0.2857721340838273,0.5709607677425708,11,13,5,5,8,6,5
8016,1,1,1.7557693866918302,0.8526790136167964,17,25,19,3,22,12,5
8017,0,1,6.4206914973480185,0.9983751141385391,25,37,21,7,30,15,10
8018,0,0,3.558800274588148,0.0276846985454533,13,15,7,3,12,4,9
8019,0,1,0.5028545423740736,0.6231299243849021,12,14,8,4,10,6,6
8020,0,1,1.6636771564937967,0.8407310002137736,7,8,4,1,7,5,2
8021,1,1,2.792964271178514,0.9422944403151878,10,12,7,2,10,7,3
8022,0,0,8.71401627078622,0.00016424020706928832,22,25,13,3,22,4,18
8023,0,0,2.0061325955896536,0.11856054097266189,24,35,20,10,25,9,15
8024,0,1,0.9723994123614577,0.7255974931484404,25,32,17,9,23,12,13
8025,1,0,2.1175109085021435,0.10740646739551474,22,29,21,5,24,10,12
8026,1,0,0.9690654243114514,0.2750668221553748,6,5,1,1,4,1,5
8027,1,1,0.9206638714882518,0.7151773547794689,5,6,3,0,6,5,0
8028,0,1,0.5740022908265685,0.6396861690342873,9,10,5,5,5,5,4
8029,1,1,1.1894105314098613,0.7666356216637689,7,6,2,2,4,4,3
8030,0,0,1.6723295083194092,0.15811384199219158,21,28,14,7,21,7,14
8031,0,0,2.427331634732245,0.08111212618021713,12,12,6,1,11,2,10
8032,1,1,2.9882276931705922,0.9520394508285359,16,24,17,4,20,13,3
8033,0,0,1.9193308167850187,0.1279362075227073,30,41,27,7,34,14,16
8034,0,0,9.862551195043807,5.2086576926013706e-05,25,32,17,5,27,4,21
8035,0,0,1.5066577181434064,0.18143464745746885,33,50,34,10,40,14,19
8036,1,1,3.992682689438407,0.9818840896508504,9,11,6,1,10,8,1
8037,1,1,1.252682672488553,0.7777638991460645,41,65,39,17,48,18,23
8038,0,1,1.8074022925311266,0.8590476246456866,17,23,11,5,18,10,7
8039,1,1,2.461892808913585,0.9214268105003202,19,25,14,5,20,12,7
8040,1,1,1.5916585092659563,0.8308493157665738,18,26,14,5,21,12,6
8041,0,1,1.1811866151351027,0.7651610932416373,23,35,24,7,28,12,11
8042,0,0,0.8704971515366973,0.2951508656391766,10,11,6,3,8,4,6
8043,0,1,1.5882606399622858,0.8303712465518633,12,14,6,4,10,8,4
8044,0,0,6.4022140890292185,0.0016551384819387671,26,36,22,4,32,5,21
8045,0,0,3.419659052483003,0.031686687879383224,26,38,19,9,29,9,17
8046,1,1,4.479870176058761,0.9887921550307813,26,36,20,7,29,16,10
8047,0,0,4.633973714366612,0.009622579699288147,13,15,7,1,14,1,12
8048,0,1,0.6610891365241129,0.659505005409221,23,32,15,9,23,10,13
8049,0,0,2.4378482434111914,0.08033173734386745,20,26,14,5,21,7,13
8050,1,1,3.9536976256197387,0.9811774484245863,11,13,7,1,12,9,2
8051,0,0,4.950640266323945,0.007029116871948737,13,15,6,1,14,1,12
8052,0,0,1.0743857022306793,0.2545699399519037,15,20,10,4,16,5,10
8053,1,1,0.6837470766321003,0.6645744923123353,3,2,1,0,2,3,0
8054,1,1,2.395754756169362,0.9165030090789709,5,6,3,0,6,5,0
8055,0,0,2.013233554444202,0.11782047045531763,17,25,15,8,17,6,11
8056,1,1,0.8560724233174934,0.7018394183950287,4,3,1,1,2,3,1
8057,0,0,0.42374786408050524,0.39562026792037486,20,28,20,5,23,8,12
8058,0,0,9.015440671373696,0.00012150414471312487,32,50,29,8,42,6,26
8059,0,0,5.406315520032283,0.004468092815475444,29,43,26,6,37,6,23
8060,1,0,2.6864676841946844,0.06377660520092387,18,22,13,2,20,3,15
8061,0,0,8.540000226758593,0.000195452006862884,18,21,10,0,21,0,18
8062,1,1,2.0433840835814574,0.8852774083109292,7,9,4,1,8,6,1
8063,0,0,1.126962262888739,0.24472214012069504,7,6,2,1,5,1,6
8064,1,1,0.574737386891663,0.6398555822866918,2,1,0,0,1,2,0
8065,1,1,1.325944061006378,0.7901689434932258,30,48,27,16,32,13,17
8066,1,1,2.5616978073472247,0.9283554637719232,23,35,21,8,27,13,10
8067,1,1,1.7468685217889488,0.8515573955807372,10,11,4,3,8,6,4
8068,1,1,3.037928292804682,0.9542584858493713,12,17,12,1,16,11,1
8069,0,0,3.3913988961614985,0.032565354460003415,23,31,17,6,25,6,17
8070,0,0,2.508338700692816,0.07527566970451505,18,22,12,1,21,3,15
8071,1,1,3.180108717117278,0.9600788331073723,22,30,16,7,23,12,10
8072,0,0,3.777509183599975,0.02236784192907859,9,8,2,2,6,2,7
8073,1,0,0.38386548155305744,0.4051949292561219,5,4,0,2,2,2,3
8074,1,1,3.708391944817172,0.9760697790754412,10,14,8,0,14,10,0
8075,0,0,2.548230659712886,0.0725454411777583,9,9,6,0,9,0,9
8076,1,0,0.6121790831408052,0.3515622799864354,17,21,11,7,14,8,9
8077,1,1,3.431601523319957,0.9686776964084014,13,18,11,2,16,11,2
8078,1,0,1.2808112076853013,0.21741216972107347,12,13,6,1,12,2,10
8079,0,1,0.7244453787539373,0.6735851676272401,7,8,3,2,6,5,2
8080,1,1,1.143554220954332,0.7583316004634629,3,2,1,0,2,3,0
8081,0,0,1.8024129099151036,0.14155759672039392,20,25,13,4,21,6,14
8082,1,1,3.1077432029666947,0.9572110170122173,25,40,29,5,35,18,7
8083,1,0,4.115927657536064,0.01604902999094171,17,20,12,2,18,3,14
8084,1,1,3.125577789224034,0.957935560275422,20,30,18,5,25,13,7
8085,0,0,4.283846668674808,0.013601951898108311,19,23,12,5,18,5,14
8086,1,1,4.968698726174974,0.993095810377568,12,17,11,1,16,11,1
8087,0,0,0.7276911181596657,0.32570159999575865,37,59,38,12,47,16,21
8088,1,1,1.911923160850663,0.8712350508396784,6,7,3,1,6,5,1
8089,1,1,1.7134557631438903,0.8472839755421291,23,31,19,7,24,11,12
8090,0,0,5.924639406198388,0.0026656466324106454,18,21,11,3,18,4,14
8091,0,0,4.7865993595811585,0.008271780137198426,26,35,21,6,29,6,20
8092,1,1,2.3191081055286116,0.9104472483999924,12,16,9,2,14,10,2
8093,1,1,0.5607523474983538,0.6366266010983305,20,25,12,8,17,10,10
8094,0,0,3.3388733282341367,0.03426141697071183,11,15,7,0,15,0,11
8095,1,1,2.1505309282947427,0.8957183797013869,13,18,11,3,15,9,4
8096,0,1,2.545529133950191,0.9272725831134334,12,15,10,1,14,11,1
8097,0,1,0.35884630819667374,0.5887611291452379,20,30,19,8,22,11,9
8098,0,0,3.729033773803172,0.023452786727610753,14,17,9,3,14,3,11
8099,1,1,2.197034713189813,0.899982910929034,16,21,12,5,16,11,5
8100,0,0,0.03486880228094513,0.4912836825443392,16,20,10,4,16,5,11
8101,0,0,0.6452193944250515,0.34406764304564796,8,8,3,1,7,1,7
8102,1,1,4.2630402425739655,0.986116045808495,10,15,9,0,15,10,0
8103,1,1,6.580114653088895,0.9986142328327448,14,20,13,0,20,14,0
8104,0,1,0.8632881150269347,0.7033471777103657,17,23,12,8,15,10,7
8105,0,0,0.22440761128093456,0.44413235283077623,8,8,3,2,6,3,5
8106,0,0,3.740505696849765,0.02319147951122713,20,25,11,3,22,4,16
8107,1,1,3.7651819032265634,0.9773609978695523,20,28,20,4,24,16,4
8108,1,1,1.940786332654801,0.8744385049355199,9,12,6,1,11,7,2
8109,1,1,1.688052335339018,0.8439678512701403,3,2,1,0,2,3,0
8110,1,1,1.1216882319640737,0.7543017318505734,14,19,11,7,12,8,6
8111,0,1,0.49505250732148287,0.6212959495752635,11,14,7,4,10,5,6
8112,0,0,3.818034793356646,0.021498591743325135,25,35,21,11,24,8,17
8113,0,0,1.1756146385756838,0.23584161184145558,34,53,33,10,43,13,21
8114,0,0,4.649088551975051,0.009479598012440027,23,28,17,4,24,5,18
8115,1,1,3.593302101166002,0.9732290496120851,21,30,19,5,25,14,7
8116,1,1,1.8506800862004584,0.8642069331277389,24,35,19,9,26,13,11
8117,1,1,3.5365826941340863,0.9717109256565057,16,24,14,4,20,12,4
8118,1,1,1.5101440621994662,0.8190825558767427,20,28,17,4,24,12,8
8119,1,0,2.227881846991285,0.09727448197311317,32,46,28,9,37,9,23
8120,1,1,3.685898898591537,0.9755387320764458,12,17,11,1,16,10,2
8121,1,1,0.9325959009478051,0.717601640617443,5,5,2,1,4,4,1
8122,1,1,2.8814461213945384,0.9469215942308281,11,15,8,2,13,9,2
8123,1,1,7.887505392923265,0.9996247359803686,20,29,17,4,25,15,5
8124,0,0,1.5499695843731929,0.17509066116888228,16,20,11,5,15,7,9
8125,0,0,7.013452707697677,0.0008988881025462359,15,16,8,2,14,2,13
8126,1,0,1.2609254293065426,0.22081462585557632,38,60,37,17,43,15,23
8127,1,1,0.16109694810982766,0.5401873619698524,13,18,12,6,12,7,6
8128,1,1,3.7866788858271025,0.9778318009485092,9,13,9,0,13,9,0
8129,1,1,1.9023128850732787,0.8701530746930877,5,4,1,1,3,4,1
8130,0,0,2.7942383874343957,0.05763631784270562,16,19,10,2,17,2,14
8131,1,1,3.7357830907981278,0.9767012950473364,17,23,16,3,20,11,6
8132,1,1,1.645407350050948,0.8382693741773146,9,12,7,1,11,8,1
8133,1,0,1.8056713371956716,0.14116209802983193,21,30,20,4,26,8,13
8134,0,0,0.5722230403081414,0.36072402829828665,16,23,14,5,18,5,11
8135,1,1,3.4592420881297343,0.9695055674047961,18,26,15,6,20,11,7
8136,1,0,0.2738818481430593,0.431954356306671,2,1,0,0,1,0,2
8137,0,0,0.9940049783658751,0.2701217456147418,9,10,6,2,8,3,6
8138,1,1,0.3134824188511187,0.577735051683804,28,41,30,6,35,15,13
8139,1,1,4.722419697272326,0.9911847668517619,16,20,10,5,15,10,6
8140,1,1,0.6295034635040386,0.6523768655266882,10,13,7,2,11,8,2
8141,1,1,1.6656398049469197,0.8409936278109174,12,15,8,3,12,9,3
8142,1,1,3.1586330367795066,0.9592475430539293,8,10,6,1,9,7,1
8143,1,1,1.7814109483119944,0.8558710020170518,11,14,6,3,11,7,4
8144,1,1,2.1464981728916346,0.895341090682903,14,19,13,3,16,8,6
8145,0,0,3.4287816604861634,0.031407974828358554,20,31,20,4,27,4,16
8146,0,0,1.2339965598536147,0.22548269985142855,13,18,12,4,14,4,9
8147,1,1,0.8908854084855689,0.7090728559961825,13,16,9,3,13,7,6
8148,0,0,2.4854075871870323,0.07688751494119317,13,16,9,5,11,5,8
8149,1,1,8.038574760483936,0.9996773355009022,24,37,24,5,32,19,5
8150,0,0,3.3476563239935277,0.033971994729064536,21,30,18,7,23,7,14
8151,0,0,6.069334461172391,0.002307375603071815,22,32,18,3,29,2,20
8152,1,1,0.24010237333852547,0.5597388774129293,23,33,19,9,24,9,14
8153,0,0,1.4531436887909646,0.18951822069483026,4,3,1,0,3,0,4
8154,1,1,1.4541543652196682,0.8106369715686881,22,32,21,6,26,13,9
8155,0,0,2.5055089305018416,0.07547288476179725,14,16,7,2,14,2,12
8156,1,1,6.209592796833912,0.9979939764207977,16,22,13,2,20,14,2
8157,1,0,0.08582428571173173,0.47855708898702287,13,16,9,3,13,5,8
8158,0,0,2.525341300799855,0.07410064522756477,15,19,11,5,14,5,10
8159,0,0,5.354440096805708,0.004704874996303454,11,11,5,1,10,1,10
8160,1,1,1.6342442769158247,0.8367502328993022,10,11,7,2,9,7,3
8161,0,0,0.4739366728240437,0.38368491018760487,18,25,15,7,18,9,9
8162,0,0,2.2595112554667054,0.09453219516889666,18,22,11,7,15,6,12
8163,1,0,3.860236490055832,0.020628518880625002,15,17,9,4,13,4,11
8164,1,1,1.459069751710307,0.8113903545013117,5,4,1,1,3,4,1
8165,1,1,2.106852475051093,0.8915674212191429,33,48,32,12,36,16,17
8166,0,1,2.658908967726377,0.9345579713563724,15,19,9,4,15,10,5
8167,1,1,1.2624579348593945,0.7794489373768028,5,4,1,1,3,4,1
8168,1,1,2.8489509994925637,0.9452644332776844,15,20,12,3,17,11,4
8169,1,1,2.107045255836912,0.8915860568860651,13,16,9,3,13,6,7
8170,0,0,4.8052053773356675,0.008120536424112368,15,17,7,1,16,1,14
8171,1,1,3.3263616448507065,0.965322180784848,13,18,11,2,16,9,4
8172,0,0,2.1283262784092662,0.10637398845708113,11,12,7,2,10,3,8
8173,0,0,2.6356348046968794,0.06687993986874907,13,16,9,2,14,3,10
8174,1,1,4.605818273458469,0.9901053610593371,20,31,21,3,28,17,3
8175,1,1,2.824906822675712,0.9440069959947258,21,30,19,5,25,14,7
8176,0,0,4.632593675655327,0.009635740352665345,31,46,28,6,40,9,22
8177,0,0,2.1798871570868856,0.10157122485954762,13,16,10,2,14,3,10
8178,0,0,1.3883982236449333,0.19966359444538928,42,64,38,15,49,18,24
8179,0,0,4.307271441179557,0.013291217798529709,17,19,10,1,18,1,16
8180,1,1,2.511852130844856,0.9249685328497502,26,38,21,12,26,15,11
8181,0,1,2.9706473583143307,0.9512303175046105,20,31,19,5,26,17,3
8182,0,0,0.21020855459296928,0.4476405229700231,14,18,8,4,14,4,10
8183,0,1,1.1305639067096855,0.755942951066289,27,41,25,11,30,14,13
8184,1,0,0.36023675535580146,0.410902255354356,19,26,14,8,18,7,12
8185,1,1,0.8516587090656869,0.7009149787556898,14,19,13,5,14,7,7
8186,1,1,1.9943432584244525,0.8802018758779242,19,25,16,6,19,12,7
8187,0,0,0.25945846794055605,0.43549683342847834,5,5,2,2,3,3,2
8188,1,1,1.6533887497237927,0.8393485238186705,23,34,24,6,28,15,8
8189,0,0,4.187768385676785,0.014953132881805331,22,31,20,5,26,5,17
8190,1,1,4.616987768578228,0.9902141887645404,15,21,14,2,19,11,4
8191,0,0,0.6209566331293499,0.34956391143414556,13,14,6,4,10,5,8
8192,1,1,4.75022370081756,0.9914244167092787,10,14,9,0,14,10,0
8193,1,0,0.35427817287218666,0.41234536118553977,10,10,3,3,7,4,6
8194,0,0,5.330698311421542,0.004817369140125316,32,49,30,9,40,11,21
8195,1,0,0.43302119371313275,0.3934051296419656,17,23,14,5,18,6,11
8196,0,1,0.7065265333147277,0.6696331968730208,25,34,20,9,25,11,14
8197,1,1,0.38933199014590514,0.5961218791862679,17,24,13,6,18,8,9
8198,0,0,0.33288630270900654,0.4175385074219169,13,15,7,4,11,4,9
8199,0,0,2.2519119214358367,0.09518467402842745,20,26,16,4,22,6,14
8200,0,0,0.8911666260942441,0.2908691354446462,28,42,25,7,35,11,17
8201,0,0,3.753971045169208,0.022888390955216886,26,37,22,5,32,6,20
8202,0,0,1.9128296703929553,0.12866328702613616,28,40,22,8,32,11,17
8203,1,1,1.7713909034437019,0.8546305582166026,10,12,5,3,9,6,4
8204,0,1,1.2222099559980055,0.7724522267828067,28,42,27,10,32,16,12
8205,1,1,1.4714113173986112,0.8132718045523574,20,29,19,7,22,9,11
8206,1,1,1.7495258893758263,0.8518929927837177,6,7,3,1,6,5,1
8207,1,1,0.7081436716738638,0.6699908494356085,16,21,11,5,16,10,6
8208,1,1,3.4348301216333605,0.9687755079194706,17,24,18,3,21,15,2
8209,0,0,1.3322722208241937,0.20878376162738665,5,5,2,0,5,0,5
8210,0,0,4.638046103238994,0.009583847294170389,16,20,13,2,18,3,13
8211,0,1,0.21811863320689628,0.5543144911884599,28,42,24,11,31,15,13
8212,0,0,6.63098979635055,0.0013171199469679262,32,49,29,12,37,11,21
8213,0,0,4.898445972306019,0.007402951832853,9,10,4,0,10,0,9
8214,0,0,1.4173462326032729,0.19507794773122777,18,21,12,6,15,7,11
8215,0,0,0.5729444283446461,0.3605576913467641,21,28,16,6,22,9,12
8216,0,0,3.249220957702035,0.037354891223656095,19,25,15,5,20,5,14
8217,0,0,3.326683514737687,0.03466704614801153,10,10,5,0,10,0,10
8218,0,0,2.434152387515635,0.08060520566314389,7,6,2,1,5,1,6
8219,0,0,0.6996760340221808,0.3318840591728798,17,23,13,4,19,6,11
8220,0,0,1.4117006957277451,0.19596595057539723,12,14,8,4,10,3,9
8221,1,1,2.309501997015052,0.9096609387983199,25,36,22,6,30,15,10
8222,1,1,1.9943781167297991,0.8802055515166751,7,8,3,1,7,6,1
8223,0,0,5.032452226064851,0.006480524436948909,26,37,20,5,32,5,21
8224,1,1,3.516720684588745,0.9711597973234545,12,17,10,2,15,10,2
8225,1,1,5.245291280440182,0.9947553654547966,16,20,10,3,17,12,4
8226,0,0,0.44490078282587,0.3905738323737984,16,23,15,5,18,7,9
8227,1,0,1.7327057119215155,0.15024181663355185,21,30,19,5,25,11,10
8228,1,0,0.8740591295949387,0.2944103840964394,24,33,20,9,24,9,15
8229,0,0,6.335597287032407,0.0017689523402230067,31,49,28,11,38,8,23
8230,0,1,1.7761142654110722,0.8552163929362552,9,10,5,2,8,7,2
8231,1,1,4.029095568959579,0.982520553685623,12,14,9,2,12,10,2
8232,1,1,2.892384205499836,0.9474686744079771,10,13,7,2,11,8,2
8233,1,0,1.0256489818544539,0.2639285088906035,4,3,1,0,3,0,4
8234,1,1,2.259309212467674,0.9054505093701781,9,12,7,1,11,8,1
8235,0,0,2.6650955166568004,0.06506467888743472,8,7,4,1,6,2,6
8236,0,1,0.14048145897127484,0.5350627200177382,7,6,1,3,3,4,3
8237,1,1,0.6933578546614632,0.6667134814897191,10,13,6,3,10,6,4
8238,1,1,5.869629815913766,0.9971840335495408,20,30,20,4,26,15,5
8239,1,1,4.217169277158565,0.9854738093322586,13,19,14,0,19,13,0
8240,1,1,1.1103904229421948,0.7522018911792802,26,39,25,9,30,16,10
8241,0,0,4.92672505499356,0.007198021322417869,18,24,15,1,23,2,16
8242,1,1,0.39104048218360943,0.5965331490874008,4,3,1,1,2,3,1
8243,1,1,3.209683405900093,0.9611970591672852,6,8,4,0,8,6,0
8244,1,1,4.805602887528005,0.9918826647328692,30,48,28,11,37,17,13
8245,1,1,4.171674837897731,0.9848079568083468,16,23,15,2,21,14,2
8246,0,0,3.3172995040278983,0.034982459334733984,31,45,23,11,34,9,22
8247,1,0,0.6470627232058943,0.343651750864875,30,46,27,12,34,14,16
8248,0,0,2.18512141996118,0.10109456990286769,10,11,6,1,10,1,9
8249,0,0,5.734085792446511,0.0032234134210400445,11,12,6,0,12,0,11
8250,0,0,0.2597033974641521,0.4354366210672628,1,0,0,0,0,0,1
8251,1,1,2.4461914338420234,0.9202824912559184,19,26,14,4,22,12,7
8252,1,1,1.9975669272846541,0.8805413841739955,6,7,3,1,6,5,1
8253,1,1,4.23874893639497,0.9857795115389166,13,17,12,2,15,11,2
8254,0,0,1.8966824370464306,0.13048441798825783,12,15,9,2,13,3,9
8255,0,0,5.059883469197935,0.006306277486570644,23,34,21,10,24,8,15
8256,0,0,3.0225978602975343,0.04641535511208972,10,9,5,1,8,2,8
8257,0,0,4.677966618952368,0.009212246300989158,10,12,7,3,9,1,9
8258,1,1,3.7892734556758905,0.9778879731703425,18,27,20,3,24,15,3
8259,1,1,2.106332823649204,0.8915171737202788,13,16,8,3,13,9,4
8260,1,1,3.344025047079522,0.9659086325138936,15,21,13,4,17,13,2
8261,1,1,2.9333424991969106,0.9494702775121737,11,14,8,2,12,9,2
8262,0,0,4.358343387237637,0.012637815379991424,21,28,16,1,27,1,20
8263,0,0,2.8894882695101245,0.052675648415219656,22,34,19,8,26,7,15
8264,1,1,4.958998014497243,0.9930289780763747,8,10,6,1,9,7,1
8265,1,0,1.238159474301463,0.22475651834669608,14,19,12,5,14,6,8
8266,1,1,3.645757183997799,0.9745623263388533,16,23,14,2,21,13,3
8267,1,1,2.500283169835929,0.9241616688526034,10,13,8,1,12,8,2
8268,0,0,2.09303513518343,0.10977561450583606,4,3,1,0,3,0,4
8269,1,1,1.7608658165634201,0.8533180644486147,4,3,1,0,3,4,0
8270,1,1,3.3065214180898623,0.9646518573727093,14,21,15,1,20,13,1
8271,1,1,3.7321593323052005,0.9766186906463447,11,15,8,2,13,9,2
8272,0,0,0.2597033974641521,0.4354366210672628,1,0,0,0,0,0,1
8273,1,1,0.8885161033237226,0.7085838534891792,17,22,10,7,15,7,10
8274,1,1,8.141379446464805,0.9997088496155538,19,26,15,3,23,13,6
8275,0,0,2.509731215996923,0.07517879507868597,12,13,6,2,11,3,9
8276,0,0,4.742403401294477,0.00864232797631237,13,14,5,2,12,2,11
8277,0,0,3.422945605318561,0.031586002815013,17,20,12,2,18,3,14
8278,0,0,3.084290672447449,0.04375992036927323,8,8,5,0,8,0,8
8279,1,1,1.66071160059109,0.8403335038424803,10,12,9,1,11,8,2
8280,0,0,1.1195205134832884,0.24610023420757166,8,9,6,1,8,2,6
8281,0,0,2.345081091732142,0.08745754843605613,8,7,2,0,7,0,8
8282,0,0,3.31403730709812,0.03509275403631751,18,22,14,4,18,5,13
8283,1,0,1.3430062495940516,0.20701611660776875,12,16,11,3,13,3,9
8284,1,1,4.496425063949986,0.9889741433052955,12,18,12,0,18,12,0
8285,0,0,3.6996233098991986,0.02413589214156442,22,32,17,7,25,6,16
8286,0,0,3.1288544569424364,0.04193260426211476,12,14,5,1,13,1,11
8287,1,0,0.3974968386620752,0.4019138995871796,11,12,6,3,9,4,7
8288,0,1,0.8871049832944735,0.7082923816544442,12,15,7,3,12,7,5
8289,1,1,1.0198245823179257,0.7349384288201817,17,22,12,5,17,10,7
8290,0,1,2.762483612557504,0.9406145176680781,17,24,12,5,19,10,7
8291,1,1,2.2316093253591966,0.9030523449481673,6,6,4,1,5,5,1
8292,0,0,2.735227015053624,0.06092641510572694,12,13,7,3,10,3,9
8293,0,0,2.7858019703208194,0.058096250269742966,20,25,14,7,18,9,11
8294,1,1,0.2248376733784183,0.5559738178338043,29,45,29,12,33,12,17
8295,0,0,4.360030871243729,0.01261677609216083,7,7,4,0,7,0,7
8296,0,0,0.5957032773144917,0.3553273303007126,2,1,0,0,1,0,2
8297,1,1,3.778158942483577,0.977646362278613,12,18,11,1,17,11,1
8298,1,1,4.963449143190252,0.993059723166875,22,32,19,6,26,17,5
8299,0,0,3.8989384540149454,0.01986095979209157,12,14,8,0,14,0,12
8300,0,0,0.8912106214514492,0.29086006085739824,10,12,7,1,11,2,8
8301,1,0,3.50031650636644,0.029303226529639015,21,27,16,2,25,2,19
8302,0,0,2.4406347890214755,0.08012611199299735,12,12,6,3,9,4,8
8303,1,1,2.1557118784951617,0.8962013253160356,8,9,4,2,7,6,2
8304,1,0,0.06848011336871451,0.4828866589232269,40,63,39,17,46,16,24
8305,0,0,0.889401923215922,0.2912332649047653,14,18,10,4,14,5,9
8306,1,1,2.1152232478493325,0.8923740167938886,9,11,6,2,9,7,2
8307,1,1,4.243063458156646,0.9858398670602211,33,52,33,10,42,19,14
8308,1,1,3.4735278508089826,0.9699250981220732,13,18,11,1,17,11,2
8309,1,1,4.3509190083364615,0.9872692064687247,23,33,20,7,26,15,8
8310,1,0,0.9528715101079421,0.2783077049262964,28,42,26,12,30,12,16
8311,1,1,2.810579023847568,0.9432448246252567,9,10,5,2,8,7,2
8312,0,0,0.13961163703534685,0.46515367269805463,8,8,3,2,6,3,5
8313,0,0,2.7124129694446832,0.06224485644248101,19,25,14,5,20,8,11
8314,0,0,2.8800055217599647,0.05315085851014323,15,17,8,1,16,2,13
8315,1,1,2.8123004161430427,0.943336907402466,15,21,12,3,18,11,4
8316,1,0,0.5216336817030438,0.3724703036843514,2,1,0,0,1,0,2
8317,0,0,4.575751139222623,0.01019358140317228,13,16,9,3,13,4,9
8318,0,1,0.7234480073471168,0.673365839427819,10,10,6,2,8,5,5
8319,1,1,2.4609144993670897,0.9213559522254751,11,13,9,2,11,8,3
8320,1,1,1.6029513401950124,0.832430471528613,10,12,8,2,10,7,3
8321,0,1,0.8302409065604845,0.6964058658395672,16,20,11,5,15,9,7
8322,0,0,3.495210958387386,0.02944880105473835,10,11,7,0,11,0,10
8323,1,1,3.313368022954429,0.9648845761112053,19,26,16,6,20,11,8
8324,0,1,0.5788420250554143,0.6408009128126617,7,7,3,2,5,4,3
8325,0,1,1.571369722866903,0.8279787854303025,14,18,13,2,16,8,6
8326,0,1,2.0051093633383044,0.8813324854838969,28,43,28,10,33,19,9
8327,0,1,3.7215554225797427,0.9763753266713295,26,39,24,6,33,17,9
8328,0,0,2.6292704084298277,0.06727821936463185,22,28,19,2,26,5,17
8329,0,0,2.1672073745196494,0.10273417183464029,10,11,4,1,10,1,9
8330,0,0,1.315985744914427,0.2114869362104086,12,13,7,3,10,5,7
8331,0,0,1.5943832023611897,0.16876810444363666,26,40,26,10,30,11,15
8332,0,0,1.9034516970452406,0.12971830892897795,13,15,9,2,13,3,10
8333,1,1,4.021588125253676,0.9823911533390607,10,15,10,0,15,10,0
8334,0,0,3.3472931359914333,0.03398391581356375,11,11,6,2,9,3,8
8335,0,1,1.8963983750201632,0.8694833494526256,18,24,15,6,18,11,7
8336,1,1,1.8465266796953392,0.8637187793990402,11,15,10,2,13,9,2
8337,1,1,1.2754054102858763,0.7816666607003848,14,18,10,4,14,7,7
8338,0,1,0.9683087046191226,0.7247822584238086,3,2,1,0,2,3,0
8339,1,1,1.312107432121035,0.7878655918526651,4,4,2,0,4,4,0
8340,0,1,0.4109830288182532,0.6013235672782229,10,12,7,3,9,4,6
8341,0,0,1.604935819835609,0.16729289602845954,14,16,7,3,13,4,10
8342,0,0,1.5619652908569792,0.17336482142484178,19,25,15,4,21,6,13
8343,1,1,2.8157484949716123,0.9435209339483543,12,17,9,3,14,9,3
8344,0,0,3.069091494301497,0.04440035859602587,33,53,37,8,45,11,22
8345,0,0,3.7412209377380394,0.0231752822298551,6,7,3,0,7,0,6
8346,0,1,0.19272124506829114,0.5480317390630257,14,19,10,8,11,6,8
8347,0,0,1.1888396635354512,0.23346652525287426,12,15,8,5,10,5,7
8348,1,1,1.9623791549335727,0.8767902009938656,14,20,9,3,17,10,4
8349,1,1,6.600907607044993,0.9986427108196959,19,29,20,4,25,16,3
8350,1,0,1.9946692917160305,0.11976374930300204,24,32,18,6,26,6,18
8351,1,1,4.130361999123673,0.9841773241867964,11,13,4,3,10,8,3
8352,1,1,0.776875800907608,0.6850063872224298,8,8,2,3,5,5,3
8353,1,1,0.8115697398719981,0.6924439054419826,13,17,14,1,16,10,3
8354,1,0,0.7429484769655446,0.32235972979591043,38,59,38,13,46,15,23
8355,0,1,0.136145596739913,0.5339839226279872,29,45,31,9,36,20,9
8356,1,1,2.0379781251521427,0.8847272274710362,11,13,7,2,11,8,3
8357,0,0,0.3984633823754211,0.40168158470549753,14,20,14,6,14,7,7
8358,0,0,2.720803725230147,0.06175687963217524,12,14,7,3,11,4,8
8359,1,0,0.5046888046936959,0.3764394166325673,15,19,12,2,17,3,12
8360,0,0,1.5273263770829675,0.17838520556030735,16,22,12,5,17,5,11
8361,0,0,5.546098815849342,0.0038874810627496093,29,38,24,4,34,6,23
8362,0,1,0.17404388891350742,0.5434014703418522,11,12,5,4,8,5,6
8363,0,0,0.996978923597232,0.26953581550415373,21,28,16,5,23,6,15
8364,1,1,3.0995841212850097,0.956875587209735,10,13,8,1,12,8,2
8365,1,0,1.2189988959579003,0.228112674271451,13,14,7,1,13,2,11
8366,0,0,3.428658845994689,0.03141171124614939,18,23,13,5,18,4,14
8367,1,1,3.432251812946404,0.9686974209747239,11,14,7,2,12,9,2
8368,1,1,0.5829749535644775,0.6417516554481588,10,11,7,2,9,4,6
8369,0,0,6.980834220700796,0.0009286642297430259,20,25,15,2,23,3,17
8370,1,1,8.955431491911362,0.9998709822437842,28,48,33,6,42,24,4
8371,1,1,0.02300974125066957,0.505752181524731,13,17,10,6,11,6,7
8372,1,1,2.0634577430810284,0.8873004020227345,24,35,22,7,28,12,12
8373,0,1,0.5790023552383374,0.6408378159958672,10,11,5,3,8,5,5
8374,1,1,1.4911272653208119,0.8162474086522691,16,20,9,5,15,8,8
8375,1,1,3.092614078751674,0.9565870528579924,10,12,10,1,11,9,1
8376,1,0,1.12530181574021,0.2450291759786608,24,32,22,7,25,9,15
8377,1,1,6.451586620628453,0.9984244697447052,13,19,13,0,19,13,0
8378,1,1,0.22454139942208218,0.5559006763788434,12,14,8,4,10,5,7
8379,1,1,1.629859993051959,0.8361504583257566,28,42,26,12,30,14,14
8380,0,1,0.23501539457768716,0.5584849084290862,8,8,3,3,5,4,4
8381,1,1,5.89414948822243,0.9972520530717924,16,25,16,2,23,14,2
8382,0,0,1.9471426739237456,0.12486525488833577,8,7,2,1,6,1,7
8383,0,0,2.552121924033228,0.07228406188854153,18,23,12,3,20,4,14
8384,0,1,1.1301794691684484,0.7558720179733537,15,21,13,6,15,9,6
8385,0,0,7.70176539591712,0.0004518242314420773,33,47,28,10,37,9,24
8386,0,0,3.2339252641905545,0.03790882587182354,6,5,1,1,4,1,5
8387,0,0,2.492675672305669,0.07637324037387783,17,24,14,4,20,4,13
8388,1,1,2.7362804353932635,0.939133827823634,23,34,20,8,26,11,12
8389,1,1,0.032282906263000566,0.5080700257055817,14,21,13,7,14,6,8
8390,1,1,2.0966018505296606,0.8905724576754352,8,8,2,3,5,5,3
8391,0,0,1.2685513705818403,0.2195053344053901,22,33,18,9,24,9,13
8392,0,0,1.9116807665716347,0.12879214449733867,16,21,14,5,16,8,8
8393,1,0,0.8047486182403174,0.3090106608127283,8,9,4,3,6,4,4
8394,0,0,6.77851181024749,0.0011366736525860732,15,18,9,0,18,0,15
8395,0,1,2.918622020033978,0.9487593499343862,21,31,17,6,25,14,7
8396,1,1,0.3368751039372495,0.5834312491840654,14,17,8,6,11,6,8
8397,1,1,3.4722786958699134,0.9698886383726771,15,21,13,1,20,14,1
8398,1,1,2.3543266051703595,0.9132775153176806,18,26,19,5,21,14,4
8399,1,1,2.4020946681237287,0.9169868930235348,6,7,4,0,7,6,0
8400,0,0,4.040922267456698,0.01727749043690563,28,39,24,8,31,10,18
8401,1,1,3.375023080296746,0.9669147599719536,9,11,5,1,10,8,1
8402,0,1,1.0906593854152096,0.7485058678431062,20,30,16,10,20,10,10
8403,0,0,2.0672921023761806,0.11231673722413704,20,30,19,9,21,7,13
8404,1,1,2.124099009578039,0.8932235042844725,11,15,9,2,13,9,2
8405,0,0,3.4610499889430164,0.03044102821674155,19,23,13,2,21,2,17
8406,1,1,1.2832191096715655,0.7829972418596546,6,6,3,1,5,5,1
8407,1,1,7.596342474076329,0.9994979669647528,41,69,40,17,52,23,18
8408,1,1,1.1696396260742565,0.7630798702686903,22,30,18,8,22,12,10
8409,0,0,0.6695617386320496,0.33859498179416225,10,10,3,2,8,3,7
8410,1,1,0.574737386891663,0.6398555822866918,2,1,0,0,1,2,0
8411,1,1,1.6930559903590292,0.8446256296994918,11,14,7,3,11,8,3
8412,0,0,1.3685255483425238,0.2028581707339493,13,14,5,3,11,4,9
8413,0,1,0.38686127240930435,0.5955268867381599,8,10,5,4,6,6,2
8414,0,0,2.6240683961969005,0.0676053910444282,22,26,14,4,22,5,17
8415,1,1,2.804319762383091,0.9429088100258559,13,20,12,1,19,12,1
8416,0,0,1.5257042689085822,0.17862307214090156,16,21,10,5,16,5,11
8417,0,0,3.249707609826208,0.03733739539446124,9,10,4,0,10,0,9
8418,0,0,5.0141967037306205,0.006599128377891117,21,27,15,2,25,3,18
8419,1,1,2.1255220992519135,0.8933591559219269,24,37,29,5,32,16,8
8420,0,0,5.138155404562465,0.005834266332971572,15,17,11,2,15,3,12
8421,0,0,0.874883576984782,0.29423914827494135,7,7,3,1,6,2,5
8422,0,1,0.44568491260442067,0.6096127948103288,11,13,6,4,9,7,4
8423,0,0,6.536050825028834,0.001448104268738426,21,31,19,8,23,6,15
8424,1,1,1.2411248281864387,0.7757597462055981,21,31,19,9,22,11,10
8425,1,1,2.150197617516801,0.8956872420468809,8,9,4,2,7,5,3
8426,1,0,0.6789835205554438,0.33648820802182655,9,10,5,4,6,3,6
8427,0,0,6.2113584976459215,0.0020024917536317632,25,36,21,5,31,5,20
8428,0,0,1.2027051259621864,0.23099433923036117,19,24,13,2,22,5,14
8429,1,1,1.7642769156876073,0.8537445048987871,14,18,10,5,13,7,7
8430,1,1,2.0615438740927843,0.8871088762802867,18,28,17,5,23,15,3
8431,1,1,3.8903617076408312,0.9799713916024547,12,16,11,1,15,10,2
8432,1,0,1.3369446049786697,0.20801296619648746,14,16,7,3,13,4,10
8433,0,0,3.9526645108851737,0.01884164089799678,18,24,16,4,20,4,14
8434,1,1,4.234559239694062,0.9857206595618907,32,45,30,10,35,17,15
8435,1,1,2.1868551274739025,0.8990628709042126,7,8,3,1,7,6,1
8436,0,0,5.236148474913662,0.0052925501452941726,9,9,4,0,9,0,9
8437,1,1,5.09977901344453,0.9939388673433509,21,35,24,4,31,18,3
8438,1,1,0.6837470766321003,0.6645744923123353,3,2,1,0,2,3,0
8439,1,1,1.8407375559463466,0.8630359135165169,21,26,13,7,19,13,8
8440,0,0,2.2562186798442214,0.09481440250971007,13,15,7,1,14,1,12
8441,0,0,4.180883864819841,0.015054878041723563,24,30,16,5,25,5,19
8442,0,0,3.231454970255475,0.03799902472293992,6,7,3,2,5,1,5
8443,0,0,1.839075138294208,0.13716071105925154,11,14,9,2,12,3,8
8444,1,1,2.695751756617555,0.9367754989219155,17,24,15,6,18,10,7
8445,0,0,1.5839810233494394,0.17023241072596895,17,22,15,1,21,2,15
8446,0,0,0.5488292500677869,0.3661360745528991,18,23,11,5,18,6,12
8447,0,1,2.8179804234663615,0.9436397539201756,20,27,20,3,24,15,5
8448,1,0,0.20168540878518249,0.4497488712152836,20,29,17,7,22,8,12
8449,1,1,1.9240638559074361,0.8725909214608694,18,25,15,4,21,10,8
8450,1,0,0.2597033974641521,0.4354366210672628,1,0,0,0,0,0,1
8451,0,0,3.8190131831472742,0.021478019574812546,17,22,12,6,16,5,12
8452,1,1,1.8990377376729182,0.8697825777676446,10,13,6,2,11,7,3
8453,1,1,2.7310928760682622,0.9388366228723664,23,31,17,6,25,12,11
8454,0,0,0.9103308693488268,0.28693213591682265,41,65,37,16,49,17,24
8455,1,1,1.0840439732423697,0.7472585046020372,12,14,8,3,11,7,5
8456,1,1,0.3273483289806678,0.5811140449065321,21,30,19,8,22,8,13
8457,1,1,0.05590422534223638,0.5139724175458593,24,34,21,11,23,12,12
8458,1,1,5.306775222269043,0.9950665703403494,24,35,21,6,29,15,9
8459,1,1,0.6837470766321003,0.6645744923123353,3,2,1,0,2,3,0
8460,1,1,2.91195013760052,0.948434023219967,12,17,11,3,14,10,2
8461,1,1,2.8804363934618475,0.946870821297783,16,23,14,2,21,12,4
8462,1,1,3.8927273397937885,0.9800177702789474,26,35,18,8,27,14,12
8463,0,0,6.126896504541591,0.0021785898463287934,19,23,13,5,18,4,15
8464,1,1,2.6391230219209083,0.9333374207382175,16,22,11,5,17,11,5
8465,0,0,0.7397586172090289,0.32305692978680056,11,12,5,3,9,4,7
8466,1,1,3.0488553418373012,0.9547330826238258,14,18,11,3,15,11,3
8467,0,1,0.016130937683769275,0.5040326469776899,19,25,15,9,16,9,10
8468,0,0,4.681292328552647,0.00918194077611545,30,46,29,7,39,8,22
8469,0,0,1.5505246701402569,0.17501050241364802,32,48,30,9,39,15,17
8470,1,1,3.5808168626543972,0.9729018267738718,26,38,24,8,30,12,14
8471,1,0,0.3070431090619077,0.4238366459981533,15,18,9,3,15,6,9
8472,1,1,1.370718430100216,0.7974962019614457,14,18,9,4,14,7,7
8473,0,0,4.584272520537841,0.010107961339602678,13,14,8,3,11,4,9
8474,0,1,2.00024379574928,0.8808226725914591,10,12,7,2,10,7,3
8475,1,1,3.232774149323912,0.962049168619298,14,21,13,2,19,12,2
8476,1,1,3.232297647695086,0.962031767444397,7,9,4,1,8,6,1
8477,0,0,0.6366003178379938,0.3460154459826855,16,20,10,5,15,6,10
8478,1,0,0.7931271755706799,0.3114975989036032,23,30,16,7,23,9,14
8479,1,1,2.4688492935026387,0.921928981897083,9,12,10,0,12,9,0
8480,0,1,1.3079109224101118,0.7871633676343384,17,24,14,7,17,9,8
8481,1,1,3.1070772634786357,0.9571837330991886,16,21,15,3,18,12,4
8482,0,0,0.9625765774218644,0.27636261783540106,13,17,10,4,13,4,9
8483,0,0,2.5573365336276495,0.07193515397090233,17,22,13,7,15,9,8
8484,1,0,0.5527399085149387,0.3652289632080836,32,48,33,7,41,14,18
8485,0,0,0.6083729782781906,0.35243043284535913,15,21,12,6,15,6,9
8486,0,0,3.111436516523142,0.042637967114435016,10,13,7,2,11,1,9
8487,1,1,2.241970853749653,0.9039557036763864,12,15,10,2,13,10,2
8488,0,1,0.09632103498848488,0.5240616584685653,19,28,19,8,20,9,10
8489,1,1,3.9036869655516613,0.9802312666729238,10,14,9,0,14,10,0
8490,0,0,2.1398531643511163,0.10528322044280869,16,19,8,3,16,5,11
8491,1,0,2.0517598421973413,0.11387467976016974,13,16,7,2,14,2,11
8492,1,1,2.6702216561944803,0.935246456303232,15,21,13,3,18,11,4
8493,1,1,1.454610432961529,0.8107069701797425,8,9,4,2,7,6,2
8494,0,0,2.3573794465537916,0.08648099933171127,12,15,9,2,13,3,9
8495,1,1,1.445532120206332,0.8093098704067142,20,28,17,9,19,13,7
8496,1,1,2.4503871607352044,0.9205897585222996,10,12,6,2,10,8,2
8497,0,0,3.3389382227774433,0.03425926983271532,12,11,4,2,9,3,9
8498,1,1,0.5110614784435414,0.625055276810133,22,31,21,8,23,10,12
8499,1,1,0.643808486144354,0.6556138659606786,10,13,7,4,9,8,2
8500,0,0,3.8864543270328094,0.020105444369604708,27,38,19,7,31,7,20
8501,0,0,7.977564000533073,0.00034295647433590926,25,36,20,7,29,6,19
8502,1,0,1.3691281620144635,0.20276074149441425,20,26,14,6,20,7,13
8503,1,0,3.4758889151560277,0.030006105045065068,10,13,7,0,13,0,10
8504,1,1,0.574737386891663,0.6398555822866918,2,1,0,0,1,2,0
8505,0,1,1.993942745329442,0.8801596367289656,21,32,24,4,28,15,6
8506,1,1,3.123082630121643,0.9578349028217062,15,21,11,4,17,11,4
8507,1,1,1.2582057167257112,0.778717077272394,17,25,16,5,20,11,6
8508,1,1,0.6291964427468391,0.6523072357061168,22,31,19,8,23,11,11
8509,1,1,1.074235451258912,0.7454015467584192,21,30,18,9,21,11,10
8510,0,0,0.8016079318113336,0.30968167177428463,16,22,12,4,18,5,11
8511,1,1,4.8697458856126365,0.9923831463066333,19,28,21,2,26,17,2
8512,0,0,1.3438032987613413,0.20688530321732213,26,39,22,8,31,8,18
8513,0,0,1.477686467605528,0.1857771190379386,30,47,28,11,36,12,18
8514,1,1,0.6164368170381569,0.6494077250983633,15,21,15,1,20,11,4
8515,0,0,3.3829988613120427,0.03283103795129505,14,15,6,2,13,3,11
8516,1,1,3.075140536547843,0.9558555898569231,7,8,3,1,7,6,1
8517,0,0,6.860569920415866,0.0010472184892615921,41,66,39,14,52,13,28
8518,0,0,0.3472886648047162,0.41404006684931927,10,11,6,1,10,2,8
8519,1,1,2.0285554917219795,0.8837627714175142,9,11,6,3,8,6,3
8520,0,0,0.3075714884798184,0.42370762139221074,10,10,5,2,8,3,7
8521,1,0,0.5287888394192319,0.37079941628225,14,18,10,4,14,8,6
8522,1,1,5.897661388169274,0.997261660280424,17,25,15,2,23,15,2
8523,0,0,2.074812953916112,0.1115690791092897,15,20,12,4,16,4,11
8524,0,0,3.0484431956320805,0.04528473277680345,16,22,13,1,21,1,15
8525,1,1,1.3620536891021058,0.7960932732736092,16,20,14,4,16,8,8
8526,1,1,2.218895457532965,0.9019335429171961,28,42,31,8,34,14,14
8527,1,1,3.502574448728784,0.9707609314043067,22,32,19,6,26,15,7
8528,0,0,2.272138789922711,0.09345685062317188,22,29,14,9,20,7,15
8529,0,0,3.213002374950074,0.03867934164583775,18,23,14,6,17,5,13
8530,0,0,3.6998977299230056,0.02412942947444152,15,18,10,2,16,2,13
8531,1,1,1.014721704233312,0.7339431770811842,9,10,5,2,8,5,4
8532,1,1,1.4454956541289292,0.8093042426281751,10,13,7,2,11,8,2
8533,0,0,1.850204985950393,0.135848831107227,19,27,14,6,21,6,13
8534,1,1,1.2670980622311088,0.7802455793271685,5,5,2,1,4,4,1
8535,0,0,4.962254207887127,0.0069485173120481525,21,27,16,3,24,3,18
8536,1,1,0.9791839882450037,0.7269462717694325,11,14,6,5,9,6,5
8537,0,0,1.4983220400520807,0.1826759189504309,4,3,1,0,3,0,4
8538,1,1,3.0720148836522947,0.9557235127217188,11,14,8,2,12,9,2
8539,1,1,4.064051213187401,0.9831108622250394,13,17,10,3,14,10,3
8540,1,1,5.600353936075667,0.9963170590535878,16,25,16,2,23,14,2
8541,1,1,5.303314389667726,0.995049551656563,26,37,24,5,32,20,6
8542,0,0,1.9923131015335658,0.12001236241925695,21,29,17,4,25,6,15
8543,1,1,3.338149493001573,0.9657146250030778,24,33,21,5,28,15,9
8544,0,0,1.5900798547443076,0.16937266222770175,11,11,3,2,9,3,8
8545,0,0,2.419114464779617,0.08172668799911564,12,14,6,1,13,2,10
8546,1,1,5.354226318753446,0.9952941238308387,10,14,7,0,14,10,0
8547,1,1,0.7371919343586795,0.6763815046587283,8,8,5,2,6,5,3
8548,1,1,4.202755293509329,0.9852660201246846,21,33,22,6,27,14,7
8549,1,1,3.8086622609128713,0.9783033571297086,17,25,18,1,24,16,1
8550,1,0,1.6496200881314542,0.16116030236161416,13,17,10,2,15,3,10
8551,1,1,1.8799752994149324,0.8676082892720958,23,36,25,7,29,13,10
8552,0,0,5.975719515337022,0.002533240489504429,23,31,20,4,27,4,19
8553,1,0,0.4091849581519069,0.3991075689895234,21,31,18,6,25,7,14
8554,1,0,0.5883313577922078,0.35701780983519693,14,17,11,2,15,5,9
8555,1,1,4.479049015015572,0.9887830510823021,10,14,10,0,14,10,0
8556,0,0,4.8686117553722355,0.0076254311882372194,24,35,19,5,30,6,18
8557,0,0,5.80610058136404,0.003000113360825063,11,14,7,0,14,0,11
8558,1,1,3.602647152651235,0.973471454312419,10,14,8,1,13,9,1
8559,1,1,8.823275480290157,0.9998527564787426,26,40,25,5,35,19,7
8560,0,0,5.517353166629358,0.004000397343318585,29,42,24,4,38,4,25
8561,0,0,6.050631337220933,0.002350834425437598,19,25,14,3,22,4,15
8562,1,0,0.5754964389013804,0.3599695200274715,2,1,0,0,1,0,2
8563,0,0,3.1803757735169076,0.03991093255471978,16,21,12,2,19,3,13
8564,1,1,3.59423637727862,0.9732533807317993,13,18,10,2,16,11,2
8565,1,1,2.54229903087768,0.9270544501078966,9,10,5,2,8,7,2
8566,1,0,0.45211205577764124,0.38885872336787997,7,6,3,1,5,2,5
8567,1,1,2.1643353278321142,0.8970007810711654,15,19,13,3,16,11,4
8568,0,0,2.6008429766034395,0.06908418750382128,19,27,17,3,24,5,14
8569,1,1,1.4313327371420757,0.807108886718646,12,16,9,4,12,9,3
8570,0,0,1.975314145303087,0.12181923972820985,20,29,16,5,24,5,15
8571,1,0,2.0138221932019724,0.11775930180757799,15,21,14,5,16,4,11
8572,0,0,8.97868206358918,0.00012605299747914245,31,46,29,5,41,5,26
8573,1,1,1.9671470805062015,0.877304351265299,14,18,10,3,15,10,4
8574,1,1,5.867511616515655,0.9971780792993137,12,17,11,1,16,11,1
8575,0,0,2.4397383578021383,0.08019220915285041,11,15,9,2,13,1,10
8576,1,1,1.1850521598180088,0.7658549793070041,26,38,21,12,26,12,14
8577,0,0,4.718279044652272,0.008851485883187182,21,26,14,2,24,4,17
8578,1,0,2.6892864502299316,0.06360850588557487,22,29,17,3,26,6,16
8579,0,0,3.964286324080325,0.01862798982439484,17,22,12,2,20,3,14
8580,1,1,3.1601409511694936,0.9593064491781359,11,14,6,2,12,9,2
8581,0,0,0.6261265780701055,0.34838934244234077,20,28,17,7,21,7,13
8582,0,0,2.134374080600306,0.10580046014496636,24,35,22,6,29,6,18
8583,0,0,3.077019859991215,0.044065178711090724,10,9,3,0,9,0,10
8584,0,0,0.5208324676422962,0.3726575955227107,3,2,1,0,2,0,3
8585,0,0,1.8900016568398623,0.13124428052682025,14,17,9,3,14,2,12
8586,1,1,0.7494703043105635,0.6790632701837596,19,26,14,7,19,10,9
8587,0,0,5.359070246531957,0.0046832428603411635,11,12,6,1,11,1,10
8588,0,0,3.048311285901699,0.04529043610756933,13,16,8,2,14,1,12
8589,0,0,3.289285473075796,0.03594059522492843,31,43,29,4,39,8,23
8590,1,1,1.3918190652611067,0.800882487772806,8,8,4,2,6,4,4
8591,0,1,2.6399571243920237,0.9333892987385806,31,42,24,9,33,14,17
8592,0,0,1.8167042220698288,0.13982981032340724,9,9,5,3,6,4,5
8593,0,0,3.8243847388115166,0.021365416830023465,31,47,28,10,37,10,21
8594,1,0,0.6410120848471319,0.3450177920778045,3,2,0,1,1,1,2
8595,0,0,1.4610821655695334,0.18830186660885795,21,28,17,5,23,7,14
8596,1,1,0.3024383892491205,0.5750384928539791,5,4,1,1,3,4,1
8597,0,0,2.6261976333691526,0.06747129829355358,29,39,25,7,32,10,19
8598,1,1,4.319288827541341,0.9868654666241597,13,19,9,2,17,11,2
8599,1,1,2.0660493642469206,0.8875592999789981,24,38,25,7,31,15,9
8600,1,1,1.6623275576847718,0.8405502026014189,12,14,7,3,11,9,3
8601,0,0,2.0601986720689465,0.11302591145631224,15,19,10,5,14,3,12
8602,0,0,1.4088239062030974,0.19641962350557785,9,10,5,4,6,5,4
8603,0,1,2.054153885122151,0.886366673274636,10,11,5,2,9,6,4
8604,1,1,2.1756686950524213,0.8980431739197419,6,7,3,1,6,5,1
8605,0,0,4.832476153173382,0.007903802107235292,24,31,17,3,28,5,19
8606,1,1,2.707585140081049,0.9374727447858223,13,14,9,3,11,8,5
8607,0,0,2.45315021194855,0.07920848526862623,14,17,10,4,13,3,11
8608,1,1,0.6666666785331699,0.6607563714257816,24,32,17,10,22,12,12
8609,1,1,5.176234688190569,0.9943824970493818,18,26,17,2,24,16,2
8610,0,1,0.30858453460200197,0.5765397245380435,28,43,26,12,31,16,12
8611,0,0,1.6098391600501563,0.16661094528454157,19,25,17,7,18,8,11
8612,0,0,3.5497527060451457,0.027929286843725754,13,17,8,1,16,2,11
8613,0,0,5.572920251153932,0.0037849885360374813,14,17,10,1,16,1,13
8614,1,1,0.2683931715457182,0.5666983884758456,15,18,11,3,15,8,7
8615,0,0,2.6548829786090367,0.0656886868013935,23,32,20,5,27,9,14
8616,0,0,1.437153026443524,0.19198660592167727,5,4,1,1,3,2,3
8617,0,0,0.5878995269381524,0.3571169453585137,13,19,11,5,14,5,8
8618,1,1,2.0975711475185514,0.8906668829704427,11,14,7,2,12,8,3
8619,0,0,1.8824546425374615,0.13210718257076237,12,14,7,1,13,1,11
8620,0,0,7.664337302844972,0.0004690475257604909,40,62,38,13,49,11,29
8621,1,1,2.8103955159640828,0.9432349999104491,8,11,7,0,11,8,0
8622,0,0,4.409094468481923,0.012019953175379516,22,28,14,5,23,6,16
8623,1,1,2.945869092325509,0.9500678866749532,11,13,9,2,11,8,3
8624,1,1,0.6890046980824529,0.6657454803225953,15,17,7,5,12,7,8
8625,1,0,1.5495156743347525,0.17515623084482523,20,29,16,7,22,7,13
8626,1,1,0.5865492156753396,0.6425729844194699,7,8,6,3,5,6,1
8627,1,1,0.5605589362127559,0.6365818574699407,3,2,0,1,1,2,1
8628,0,0,0.5445852892695155,0.36712157327818684,20,28,17,8,20,8,12
8629,0,0,1.5997782089562957,0.16801261550608027,10,12,7,4,8,4,6
8630,1,1,5.530707365474671,0.9960524601521128,24,41,29,7,34,20,4
8631,0,0,3.0053751113724494,0.04718363346443477,14,18,11,0,18,0,14
8632,1,0,2.2138066621983725,0.09851747964376056,18,23,14,2,21,3,15
8633,1,1,3.9191444042124566,0.9805285868741533,38,60,35,13,47,22,16
8634,1,1,2.897701336126503,0.9477326887147028,8,10,5,1,9,7,1
8635,0,0,0.36146445880893996,0.41060510804307204,15,19,13,4,15,6,9
8636,0,0,2.242317220545922,0.09601422903850321,11,11,5,3,8,3,8
8637,0,1,1.3480054841135867,0.7938033579638397,11,13,7,4,9,6,5
8638,1,0,0.6996150742678386,0.3318975763463079,25,39,23,11,28,11,14
8639,0,0,5.0085641883199035,0.0066361555865861455,35,53,31,14,39,11,24
8640,1,1,6.120882741245847,0.9978082979573476,15,22,12,1,21,14,1
8641,1,1,0.6632045774205884,0.6599798844978257,5,4,1,2,2,3,2
8642,0,0,2.1947234674343994,0.10022532519893723,9,10,8,2,8,3,6
8643,0,0,3.3675961018868796,0.0333236592611017,19,26,15,3,23,4,15
8644,0,1,1.388184322921227,0.8003022224415923,14,19,9,6,13,8,6
8645,0,0,3.2232886747279386,0.0382986733230507,15,20,14,4,16,4,11
8646,1,1,1.1736371113880146,0.763801811372107,9,10,4,3,7,6,3
8647,1,1,2.8522112057341884,0.9454328703323761,8,8,5,2,6,5,3
8648,0,0,2.3451764552145136,0.08744993789746947,13,18,11,5,13,4,9
8649,1,1,0.11566663698533652,0.5288844632066936,10,11,6,3,8,4,6
8650,1,1,3.37393903597481,0.9668800631775633,8,10,7,0,10,8,0
8651,0,0,1.261254840412043,0.22075795406669807,20,25,15,3,22,5,15
8652,0,0,2.896379525088188,0.052332826539526645,12,14,8,1,13,2,10
8653,1,1,1.8794369487405376,0.8675464398431743,6,7,3,1,6,5,1
8654,0,0,4.447411771371151,0.011573322819229848,24,33,21,5,28,6,18
8655,0,0,0.2597033974641521,0.4354366210672628,1,0,0,0,0,0,1
8656,0,0,0.23994849400524387,0.4402990436145807,23,33,21,9,24,10,13
8657,0,1,2.8129919569766315,0.9433738605796239,19,29,17,5,24,15,4
8658,0,1,1.9032558647042392,0.8702595816671668,10,12,5,3,9,6,4
8659,1,0,1.569033936414755,0.17235415534928578,19,25,14,6,19,5,14
8660,0,0,1.3265155150941736,0.20973632399607545,11,13,7,4,9,6,5
8661,0,0,5.778587473694342,0.0030835437310949843,17,18,10,2,16,2,15
8662,0,0,1.7386667736493366,0.14948235823969236,11,13,7,3,10,3,8
8663,0,0,0.5820383107492024,0.3584637133723624,10,12,6,1,11,2,8
8664,1,1,0.18444309531754866,0.5459804958248435,8,9,5,1,8,5,3
8665,1,1,2.9514064548335934,0.9503299193422647,12,15,7,3,12,9,3
8666,1,1,1.9997590028479337,0.8807717725006282,6,8,4,0,8,6,0
8667,0,0,1.2562414353306006,0.2216215866963528,9,10,7,2,8,3,6
8668,0,0,2.0610091963691217,0.11294468102280897,23,33,19,6,27,8,15
8669,1,1,3.896882836564596,0.9800989850068944,13,19,12,0,19,13,0
8670,0,1,0.4671502526033018,0.6147090380004157,9,10,4,3,7,4,5
8671,0,1,1.18754731732794,0.7663021169304104,9,10,4,3,7,6,3
8672,1,1,1.7719145764432664,0.854695605785097,4,4,2,0,4,4,0
8673,0,0,3.8092097466484045,0.021685025036192407,13,13,6,2,11,4,9
8674,0,0,1.8579733045024365,0.13493945474792746,8,8,2,2,6,2,6
8675,0,0,0.4385874823907301,0.39207759534451403,12,15,8,4,11,5,7
8676,1,1,1.2167690350105211,0.7714944598530824,6,6,4,1,5,5,1
8677,0,0,2.0122636804183136,0.11792131537657835,22,31,17,7,24,7,15
8678,0,0,2.0995638299597355,0.10913922184256819,20,27,16,3,24,4,16
8679,0,0,0.44333002309763203,0.39094777809126624,11,14,8,5,9,5,6
8680,0,0,3.521115580751982,0.02871736302896144,12,15,8,2,13,2,10
8681,0,0,1.6560103841867926,0.1602982826482765,10,11,6,2,9,3,7
8682,0,1,0.9478546460503345,0.720683525415686,11,14,7,5,9,7,4
8683,0,0,1.50753477037009,0.18130442745870623,7,6,2,0,6,0,7
8684,1,1,3.101544219965273,0.956956397696078,19,27,19,5,22,12,7
8685,1,1,4.637444952325014,0.9904104449004886,7,10,5,0,10,7,0
8686,1,0,1.092594376920196,0.2511300551853929,22,31,19,7,24,9,13
8687,1,1,2.8822273008256554,0.9469608434545173,17,24,14,4,20,12,5
8688,0,0,1.251323992147101,0.2224710335945176,16,21,13,2,19,4,12
8689,1,1,3.153648769392176,0.9590522529802862,10,12,5,2,10,8,2
8690,0,0,3.6449937912947483,0.025456605480735917,29,42,24,7,35,10,19
8691,1,1,3.413687207794788,0.9681295668164337,19,27,13,5,22,13,6
8692,0,0,1.187157438013847,0.2337677111470191,16,18,10,2,16,4,12
8693,0,0,1.2896132313362751,0.21591828262601398,22,31,18,7,24,10,12
8694,1,1,3.227758234979707,0.9618656097176118,11,17,12,0,17,11,0
8695,1,1,4.7159121794622,0.9911277251269203,12,16,10,1,15,11,1
8696,0,0,0.8881875470402185,0.29148399565909067,5,5,3,0,5,0,5
8697,1,1,0.8970459651688079,0.7103420694777267,20,29,20,7,22,13,7
8698,1,0,1.378272879118769,0.2012865261757838,5,4,2,0,4,0,5
8699,1,1,2.707827703372457,0.9374869617545223,19,26,13,7,19,11,8
8700,0,0,1.6852994376707997,0.1563950105027535,42,69,46,16,53,21,21
8701,1,0,0.00046838028926321496,0.4998829049298249,4,3,1,1,2,1,3
8702,1,1,2.570214095271476,0.9289198334486336,10,13,8,1,12,9,1
8703,1,1,1.0430236642050015,0.7394330026467677,8,9,4,2,7,6,2
8704,0,0,1.8737318543720838,0.13311050611137742,10,11,5,3,8,3,7
8705,0,0,2.0156655587580077,0.11756792568315466,21,23,11,6,17,6,15
8706,0,1,0.6555446909000562,0.6582588560782672,10,11,8,2,9,4,6
8707,0,0,3.9047565221913523,0.01974801817482852,22,28,19,3,25,7,15
8708,0,0,0.2365105470823312,0.4411464498948653,12,12,5,3,9,4,8
8709,0,0,1.3549133344816238,0.20506826253115074,7,6,3,2,4,2,5
8710,1,1,4.922413012590772,0.9927710983455227,16,23,15,3,20,13,3
8711,0,0,2.194248779665833,0.10026814076552715,15,17,7,4,13,5,10
8712,0,0,0.02457795792202533,0.49385581981237037,12,16,10,3,13,5,7
8713,0,1,0.5150974497020633,0.6260006733442423,14,17,8,5,12,6,8
8714,0,0,3.154984867337697,0.04089530924842233,15,17,7,2,15,2,13
8715,0,0,2.147084801401399,0.10460395179225668,15,19,9,3,16,3,12
8716,0,0,0.3654262740014427,0.40964665558489066,22,31,19,4,27,8,14
8717,0,0,2.8329035212247535,0.055571813930406666,34,52,32,12,40,15,19
8718,1,1,2.025322604436009,0.8834302571527167,6,7,3,1,6,5,1
8719,1,1,0.7683390208502869,0.6831614811160787,17,22,11,4,18,9,8
8720,0,0,2.524421766585202,0.07416375894330551,8,7,3,1,6,1,7
8721,1,1,4.646973209821056,0.9905005188611194,14,20,16,0,20,14,0
8722,0,0,4.35935211795583,0.012625234522238626,18,24,16,5,19,4,14
8723,1,1,6.700570077194833,0.9987713011702172,30,45,26,8,37,22,8
8724,0,1,0.2446941203537727,0.5608701151527768,15,20,11,7,13,9,6
8725,1,1,5.154252112957758,0.9942583594540564,16,22,11,2,20,13,3
8726,0,0,1.39992271355715,0.19782837591910696,5,4,1,0,4,0,5
8727,1,1,5.012958985506554,0.9933927527043033,11,16,9,0,16,11,0
8728,1,1,0.6720439842542352,0.6619606902776121,7,6,3,2,4,3,4
8729,1,1,2.0531431462900462,0.8862648310948492,9,9,4,2,7,6,3
8730,1,1,1.5227837479390065,0.8209480359149666,7,6,3,1,5,4,3
8731,0,1,1.3992416088768465,0.8020635157604471,16,21,12,4,17,8,8
8732,0,0,3.807118431778866,0.021729436239603772,9,9,5,0,9,0,9
8733,0,0,2.0572605623886586,0.11332079511328941,18,25,14,7,18,6,12
8734,1,1,1.2609369113684856,0.7791873496903079,14,15,7,4,11,8,6
8735,1,1,0.845089259456195,0.6995359890300934,20,29,17,5,24,14,6
8736,0,0,0.4788769649081175,0.38251734865799136,18,25,14,3,22,4,14
8737,0,0,2.6691360977642162,0.06481931675261876,13,17,10,2,15,1,12
8738,1,1,3.77691688543895,0.9776192023132919,21,31,20,4,27,17,4
8739,0,0,2.9047792881891805,0.051917810856031976,25,33,19,11,22,12,13
8740,1,1,4.0848946304755165,0.9834534816603421,26,40,26,7,33,20,6
8741,0,1,1.9507452610454543,0.8755278822069105,31,48,32,13,35,19,12
8742,0,0,0.25272974310136,0.43715173073345515,6,6,3,1,5,2,4
8743,1,1,0.47531572149362344,0.6166411422025306,10,11,6,3,8,6,4
8744,1,1,1.359415285506024,0.7956646498560197,7,8,5,1,7,6,1
8745,0,0,4.449455470060766,0.011549967492578084,17,23,15,2,21,2,15
8746,0,0,0.40624572470749154,0.39981266664922666,27,40,21,11,29,11,16
8747,0,0,4.6662964973132794,0.0093193763223971,26,36,22,6,30,8,18
8748,0,1,0.48345546621617963,0.6185635001295007,13,16,9,6,10,6,7
8749,1,1,3.915730245341333,0.9804632957533401,25,41,30,5,36,19,6
8750,0,0,1.4006193715111115,0.19771784493176925,18,21,10,5,16,6,12
8751,0,0,1.081674775342778,0.25318921183509924,18,24,16,5,19,6,12
8752,0,0,1.5586214248555623,0.17384455258321552,18,23,13,5,18,6,12
8753,0,0,5.099081762710556,0.006065334617694984,14,17,8,3,14,2,12
8754,1,1,5.832067390157609,0.9970765624422442,21,35,25,6,29,17,4
8755,1,1,3.1368092239289864,0.9583858106970278,5,6,3,0,6,5,0
8756,1,1,0.1287419795524838,0.5321411135799492,24,37,22,10,27,13,11
8757,0,0,1.127926848066176,0.24454389664592757,33,52,33,11,41,12,21
8758,0,0,0.5772752222455355,0.35955980568873547,13,15,7,5,10,5,8
8759,0,0,6.5971341584662095,0.0013624135255585479,24,33,21,8,25,8,16
8760,1,1,4.12213104923572,0.9840486370892327,10,16,11,0,16,10,0
8761,0,0,2.549309405514773,0.07247289381501365,13,15,8,5,10,4,9
8762,0,1,1.940015895498473,0.8743538897612386,21,30,19,8,22,12,9
8763,0,0,3.511962482324229,0.02897377171771076,30,45,29,11,34,11,19
8764,1,1,0.5210091321912775,0.6273837048774278,5,5,2,1,4,4,1
8765,0,0,1.957806895045936,0.12370458788166983,13,15,10,2,13,3,10
8766,1,1,1.2574889000697418,0.7785935330491268,6,6,3,1,5,4,2
8767,1,1,3.9321210818886385,0.9807748024287298,15,21,12,3,18,12,3
8768,0,0,0.5957032773144917,0.3553273303007126,2,1,0,0,1,0,2
8769,1,0,0.7023452553590048,0.3312924597848297,12,15,8,3,12,6,6
8770,1,0,0.9581723743697077,0.27724426515056655,9,11,5,3,8,2,7
8771,0,0,3.293340760918926,0.03580034821062472,24,32,20,3,29,7,17
8772,0,0,4.65505247372713,0.009423761876177217,29,41,25,11,30,9,20
8773,0,0,0.4123466248388743,0.39834957823813555,22,31,18,11,20,10,12
8774,0,0,0.5754964389013804,0.3599695200274715,2,1,0,0,1,0,2
8775,0,1,0.19753047873684348,0.5492226749507946,9,10,7,2,8,3,6
8776,0,0,0.9903271485464531,0.27084746453035113,10,12,5,3,9,3,7
8777,0,1,0.7136218803425525,0.6712009684714542,24,35,21,13,22,13,11
8778,0,1,1.7774070153939963,0.8553763894444226,20,27,14,6,21,12,8
8779,0,0,3.1371783080838167,0.04159947181327106,18,20,10,2,18,3,15
8780,0,0,4.698223862373051,0.009029177061852356,21,27,14,3,24,4,17
8781,0,1,0.5329400349024889,0.630168566995467,10,12,7,4,8,5,5
8782,1,1,1.1769865487191813,0.7644055446705653,12,15,10,4,11,9,3
8783,1,0,0.5895235629647431,0.356744178550106,21,29,19,8,21,10,11
8784,0,0,8.485973427367957,0.0002062998740255395,26,35,22,5,30,5,21
8785,1,1,6.072309313370069,0.9976994625309275,12,19,12,0,19,12,0
8786,0,0,1.2915119208425012,0.21559701247567864,16,20,10,6,14,6,10
8787,0,0,0.7287694258371952,0.3254648265144374,32,47,30,7,40,16,16
8788,0,0,1.0387903103584655,0.26138347177944365,11,13,9,1,12,4,7
8789,1,1,2.5023218034260863,0.9243044268239821,10,14,8,1,13,9,1
8790,1,1,4.643373322943651,0.9904665867791215,16,24,16,2,22,14,2
8791,1,1,2.686656296110751,0.936234655729684,6,7,4,0,7,6,0
8792,0,0,2.812206115220385,0.056668133417640765,23,33,20,7,26,7,16
8793,1,0,0.06770037066946089,0.4830813688259139,6,5,1,2,3,2,4
8794,1,0,0.857392742102256,0.2978843642248329,17,21,12,5,16,7,10
8795,0,0,5.450706479354684,0.0042749171364220295,19,23,16,5,18,6,13
8796,0,0,0.365522556109396,0.40962337128130966,9,10,5,3,7,3,6
8797,0,0,1.024721015881918,0.26410882456123597,21,27,13,6,21,6,15
8798,0,0,1.4659994487955812,0.18755143972327049,10,10,5,3,7,3,7
8799,0,0,4.28040063396684,0.013648264716043523,23,35,22,6,29,5,18
8800,1,1,2.8591876198454393,0.9457916640376668,10,14,9,1,13,9,1
8801,1,1,3.056426510184436,0.9550591678180753,27,40,25,7,33,16,11
8802,0,0,3.1098881794626716,0.04270121496451418,9,8,2,2,6,2,7
8803,1,0,0.2496323851280774,0.4379139837306917,12,14,7,3,11,4,8
8804,1,1,2.323479110111748,0.9108029909703451,8,10,6,1,9,7,1
8805,1,1,2.8405738611533344,0.9448293834110832,21,28,19,5,23,11,10
8806,0,0,0.48904384447224647,0.3801188393177395,34,49,30,10,39,13,21
8807,0,0,2.0213545004400792,0.11697900526101868,5,5,2,0,5,0,5
8808,0,0,2.990809863537282,0.04784278393383479,21,27,11,5,22,6,15
8809,1,1,0.8585296336432,0.7023533611597794,12,15,7,6,9,7,5
8810,1,0,0.2600370921170432,0.43535459015488087,18,23,13,6,17,8,10
8811,1,1,0.6189298991694374,0.6499751317409064,25,36,26,8,28,16,9
8812,0,0,2.3877234473175717,0.0841136482296817,16,21,12,7,14,6,10
8813,0,0,3.166974237185889,0.04042763147492734,14,18,9,5,13,5,9
8814,0,0,2.9914428578989014,0.04781395685404122,13,15,7,2,13,2,11
8815,1,1,1.2490914764189571,0.7771425517730353,11,14,11,2,12,8,3
8816,1,0,0.5364260554248395,0.3690193638183623,17,20,11,4,16,7,10
8817,1,1,2.128304262845703,0.8936239187569462,10,13,8,4,9,8,2
8818,1,1,0.3500432059478875,0.5866280562079305,32,50,29,17,33,14,18
8819,0,1,0.2593087231770139,0.5644663530619458,12,13,7,3,10,5,7
8820,1,1,4.269201509174803,0.9862001487183292,27,41,27,8,33,20,7
8821,1,0,0.08413419346345297,0.4789788501317658,33,54,35,13,41,18,15
8822,1,1,0.31113175803394877,0.5771614863648082,9,9,3,3,6,5,4
8823,1,1,4.281267382678466,0.9863633985287765,26,40,27,9,31,16,10
8824,1,1,0.9683750855183171,0.724795499419108,6,6,2,2,4,4,2
8825,1,1,0.7423946061462301,0.6775192685809406,27,39,27,9,30,14,13
8826,1,1,3.7498570168043903,0.9770194199825946,17,26,18,3,23,15,2
8827,0,0,1.8391998359758417,0.13714595404932295,20,28,18,5,23,7,13
8828,1,1,3.3379190955958484,0.9657069957521848,14,19,14,2,17,12,2
8829,1,1,3.512001688902225,0.9710273313112433,26,38,25,8,30,17,9
8830,1,1,4.194994665705779,0.9851529346378972,18,26,16,6,20,13,5
8831,1,1,4.9784480595926395,0.9931623365526552,14,20,12,2,18,10,4
8832,1,0,1.68491665294172,0.15644552008268364,26,38,20,7,31,8,18
8833,0,0,3.5449623003392463,0.02805963725293681,18,23,14,3,20,4,14
8834,0,0,3.8876466192135433,0.020081968199688882,19,25,14,5,20,5,14
8835,0,0,0.9953629981047405,0.26985408748962014,13,14,9,2,12,3,10
8836,1,0,1.1428192379586954,0.24180312161015016,10,10,4,2,8,3,7
8837,0,0,0.7645199116763097,0.31766574986730123,2,1,0,0,1,0,2
8838,1,0,0.5277200925574623,0.3710487970413112,20,26,15,6,20,8,12
8839,0,0,4.021388651557727,0.01761229764361716,17,21,9,2,19,2,15
8840,0,0,0.0719839970775602,0.482011767522325,13,15,9,3,12,4,9
8841,1,1,0.718998703087216,0.6723864865650104,25,36,18,11,25,12,13
8842,0,0,3.0823105110056237,0.04384285510303265,13,15,8,4,11,4,9
8843,1,1,3.6595869926815356,0.9749029346945359,10,13,6,1,12,8,2
8844,1,1,1.1995734461800798,0.7684488932544786,8,10,5,4,6,6,2
8845,1,1,3.281549622754742,0.963790401961824,24,35,21,9,26,15,9
8846,0,0,4.543655330258767,0.010522561160055344,26,36,22,7,29,7,19
8847,1,1,2.3002614817148834,0.908898692472365,8,9,7,1,8,7,1
8848,0,0,2.3415319765625413,0.08774121382890732,18,25,15,3,22,4,14
8849,1,0,2.2718626504838557,0.09348024851964754,21,28,20,7,21,8,13
8850,0,0,1.2399357835225708,0.2244471637360943,16,22,13,5,17,5,11
8851,0,0,7.807481935120404,0.0004065154862051834,23,34,18,3,31,2,21
8852,0,1,1.58906839138942,0.830484991889429,12,15,7,3,12,9,3
8853,1,1,0.6889505050766722,0.665733420729471,23,31,19,5,26,12,11
8854,0,0,5.407094485136052,0.004464629215368832,15,18,10,1,17,1,14
8855,1,1,2.7437218208927927,0.9395578010405337,9,13,6,1,12,8,1
8856,0,0,0.5665348670861767,0.36203677002675905,11,12,6,3,9,4,7
8857,0,0,2.745044037447621,0.06036715530906689,15,20,11,2,18,3,12
8858,1,1,1.2094962294481606,0.7702098005144755,17,20,14,5,15,9,8
8859,0,1,0.9423023434378615,0.7195644853778058,26,37,21,11,26,14,12
8860,0,0,3.9115245552849993,0.0196174273263372,11,12,6,1,11,1,10
8861,1,1,6.586262763556508,0.9986227148472102,17,26,18,0,26,17,0
8862,0,0,2.5909544992735047,0.06972284712123933,13,17,9,0,17,0,13
8863,1,1,0.4602185883930683,0.6130660301008671,24,35,20,10,25,13,11
8864,1,1,0.6301402379513574,0.652521260042398,14,16,10,4,12,8,6
8865,1,1,3.7775253365133716,0.9776325112923784,13,18,10,2,16,11,2
8866,0,0,2.140951722067864,0.10517978263665206,37,57,36,15,42,19,18
8867,1,1,0.9195857322460761,0.7149576882715528,16,23,13,7,16,8,8
8868,0,0,2.6585842060862013,0.0654618936641197,16,23,13,5,18,5,11
8869,1,1,4.966171718285185,0.9930784622854331,15,21,12,2,19,13,2
8870,0,0,0.04860187230217616,0.4878519231205277,8,7,2,2,5,3,5
8871,0,0,2.569860459179615,0.07110351989822106,20,27,17,5,22,7,13
8872,1,0,1.5921922213743973,0.16907569025547142,23,31,14,8,23,9,14
8873,1,1,1.2058129028277025,0.7695572520998546,6,5,3,1,4,4,2
8874,0,0,5.456812929796708,0.004249002688343939,9,8,2,1,7,1,8
8875,1,1,2.2694440081772798,0.9063145900197396,7,7,3,1,6,6,1
8876,1,1,1.2022808320848122,0.7689302823193803,17,25,16,7,18,10,7
8877,1,1,2.320904029917263,0.910593567708244,15,21,13,3,18,12,3
8878,1,0,0.3758420200757273,0.40713014140823456,27,41,25,9,32,10,17
8879,0,0,0.9503845058255411,0.2788075013243244,17,21,13,3,18,6,11
8880,0,0,2.576530168597933,0.07066425838849333,15,20,13,7,13,5,10
8881,1,0,0.5999419360512046,0.3543569780029737,12,15,9,5,10,7,5
8882,1,1,2.701586880596733,0.937120217223444,15,18,8,4,14,8,7
8883,0,0,3.2849452585135213,0.0360912820143694,14,16,8,4,12,5,9
8884,0,0,1.3895883463606824,0.19947348313917768,15,17,9,2,15,3,12
8885,1,0,4.600902300092035,0.009942915647312867,17,20,11,3,17,4,13
8886,1,1,2.371984530893566,0.9146658850963048,16,22,11,5,17,10,6
8887,1,1,1.143554220954332,0.7583316004634629,3,2,1,0,2,3,0
8888,0,0,4.0151876545814,0.017719909494876007,20,25,14,3,22,5,15
8889,1,1,3.3385002505121504,0.9657262366480737,15,19,9,3,16,10,5
8890,1,0,0.08062448029208613,0.47985479124807506,6,5,2,1,4,2,4
8891,0,0,7.068932630981678,0.000850417281038296,41,67,40,12,55,12,29
8892,1,1,4.722801381250059,0.9911881011998328,22,33,23,4,29,16,6
8893,0,0,0.8028898559635769,0.30940769027741355,12,15,10,1,14,2,10
8894,1,1,2.82048781064004,0.9437729579768991,17,24,15,4,20,13,4
8895,1,1,1.6618338231808476,0.8404840184313285,12,15,11,2,13,8,4
8896,1,1,0.35690506057857263,0.5882910305801301,24,36,23,7,29,11,13
8897,1,1,1.183476184858748,0.7655722552990814,10,12,8,2,10,6,4
8898,0,0,8.73149434917838,0.0001613950039275336,25,33,19,3,30,4,21
8899,1,1,0.9970826181238981,0.7304846000354428,7,7,4,2,5,5,2
8900,0,0,1.3285614632169784,0.2093974156197005,11,13,8,1,12,2,9
8901,0,1,1.1676190826641588,0.7627143841277363,21,30,22,4,26,15,6
8902,1,0,3.8648708205401787,0.020535099285201253,18,22,13,3,19,4,14
8903,0,0,0.531795976770955,0.3700981024648089,9,9,3,2,7,3,6
8904,1,0,1.5744573467687817,0.17158188979805922,12,12,5,2,10,3,9
8905,0,1,0.17197094961691484,0.5428870941942943,28,41,22,13,28,13,15
8906,0,0,1.7456279585166914,0.1485994891959932,7,7,4,0,7,0,7
8907,0,0,4.958503557215977,0.006974445602509927,29,44,26,5,39,6,23
8908,0,1,0.26387541584348706,0.5655887150900504,20,30,21,8,22,10,10
8909,1,1,2.236854029098778,0.9035105428744723,11,14,10,4,10,9,2
8910,1,1,4.791749424528899,0.9917703608758085,12,17,11,0,17,12,0
8911,1,1,2.3736125277644664,0.9147928680886964,12,16,10,4,12,10,2
8912,0,0,1.9364665318075178,0.1260365587570238,5,4,1,0,4,0,5
8913,1,0,0.14679288050606143,0.46336753641256656,15,18,9,3,15,4,11
8914,1,1,2.1822020272524756,0.8986398227400241,19,27,16,4,23,12,7
8915,1,1,1.688052335339018,0.8439678512701403,3,2,1,0,2,3,0
8916,0,0,1.547401633642925,0.17546186987760837,15,19,10,5,14,5,10
8917,1,1,1.0141630382020101,0.7338340717788958,5,5,2,1,4,4,1
8918,0,0,7.010013749590536,0.0009019818694511184,20,26,15,1,25,1,19
8919,0,0,0.23293411729281344,0.44202835420616193,15,19,10,4,15,5,10
8920,0,0,2.338592515141884,0.08797678153340205,11,12,6,4,8,4,7
8921,1,1,3.548825474215075,0.9720455284931324,21,27,14,6,21,14,7
8922,1,1,4.623703810487689,0.9902790537419137,11,14,9,1,13,10,1
8923,0,0,1.9902708903826878,0.12022820652719346,14,17,10,5,12,4,10
8924,1,1,4.185613210437848,0.9850150891783015,13,17,12,2,15,11,2
8925,1,1,0.8202754689526219,0.6942948113918669,12,14,8,6,8,7,5
8926,1,1,4.206657634606646,0.9853225628348267,17,25,16,2,23,15,2
8927,0,0,1.8352631769954721,0.13761247201916227,8,8,3,2,6,2,6
8928,0,0,0.663201829943121,0.34002073205407324,10,9,3,2,7,4,6
8929,1,1,2.7723666161474734,0.9411641728521934,42,68,45,20,48,22,20
8930,1,1,2.94840939894852,0.9501882583332617,17,23,15,3,20,12,5
8931,0,0,2.6094964611939324,0.06852973934295536,13,15,9,4,11,4,9
8932,1,0,0.22627030512074775,0.44367254118259547,14,16,8,4,12,5,9
8933,1,1,2.646969676899341,0.9338239723585424,12,16,12,2,14,10,2
8934,0,0,2.084939525764215,0.11056926023628155,18,22,12,2,20,5,13
8935,1,0,1.3753770399445358,0.2017524937428683,14,14,7,4,10,5,9
8936,0,0,2.1419751469008323,0.10508349987904464,6,6,2,0,6,0,6
8937,1,0,1.0842322695421007,0.2527059348059705,19,25,14,3,22,5,14
8938,1,1,1.9089114454119864,0.8708968050159906,17,23,16,5,18,12,5
8939,0,0,0.3058754259284786,0.4241218185485469,19,25,13,6,19,7,12
8940,1,1,2.86041254289167,0.9458544313052266,10,15,10,0,15,10,0
8941,1,0,1.434612217261753,0.1923810644231576,33,50,32,10,40,15,18
8942,1,0,0.18447406404036926,0.45401182747964275,8,8,3,2,6,3,5
8943,1,1,1.726663668741953,0.8489851692442183,5,6,3,0,6,5,0
8944,1,1,3.924601912282581,0.9806325103349947,22,29,18,6,23,14,8
8945,1,0,1.512372379284642,0.18058747276078413,25,39,22,10,29,10,15
8946,0,0,0.14784522110238218,0.4631058735498841,9,9,5,2,7,3,6
8947,0,0,5.7678823091279865,0.00311662746224306,23,30,16,4,26,3,20
8948,0,0,0.35730598692938054,0.41161186661435367,19,25,15,6,19,8,11
8949,0,0,0.6085630809590181,0.35238704821608413,10,10,3,2,8,3,7
8950,0,0,2.378105042871475,0.08485760630668615,19,24,13,3,21,6,13
8951,0,0,1.1464713552053891,0.24113419450683304,13,16,9,4,12,4,9
8952,1,1,2.0638405757133764,0.8873386789970569,39,65,42,20,45,20,19
8953,0,0,1.5884170743822827,0.16960672004178623,12,14,6,3,11,4,8
8954,1,1,2.975946233348105,0.9514755517469837,5,5,2,0,5,5,0
8955,0,1,0.022206622060788384,0.5055514273839101,20,25,16,4,21,10,10
8956,1,0,1.5030644967872322,0.18196890972005464,12,13,6,2,11,3,9
8957,0,0,3.230268803542175,0.03804240893429145,13,18,12,2,16,1,12
8958,1,1,2.363679103937267,0.9140153916741138,43,68,48,18,50,22,21
8959,0,0,3.269325219758875,0.03663863803995626,24,31,17,5,26,7,17
8960,0,0,0.9625396625690095,0.2763700003619707,15,19,13,1,18,2,13
8961,0,0,4.882593256651083,0.007520354272947727,18,22,14,4,18,4,14
8962,0,0,5.492810953312084,0.004099383173854498,18,20,10,2,18,3,15
8963,0,0,1.0718125215510959,0.2550585455330735,13,17,12,4,13,4,9
8964,0,1,0.018864119628432263,0.504715890060179,20,29,17,8,21,11,9
8965,1,1,4.45863526752186,0.9885543657191755,23,31,19,8,23,15,8
8966,1,1,3.6027102257727543,0.9734730831133873,27,43,29,7,36,19,8
8967,1,1,3.710071956136927,0.9761089886806338,23,32,16,6,26,13,10
8968,0,0,2.187283954433473,0.10089822021208139,7,7,2,1,6,1,6
8969,1,0,1.3571122487462786,0.20471003839137847,16,21,11,4,17,5,11
8970,0,0,5.198589812292031,0.005493998532928646,11,11,5,1,10,2,9
8971,0,1,0.4344166595887695,0.6069278313110293,26,38,28,6,32,13,13
8972,0,1,1.9662427991959963,0.8772069799196732,7,8,5,1,7,6,1
8973,1,1,1.8628287199657687,0.8656263178201359,17,20,11,7,13,8,9
8974,1,1,4.358132591324896,0.987359554017076,23,34,23,3,31,18,5
8975,0,0,1.11531495044833,0.24688134587536248,21,28,17,7,21,7,14
8976,1,1,1.1738902021592061,0.7638474680763528,5,5,2,1,4,4,1
8977,1,1,2.7728824307367637,0.9411927291594107,16,18,9,4,14,9,7
8978,0,0,2.3809554880169115,0.08463651165816588,24,34,21,5,29,6,18
8979,0,0,4.1760201331852524,0.015127168932572599,23,34,23,5,29,7,16
8980,1,1,1.860772396284105,0.8653869517226226,27,35,22,9,26,16,11
8981,1,1,1.46488071211962,0.8122780321821093,5,5,2,1,4,4,1
8982,1,1,4.313079918252476,0.986784742873085,22,34,25,6,28,18,4
8983,0,0,4.480574321992085,0.011200044147825938,26,37,21,6,31,7,19
8984,1,1,4.774897037408465,0.9916316670289367,15,25,16,1,24,14,1
8985,0,0,1.1409657584791022,0.24214309070570972,13,16,8,3,13,3,10
8986,1,1,2.2816159206731284,0.9073429895154254,12,15,9,2,13,7,5
8987,1,1,0.8417581561012188,0.6988353747424019,4,3,1,1,2,3,1
8988,0,0,5.196421583789431,0.005505858042432421,14,17,8,0,17,0,14
8989,0,0,6.262801607529704,0.0019022731896507494,22,27,17,3,24,3,19
8990,1,1,2.967850951085678,0.9511004249992064,6,7,3,0,7,6,0
8991,0,1,1.6195188958025306,0.8347287689734042,6,6,2,2,4,4,2
8992,1,1,1.9601664720782461,0.8765509674025411,17,22,12,6,16,10,7
8993,1,1,2.2834307618792957,0.9074954535278738,4,4,2,0,4,4,0
8994,1,1,4.058839546803363,0.9830241100352648,16,24,15,2,22,14,2
8995,1,1,3.1335018730386905,0.9582537052882807,13,15,7,3,12,10,3
8996,1,1,0.8075543411039923,0.6915881045041268,4,3,1,1,2,3,1
8997,0,0,1.5933931094902376,0.16890704560358105,20,27,14,7,20,7,13
8998,1,1,4.3889062708987945,0.9877379253901715,22,32,21,3,29,13,9
8999,0,0,6.308585320752332,0.0018172984070058407,13,15,8,0,15,0,13
9000,0,0,4.352949316085982,0.012705300390076113,13,15,8,2,13,3,10
9001,0,0,2.2160850515322803,0.09831531683070749,21,28,15,5,23,6,15
9002,0,0,1.2182524186107468,0.2282441386495001,12,15,9,2,13,4,8
9003,0,0,1.9451992833509775,0.12507777166509026,12,14,8,2,12,3,9
9004,1,1,2.716736308916667,0.9380070216722753,33,52,34,12,40,21,12
9005,1,1,2.351456644839585,0.9130499398251177,6,8,4,0,8,6,0
9006,1,1,2.661553198053417,0.9347195051081393,7,10,5,0,10,7,0
9007,1,1,4.521388351111094,0.9892430537637796,18,26,16,5,21,14,4
9008,1,1,1.8555933072894668,0.8647824848178195,17,21,11,6,15,7,10
9009,1,1,3.5683727541216967,0.9725718141978232,18,25,13,4,21,11,7
9010,0,1,0.6937948507634166,0.6668105778390222,13,16,10,4,12,6,7
9011,1,0,0.6559935232000056,0.3416401844131933,14,17,9,3,14,4,10
9012,1,1,2.769779655364929,0.9410207584441204,32,45,26,11,34,20,12
9013,0,0,3.8682862576969788,0.020466515578941746,19,24,15,1,23,2,17
9014,1,0,3.4044689616291652,0.032156090165814,14,15,7,2,13,2,12
9015,1,1,4.774719848570875,0.9916301965340081,20,25,14,5,20,14,6
9016,1,1,2.0901849703464177,0.8899455433974436,24,36,22,10,26,15,9
9017,0,0,0.7785602418625919,0.31463026982669295,29,43,25,7,36,9,20
9018,1,0,0.009955040531097747,0.49751126042062,16,23,11,7,16,7,9
9019,1,1,3.695225257386448,0.9757603018989298,13,19,14,1,18,12,1
9020,1,1,5.473565892453339,0.9958212927678306,14,20,11,2,18,12,2
9021,1,0,9.661133973429859,6.370817398293482e-05,21,24,11,2,22,3,18
9022,0,0,0.7181960580773863,0.327790346862914,17,23,12,9,14,9,8
9023,0,0,1.4146799938371242,0.19549694771664972,5,4,1,1,3,1,4
9024,1,0,0.1277510343859034,0.46810560685249647,26,38,23,8,30,13,13
9025,0,0,0.7928377963619324,0.31155966453461337,40,62,39,16,46,16,24
9026,0,0,3.5852690204997892,0.026981043951431638,12,14,7,1,13,1,11
9027,1,0,0.09175170918689157,0.47707815084321537,10,11,7,5,6,5,5
9028,0,1,0.04004650495849038,0.510010288464926,9,10,5,5,5,5,4
9029,1,1,6.919025589216726,0.9990121837839318,14,21,13,1,20,13,1
9030,0,0,3.167346528740608,0.040413191550771166,21,28,17,7,21,6,15
9031,0,0,4.604243406128028,0.009910079413206985,39,62,35,18,44,14,25
9032,1,0,0.619408354750024,0.34991602385766185,9,9,3,3,6,4,5
9033,0,0,7.439145441036862,0.0005874419909440709,18,24,14,2,22,3,15
9034,1,1,0.6245592560632669,0.6512547686983633,5,4,1,2,2,3,2
9035,0,0,2.903526573946122,0.05197950702033094,16,19,9,3,16,4,12
9036,1,1,2.9631162495941217,0.9508797506675728,11,12,6,2,10,8,3
9037,1,0,0.11021205310787074,0.4724748427288492,24,34,18,10,24,9,15
9038,0,0,4.337436653560415,0.012901367487138105,14,18,10,3,15,4,10
9039,1,0,1.1487606503044248,0.24071552813563524,16,20,9,6,14,5,11
9040,0,1,1.7293514332204014,0.8493294426531321,17,21,12,5,16,11,6
9041,1,1,1.1784488070531935,0.7646687805253062,33,49,29,14,35,15,18
9042,0,0,1.8729609946884973,0.1331994823884055,15,18,10,4,14,7,8
9043,0,0,0.7320542431888617,0.32474409986536945,29,43,23,10,33,12,17
9044,1,0,0.0052360328926246424,0.49869099476748757,20,27,15,5,22,8,12
9045,1,1,3.9517087810100766,0.981140682746852,22,32,23,3,29,17,5
9046,1,1,3.2084772989661268,0.9611520496369369,18,24,15,4,20,12,6
9047,1,1,1.0969550230191754,0.7496891339650747,18,26,15,7,19,9,9
9048,0,0,3.5901824789771664,0.026852349959958666,14,18,11,2,16,3,11
9049,0,0,2.0951699758926794,0.10956716108398801,11,14,9,2,12,1,10
9050,0,0,4.218856342088316,0.014502059798366052,19,23,13,3,20,5,14
9051,1,1,5.14284071395708,0.9941928467032819,20,32,21,4,28,17,3
9052,0,1,0.9049848012722017,0.711972802657252,7,9,5,3,6,6,1
9053,1,1,1.2050116887669549,0.7694151350035379,5,4,2,1,3,4,1
9054,0,0,4.111245360586992,0.01612313808319521,33,48,27,9,39,12,21
9055,0,0,2.3412321039433053,0.08776521940848814,33,51,29,12,39,10,23
9056,1,1,2.4668971950540066,0.9217883620110436,22,30,18,7,23,16,6
9057,0,0,4.4232079003688565,0.011853498630959414,22,29,14,7,22,7,15
9058,0,0,7.20474265457953,0.0007425016745192803,24,34,21,3,31,4,20
9059,0,0,1.6995408649236805,0.15452524027697367,20,26,15,7,19,10,10
9060,1,1,1.0238667969145139,0.735725119958983,27,41,25,10,31,13,14
9061,0,0,2.611912532116622,0.06837567396944477,11,12,7,1,11,2,9
9062,0,0,0.33211522212375566,0.4177260462143466,6,6,3,1,5,1,5
9063,1,1,2.077814231769646,0.8887280651818248,9,10,4,2,8,6,3
9064,1,1,2.7788837014154106,0.9415240151986406,7,8,4,1,7,6,1
9065,1,1,2.0460753034667536,0.8855504488799056,17,22,12,5,17,9,8
9066,1,1,1.9207544567359986,0.8722225417861129,5,5,3,0,5,5,0
9067,0,1,2.9030929848934424,0.9479991225843373,18,23,12,5,18,11,7
9068,0,0,1.9317673205033987,0.12655509348488958,17,22,14,1,21,2,15
9069,0,1,0.05586513087259415,0.513962651555468,8,8,4,3,5,3,5
9070,1,1,3.752833745308715,0.9770861600814732,9,13,9,0,13,9,0
9071,1,1,4.139589594119285,0.9843203790826722,43,72,47,20,52,25,18
9072,0,0,6.734983552937655,0.0011871836686140336,24,28,17,4,24,5,19
9073,0,0,7.084374822439288,0.0008373967629230483,15,20,11,0,20,0,15
9074,1,1,3.1578294550262913,0.9592161180862973,8,11,7,0,11,8,0
9075,0,1,2.401671688533857,0.9169546893208498,12,17,11,3,14,11,1
9076,1,1,0.7391008933263958,0.6767992150843591,14,20,12,4,16,9,5
9077,1,1,2.269705871895538,0.9063368220976,17,21,9,6,15,9,8
9078,0,0,2.489685494215798,0.07658443600655918,26,39,25,7,32,9,17
9079,1,1,3.2823358215914826,0.9638178290906692,39,63,40,14,49,21,18
9080,1,1,1.0610650754112247,0.742894029980824,14,19,12,3,16,10,4
9081,1,1,1.9450347962518109,0.8749042268549982,27,39,20,9,30,12,15
9082,0,0,4.7019443473006595,0.008995948196902748,20,28,17,6,22,5,15
9083,0,0,0.0018260739838837914,0.4995434816308858,12,15,8,3,12,6,6
9084,0,0,3.306340220541462,0.03535432173956121,13,17,11,2,15,2,11
9085,1,1,6.02814337357826,0.9975958297335393,20,28,14,5,23,12,8
9086,1,0,0.024827326738186217,0.4937934871180669,11,14,9,3,11,4,7
9087,1,1,1.0305158110845645,0.7370158843499081,13,16,10,3,13,7,6
9088,1,1,2.40928991286936,0.9175329681902508,13,19,11,4,15,10,3
9089,1,1,3.831070161058814,0.9787739218492648,17,24,16,4,20,14,3
9090,0,0,0.7865754067236153,0.31290446858144216,24,38,23,9,29,8,16
9091,1,1,2.423769308544061,0.9186219666335275,9,10,7,1,9,8,1
9092,0,0,2.5132940481162542,0.07493145687447234,19,27,16,3,24,4,15
9093,0,0,6.012589620074443,0.0024417644384897574,22,30,18,4,26,4,18
9094,1,1,4.996727935419869,0.9932853610556363,18,30,21,3,27,16,2
9095,0,0,1.3384902485405403,0.2077584462724441,12,15,8,3,12,2,10
9096,1,1,1.3812755695704868,0.7991957841826973,6,6,2,1,5,5,1
9097,0,0,7.508313872883517,0.0005482044658895457,37,58,37,9,49,8,29
9098,1,1,0.006024242706703431,0.5015060561219256,9,10,4,3,7,5,4
9099,0,0,5.8106603656300635,0.0029865053944039266,27,42,27,11,31,8,19
9100,0,0,4.296095758693486,0.01343858199661041,23,33,20,4,29,6,17
9101,1,1,1.0986590141104509,0.7500087609180979,6,6,2,2,4,4,2
9102,0,1,1.4346495086459727,0.8076247294947625,7,8,4,1,7,5,2
9103,1,1,1.544180947958166,0.8240716902779922,13,16,9,4,12,8,5
9104,0,0,1.8618490448280562,0.13448767626352687,8,9,6,0,9,0,8
9105,0,0,0.5364335777023841,0.36901761230234675,9,9,3,2,7,3,6
9106,1,1,3.0007935251044318,0.9526099627644601,5,6,3,0,6,5,0
9107,1,1,2.679099567818573,0.9357820342344286,9,11,7,1,10,8,1
9108,0,1,2.1354642598160227,0.8943026338232213,18,23,13,6,17,10,8
9109,1,1,2.975230158213627,0.9514424799921286,9,13,9,0,13,9,0
9110,1,1,6.110355442368618,0.9977851547533825,33,51,30,11,40,20,13
9111,1,0,1.7588564670447955,0.14693361708110575,17,19,10,4,15,5,12
9112,1,1,2.4719766327500565,0.9221537782556912,14,18,10,5,13,7,7
9113,1,1,1.6562352703423933,0.8397319853327552,14,19,10,5,14,9,5
9114,0,0,4.35386107689779,0.01269386845571252,40,63,39,14,49,15,25
9115,0,0,1.4825751420434234,0.18503877434665772,6,5,2,1,4,2,4
9116,0,0,1.7705393974351407,0.14547526242600795,9,10,5,3,7,2,7
9117,1,1,3.2180821942796918,0.9615091005416747,17,23,12,4,19,12,5
9118,1,1,3.8046780220057963,0.9782186267223137,24,34,21,5,29,17,7
9119,0,0,7.310161253158184,0.0006682623387229691,18,20,10,4,16,4,14
9120,0,0,6.130409594500492,0.0021709662788638173,19,23,13,2,21,3,16
9121,0,1,0.7096426362871004,0.6703221906838432,10,10,3,5,5,4,6
9122,1,1,1.8595316807297761,0.8652423522860221,21,31,18,7,24,11,10
9123,1,1,6.399003230535215,0.9983395474000677,16,23,15,3,20,13,3
9124,1,1,3.8005726620486726,0.9781309820972179,10,14,8,1,13,9,1
9125,0,0,4.980575951875178,0.006823228276439552,39,61,38,14,47,12,27
9126,1,1,2.636151991649821,0.933152328995336,15,25,16,3,22,13,2
9127,1,1,3.593484888590681,0.9732338115924534,25,37,26,5,32,19,6
9128,1,0,0.4113241119335904,0.39859466648752007,28,41,27,10,31,13,15
9129,1,1,0.9484489305461341,0.7208031384699917,15,20,11,4,16,7,8
9130,1,1,0.31721477961239253,0.5786453230364244,7,7,3,2,5,4,3
9131,0,0,6.376459743112266,0.0016982458177398074,19,24,14,3,21,4,15
9132,0,1,0.7569617616997195,0.6806937362222203,7,7,3,2,5,4,3
9133,1,1,2.573781739972601,0.9291550369297625,8,10,6,1,9,7,1
9134,1,0,3.477314441118942,0.02996464184575942,23,32,18,7,25,7,16
9135,0,0,0.8536414835592943,0.298669531593577,9,9,4,2,7,3,6
9136,0,1,0.6245592560632669,0.6512547686983633,5,4,1,2,2,3,2
9137,0,0,6.3477200486905865,0.0017476744646677256,27,39,25,9,30,7,20
9138,1,1,2.623704174262462,0.9323716466455496,9,12,5,2,10,7,2
9139,1,1,6.173630372952047,0.997920674804083,14,25,17,0,25,14,0
9140,1,1,2.2572035132433053,0.9052700867324981,14,20,12,4,16,10,4
9141,1,1,4.478008809154439,0.9887715081571498,14,22,15,2,20,13,1
9142,0,0,3.8387765627748385,0.021066562897932406,12,15,7,2,13,1,11
9143,1,1,4.917448439539047,0.9927353820660837,20,30,15,5,25,13,7
9144,0,0,2.0670855556073278,0.11233733193463613,11,12,5,1,11,1,10
9145,0,0,2.9356770221877633,0.05041783776775299,12,14,8,5,9,4,8
9146,0,0,2.7613438228278264,0.0594491816552466,8,7,3,1,6,1,7
9147,1,1,3.833483889713058,0.9788240104373639,17,26,19,1,25,16,1
9148,1,1,4.627300968154051,0.9903136205986316,32,49,33,10,39,16,16
9149,0,0,4.115102269164388,0.016062069285037617,26,36,20,4,32,5,21
9150,0,0,1.733873870291962,0.15009273969929626,12,13,8,3,10,3,9
9151,1,0,0.39252204989133355,0.40311031625186355,10,11,6,4,7,5,5
9152,0,0,0.7949871466317306,0.31109883670333605,3,2,1,0,2,0,3
9153,1,0,1.1518842087234495,0.2401450929360296,21,27,18,7,20,10,11
9154,1,1,4.234165777997224,0.9857151203565006,25,37,22,6,31,15,10
9155,0,1,2.230125091820204,0.9029223243146056,29,42,24,11,31,14,15
9156,1,1,3.275330032388276,0.9635727205982821,13,18,13,2,16,11,2
9157,1,1,0.8456138824761323,0.6996462455793464,15,18,10,4,14,10,5
9158,1,1,5.845538715683492,0.9971155681059927,17,25,14,3,22,13,4
9159,0,0,1.1170777361997468,0.24655373571386885,6,6,2,1,5,1,5
9160,1,1,1.1505067362244508,0.759603462217995,18,25,14,8,17,8,10
9161,0,0,5.447204789226035,0.004289848482166514,17,26,15,2,24,1,16
9162,0,1,1.6868690062099976,0.8438119598177932,26,39,24,12,27,15,11
9163,1,1,0.05532488791803214,0.5138276951255136,18,23,11,7,16,10,8
9164,1,1,3.6206165358382965,0.9739315825672681,8,11,5,1,10,7,1
9165,1,0,0.15782279574937874,0.46062599457989684,21,28,20,6,22,9,12
9166,0,0,8.94880878547145,0.00012987492723270933,29,41,21,9,32,8,21
9167,1,1,1.3389623413114762,0.7923192470574212,16,22,11,6,16,7,9
9168,0,0,5.763867337643279,0.0031291265522931377,23,30,15,4,26,5,18
9169,0,0,0.3221176591932404,0.42015974495008557,15,16,7,3,13,5,10
9170,1,1,4.768051785520453,0.9915746714609316,14,18,11,2,16,12,2
9171,0,1,0.009112765100671716,0.502278175509743,10,13,8,3,10,4,6
9172,0,0,0.029480866720025922,0.49263031707475335,21,31,19,6,25,7,14
9173,0,0,4.989713374511241,0.006761585177016638,19,23,13,7,16,6,13
9174,1,1,0.38381549868238896,0.5947930242152429,27,36,20,9,27,13,14
9175,0,0,2.053838394459935,0.11366510706889721,11,12,5,1,11,2,9
9176,0,0,4.975600306480269,0.0068570294665186715,30,43,24,6,37,6,24
9177,0,0,4.160870772556273,0.0153545349950861,10,11,6,1,10,1,9
9178,1,0,1.1391197429250945,0.24248201391113822,6,6,4,0,6,0,6
9179,0,0,2.3331806731296236,0.08841198012920959,22,31,19,10,21,11,11
9180,1,1,1.4585112103984255,0.8113048626798969,9,12,5,2,10,7,2
9181,0,0,2.9225037669136036,0.05105226715705591,10,11,5,0,11,0,10
9182,0,1,0.6327333080055009,0.6531089728862842,6,7,4,3,4,5,1
9183,1,1,1.773209667406308,0.8548563705902767,7,9,4,1,8,6,1
9184,0,0,4.309096411467337,0.013267305360128434,23,33,21,1,32,2,21
9185,1,1,3.6931901429245446,0.9757121204627354,14,22,15,0,22,14,0
9186,0,0,0.23829722917746876,0.44070601440405865,14,20,13,4,16,6,8
9187,0,0,0.06973360696342423,0.482573659386041,10,11,4,2,9,3,7
9188,1,1,0.9957134118124786,0.7302149499567125,12,16,10,3,13,9,3
9189,1,1,1.103072044239057,0.7508352715084402,6,5,3,1,4,4,2
9190,0,0,6.087762446250698,0.0022653401467378487,31,40,24,5,35,6,25
9191,0,0,0.27624522471536306,0.4313745486056413,27,38,20,9,29,10,17
9192,1,1,2.5126277601503095,0.9250223451376662,16,20,11,3,17,8,8
9193,0,0,2.4762269617764807,0.0775416537703898,13,15,7,3,12,3,10
9194,0,0,5.579247155838152,0.0037612066571115488,29,41,23,11,30,9,20
9195,1,1,4.237744064299994,0.9857654180959478,29,46,28,12,34,18,11
9196,0,1,1.5525255856516862,0.8252782055861219,13,17,8,4,13,9,4
9197,1,1,3.9768378581609944,0.9816000836130688,12,17,12,1,16,11,1
9198,0,0,9.023034508737425,0.00012058506733958474,26,36,20,4,32,4,22
9199,1,1,0.4502687250254098,0.610703123831837,5,5,2,1,4,4,1
9200,0,0,0.5496537763878613,0.36594473924328774,16,20,12,6,14,6,10
9201,0,1,1.6522685215926916,0.8391974119389363,7,8,5,1,7,6,1
9202,1,1,4.7538084473763424,0.9914548407489123,23,37,25,4,33,18,5
9203,1,1,0.08845447638820225,0.5220992119315127,15,21,10,6,15,8,7
9204,1,1,4.202106075954098,0.985256592535269,9,13,8,0,13,9,0
9205,0,0,0.3237488449585795,0.41976239828374806,12,13,6,4,9,4,8
9206,1,1,3.607674619024534,0.9736009789469671,22,32,24,3,29,18,4
9207,0,0,0.5222264684963948,0.3723317584435487,12,13,6,2,11,3,9
9208,1,1,1.1720818132171302,0.7635211070860908,8,9,5,2,7,6,2
9209,1,1,2.080757718538246,0.8890188151439657,12,14,8,3,11,7,5
9210,1,1,0.32830414511510453,0.5813466921042103,18,24,15,5,19,9,9
9211,1,1,3.5918697482206525,0.9731917053998963,15,20,10,3,17,11,4
9212,1,1,3.8520576020162682,0.9792055937083315,7,9,4,0,9,7,0
9213,0,0,1.5189390020401625,0.17961780988766518,10,11,5,2,9,3,7
9214,1,1,3.8308351796373312,0.978769039436017,7,9,6,0,9,7,0
9215,0,0,4.682432280291325,0.009171575714322922,25,35,21,10,25,9,16
9216,1,1,1.7204975248696568,0.8481929095885952,7,8,4,1,7,6,1
9217,1,1,4.881110942011864,0.9924685739487262,18,26,15,2,24,16,2
9218,0,0,1.37225879948699,0.2022551485227544,21,30,16,4,26,4,17
9219,0,0,5.593629139848431,0.0037076992992389757,25,35,21,8,27,6,19
9220,1,1,4.189834029349669,0.9850772626273794,22,33,19,8,25,13,9
9221,1,1,0.7541152104823172,0.6800747209843551,16,22,14,6,16,10,6
9222,0,0,1.2992262669608028,0.21429526375980756,24,38,21,11,27,9,15
9223,1,1,2.927445557031002,0.9491866120119619,19,25,13,5,20,11,8
9224,1,1,5.081233021434063,0.9938261092575089,22,30,17,4,26,15,7
9225,1,1,2.069227517511265,0.8878760821933465,19,26,17,6,20,12,7
9226,1,1,3.5527527448235645,0.972152046686396,12,17,9,1,16,11,1
9227,0,0,2.923370321136905,0.05101030245753124,16,23,14,7,16,6,10
9228,1,0,1.6843624609431114,0.15651867090339833,24,34,21,6,28,6,18
9229,0,0,5.989190532332892,0.002499428708485185,17,22,13,2,20,3,14
9230,0,0,0.8648203489468559,0.2963332214389792,11,13,6,4,9,3,8
9231,1,1,4.156310152151375,0.9845763614003161,22,32,22,6,26,16,6
9232,1,0,2.115915712474891,0.10755949514943908,9,9,4,0,9,0,9
9233,1,0,0.8893197706909058,0.2912502228281948,14,17,9,2,15,5,9
9234,1,0,0.17696749829269987,0.45587322702967825,12,13,6,2,11,3,9
9235,0,0,0.9022770373891511,0.28858279035212697,12,14,9,4,10,4,8
9236,1,1,2.828954216311459,0.9442205482074532,9,12,9,0,12,9,0
9237,0,0,3.2043081572550145,0.039003920701808914,16,22,12,3,19,3,13
9238,0,0,3.2167201691184353,0.038541338822117965,14,17,9,2,15,3,11
9239,1,1,3.0255844867832478,0.9537166569397032,18,24,15,3,21,13,5
9240,0,0,3.1624000644632333,0.040605451944048965,26,34,19,5,29,6,20
9241,1,1,2.2935978574570672,0.9083454265315919,12,17,10,2,15,10,2
9242,0,1,2.0266833941365547,0.8835703198587566,15,20,10,5,15,9,6
9243,1,1,1.128022887318707,0.7554738454195852,12,12,4,5,7,5,7
9244,1,1,1.789435552398186,0.8568580596530992,19,27,16,7,20,8,11
9245,0,0,3.3401191757276467,0.03422021881184034,13,15,7,4,11,4,9
9246,1,1,2.679469959262314,0.9358042889523652,8,11,6,0,11,8,0
9247,1,1,3.1924660678290673,0.9605497755946734,10,12,9,1,11,9,1
9248,1,0,2.0830034958082884,0.11075980018137688,21,27,16,3,24,5,16
9249,0,0,0.6466696615533386,0.34374041342192474,11,13,8,2,11,5,6
9250,1,1,3.7225565084293097,0.9763984072573815,23,37,25,9,28,14,9
9251,0,0,0.0674462973315677,0.4831448147067998,17,25,17,6,19,8,9
9252,1,0,1.826507058973595,0.13865490787456536,16,22,14,1,21,2,14
9253,1,1,3.259915403980809,0.9630277787566834,20,29,21,3,26,15,5
9254,0,1,2.1408612033093606,0.8948116977052443,30,43,24,11,32,14,16
9255,0,0,0.19719074469745035,0.45086143683281443,25,38,21,9,29,12,13
9256,0,0,0.5557945175307883,0.36452108449228193,14,21,13,5,16,5,9
9257,0,1,1.3749111093246225,0.7981724584371441,14,18,10,6,12,8,6
9258,1,1,2.557773339082239,0.9280940019221664,8,9,5,1,8,7,1
9259,0,0,8.907513724259264,0.0001353496560527745,30,46,28,10,36,7,23
9260,1,1,3.5707293531316795,0.9726346085904183,21,29,16,6,23,13,8
9261,0,0,0.46265545279644993,0.3863560660091915,22,31,20,4,27,6,16
9262,1,1,5.739219412016094,0.9967930390226741,20,30,21,4,26,17,3
9263,1,1,1.8289966134177609,0.8616421515419745,4,3,1,0,3,4,0
9264,1,1,2.3316059212064686,0.9114610199755145,13,16,7,5,11,6,7
9265,1,1,1.7157059901204528,0.8475749135707876,8,9,3,2,7,6,2
9266,0,0,4.866590387477829,0.007640742687001434,28,44,29,9,35,7,21
9267,0,0,5.166089600544099,0.005674458041400099,10,10,6,0,10,0,10
9268,0,0,2.4751140388822086,0.07762129740897994,9,9,5,2,7,3,6
9269,1,1,1.703244318874669,0.8459579867594007,7,6,2,2,4,5,2
9270,0,0,3.659034042602227,0.025110598000401163,17,22,15,2,20,3,14
9271,1,1,0.21492936349646374,0.5535264464705106,18,24,12,7,17,8,10
9272,0,1,1.1494493916420614,0.7594103317138874,13,14,8,4,10,8,5
9273,1,1,2.8515123785633483,0.9453968069231231,12,18,12,1,17,11,1
9274,0,0,4.453669386853424,0.01150195792303077,28,39,22,7,32,10,18
9275,0,0,2.5104925999940155,0.07512587549577743,17,21,13,3,18,4,13
9276,0,0,3.2552076268120347,0.03714020882360192,17,24,14,4,20,4,13
9277,0,0,4.817305787987829,0.008023650379826885,26,35,20,5,30,5,21
9278,1,0,0.45233628370263324,0.38880543746408414,17,22,12,3,19,4,13
9279,1,1,2.477444104877841,0.922545362438614,7,8,5,1,7,6,1
9280,0,0,2.5368421599119637,0.0733154290860254,19,27,17,5,22,5,14
9281,1,1,1.3560276593006464,0.7951133297313071,13,14,8,4,10,8,5
9282,1,1,1.2996423700047446,0.7857747883473367,9,11,5,3,8,5,4
9283,1,0,3.382466658569733,0.03284794127285229,40,58,34,14,44,14,26
9284,1,1,1.5981205350836494,0.8317555400480053,18,23,12,6,17,11,7
9285,1,1,1.0922479271749106,0.7488047845585994,23,31,19,5,26,15,8
9286,1,1,5.031979945636195,0.9935164340637914,20,28,14,5,23,14,6
9287,1,1,2.9027743349152937,0.9479834119218621,15,21,13,2,19,13,2
9288,0,0,1.674284049750451,0.15785383927218322,18,23,13,4,19,6,12
9289,1,1,0.22883428638257253,0.5569602274449736,6,6,3,2,4,3,3
9290,1,1,4.0372979613113,0.9826608647638243,12,17,10,1,16,11,1
9291,1,1,0.9224175739658473,0.7155344468621093,14,19,11,5,14,8,6
9292,0,0,2.933556048623828,0.05051947812356583,16,21,10,3,18,4,12
9293,1,0,0.14079468929787706,0.46485935834062786,14,15,9,2,13,5,9
9294,0,0,2.4852393105944266,0.07689945936159315,11,12,8,2,10,3,8
9295,1,0,0.6905474482062655,0.33391130173582173,47,70,44,13,57,17,30
9296,0,1,0.3189561419018623,0.5790698348876493,18,22,11,7,15,10,8
9297,0,0,3.4318288651528306,0.03131540649865461,21,29,16,6,23,5,16
9298,0,0,5.4012253536600126,0.004490791737322364,28,37,19,6,31,8,20
9299,0,1,0.016789658071378333,0.5041973159189433,4,3,1,1,2,2,2
9300,0,0,3.8936377990975033,0.01996440804089683,26,36,21,8,28,8,18
9301,0,1,0.14632935392543844,0.5365172020108351,16,23,13,6,17,9,7
9302,0,0,3.408331299923022,0.03203610314206151,10,10,4,0,10,0,10
9303,1,1,1.2403801458803945,0.7756301772301365,15,20,11,5,15,9,6
9304,1,1,3.5656478384496197,0.9724990309939535,35,53,33,14,39,18,17
9305,1,1,4.454518408067331,0.988507691159465,23,34,23,3,31,18,5
9306,0,0,1.9362928659666763,0.12605568952529944,10,12,6,1,11,1,9
9307,0,0,1.994132208900429,0.11982038034858644,22,32,20,9,23,10,12
9308,0,0,5.870426103318422,0.0028137313311416,30,42,26,9,33,10,20
9309,0,0,4.938402812017149,0.0071150480598575205,15,17,10,3,14,3,12
9310,0,0,5.124632592958715,0.005913228179052266,11,13,7,0,13,0,11
9311,0,0,4.4833161010101765,0.011169720691181828,24,34,20,10,24,8,16
9312,0,0,2.8159662302927555,0.05646746423510984,25,35,22,7,28,7,18
9313,0,0,1.141902223417779,0.24197128169864368,6,6,3,1,5,1,5
9314,1,1,2.3002614817148834,0.908898692472365,8,9,7,1,8,7,1
9315,1,1,1.9307925205275627,0.873337113964682,15,23,13,4,19,12,3
9316,1,1,3.5076041761322836,0.9709033583798344,12,16,8,2,14,9,3
9317,0,0,11.157106719161936,1.4273284388965912e-05,30,43,25,9,34,5,25
9318,0,1,0.31651111404803167,0.5784737493901457,42,67,45,17,50,20,22
9319,0,0,0.13807216542391262,0.46553669174345214,13,15,10,2,13,5,8
9320,1,1,2.545483098459603,0.9272694785045208,23,33,21,6,27,14,9
9321,1,1,1.5521842390903264,0.8252289799645127,4,4,2,0,4,4,0
9322,1,1,1.2157066571788353,0.7713071184423603,23,34,22,9,25,14,9
9323,1,1,0.652683452383451,0.6576149174976464,16,21,12,6,15,7,9
9324,1,0,0.17490492434171712,0.45638490071943405,9,10,4,3,7,4,5
9325,0,0,2.4272887495389717,0.08111532259756782,14,19,10,6,13,6,8
9326,0,1,0.041252930452580605,0.5103117702700646,16,22,16,4,18,9,7
9327,1,1,0.9676564238610892,0.7246521269903077,10,10,5,3,7,4,6
9328,0,1,1.0120225706551762,0.7334157829755739,4,4,2,0,4,4,0
9329,1,1,1.7108974532727015,0.8469526518159605,3,2,0,0,2,3,0
9330,1,1,4.400007745279996,0.9878716578141775,18,29,19,4,25,15,3
9331,0,0,2.5256153683889284,0.07408184371637239,18,25,14,4,21,5,13
9332,0,0,3.012978004533731,0.04684300196311719,16,18,11,1,17,4,12
9333,0,0,7.60851138285191,0.0004959638734114424,21,26,14,1,25,2,19
9334,1,1,3.403745728274039,0.9678213936931324,8,11,7,0,11,8,0
9335,1,1,1.2790684382520914,0.7822911622809454,9,10,5,2,8,5,4
9336,1,1,0.20633354472496368,0.5514011547218126,14,18,11,4,14,7,7
9337,0,0,1.533059245761189,0.177546522471294,21,31,20,5,26,7,14
9338,0,0,5.352988786309614,0.004711675992324693,19,25,15,4,21,4,15
9339,0,0,1.022591177777539,0.2645229779168271,3,2,0,0,2,0,3
9340,0,0,0.7790355482155702,0.31452778471696785,11,14,8,3,11,4,7
9341,0,0,3.5201886086405834,0.028743230060379488,31,41,25,9,32,10,21
9342,1,1,4.405355073637002,0.9879355586107025,26,37,26,5,32,18,8
9343,1,1,0.6928365470367224,0.6665976334213878,3,2,1,0,2,3,0
9344,1,1,3.4453382667275223,0.9690918132795757,25,37,23,7,30,17,8
9345,1,1,3.26581361916099,0.963237213754673,12,15,7,3,12,8,4
9346,1,0,0.5873357150369358,0.35724639821918713,18,25,15,8,17,7,11
9347,0,0,2.7701965610793975,0.05895610725470468,27,36,20,11,25,12,15
9348,0,0,0.19784870510184316,0.4506985407143578,34,50,25,15,35,17,17
9349,1,1,5.205165846994887,0.9945418151098805,20,31,23,2,29,18,2
9350,1,1,5.142139555104041,0.9941887972085224,15,23,15,1,22,14,1
9351,0,0,4.05447942265994,0.017048803892695474,34,48,31,7,41,11,23
9352,1,1,1.0694182008450621,0.744486257971484,6,6,3,1,5,4,2
9353,0,0,6.89135052723902,0.0010155077442155491,30,40,23,5,35,8,22
9354,1,1,3.3136301776369423,0.9648934574404703,8,10,4,1,9,7,1
9355,1,1,2.346117656462331,0.9126251431055856,7,9,4,1,8,6,1
9356,0,1,0.28769356333712004,0.5714313855206303,16,21,14,6,15,7,9
9357,0,0,8.844928133377962,0.0001440900316750371,34,50,29,10,40,8,26
9358,0,0,2.132535933592207,0.10597448725986092,27,38,27,5,33,14,13
9359,1,1,1.4985228056668767,0.8173540545358864,12,17,8,4,13,8,4
9360,0,0,3.633919742562415,0.02573278529225842,38,57,34,10,47,11,27
9361,1,1,2.5250377488535327,0.9258785254597344,6,7,3,0,7,6,0
9362,0,0,2.986336130222759,0.048046992457651205,8,9,4,2,7,2,6
9363,0,0,1.7150497953672943,0.15250988066798232,17,21,11,6,15,6,11
9364,0,0,7.52355491940235,0.0005399170818682908,18,21,11,2,19,2,16
9365,1,0,0.7348015941669926,0.324141936305242,14,17,12,2,15,5,9
9366,1,1,5.73587924950197,0.9967823438667928,24,37,24,4,33,19,5
9367,0,1,1.5478464482212493,0.8246024743826905,11,14,7,3,11,8,3
9368,0,0,3.5859335299352133,0.0269636040230129,19,23,13,5,18,5,14
9369,1,1,0.3716401547047288,0.5918552381030235,3,2,0,1,1,2,1
9370,0,0,4.957787982988918,0.006979403277269758,21,28,14,3,25,3,18
9371,0,0,1.3645501945002572,0.20350177161953176,16,17,7,3,14,4,12
9372,0,0,7.66724423432653,0.0004676866533669388,18,21,11,1,20,1,17
9373,0,0,4.560048441362879,0.01035324118661618,19,25,14,5,20,5,14
9374,0,0,2.9342180058824914,0.050487735293152536,21,30,18,6,24,8,13
9375,0,1,0.5341595857157084,0.6304527456578275,14,16,9,5,11,7,7
9376,1,1,1.8032993240515616,0.8585500852569664,14,19,14,1,18,12,2
9377,1,0,1.2794867251610005,0.21763760697650858,11,12,5,2,10,3,8
9378,0,0,2.559026247399429,0.07182242941689054,26,39,23,5,34,8,18
9379,0,1,0.5137891865863666,0.6256943273175251,16,21,13,3,18,8,8
9380,1,1,1.1807937733232927,0.7650904963028005,17,24,17,7,17,11,6
9381,1,1,2.2802164823119173,0.9072252692815246,4,3,1,0,3,4,0
9382,1,1,3.022602643789124,0.9535848566094283,13,18,9,2,16,9,4
9383,1,1,4.028560803259385,0.9825113672946025,26,39,25,5,34,20,6
9384,0,1,1.5793096617883116,0.8291067270323893,16,23,12,7,16,9,7
9385,0,0,4.208644365827516,0.014648732724803493,25,37,22,7,30,8,17
9386,0,0,0.49066945458909883,0.37973587394906905,23,34,21,8,26,11,12
9387,0,1,1.2902690753713142,0.7841927294935546,13,19,11,5,14,10,3
9388,1,1,0.9030059853417955,0.711566841610245,19,28,18,8,20,9,10
9389,0,0,3.1284775299584533,0.04194774963992365,30,44,31,10,34,15,15
9390,1,1,1.3106026660937005,0.7876139862481515,5,4,1,1,3,4,1
9391,1,1,0.6108324737041082,0.6481306771914539,11,13,6,4,9,5,6
9392,0,0,3.878004684823478,0.02027258935945908,16,19,12,2,17,3,13
9393,0,0,1.4575907297312543,0.18883609342600427,24,33,18,5,28,9,15
9394,1,1,1.4815852781514933,0.8148119082059686,22,30,19,6,24,11,11
9395,1,1,4.606172329276058,0.9901088290485609,16,24,15,2,22,14,2
9396,1,1,2.8840547812202977,0.9470525555558078,13,18,11,4,14,11,2
9397,1,1,0.8879641299405896,0.708469861851708,18,24,14,9,15,8,10
9398,0,0,5.902868500690498,0.0027241566782499893,25,35,20,6,29,6,19
9399,1,1,4.813726919305056,0.9919478142206147,19,30,17,6,24,12,7
9400,0,0,0.9152046685265027,0.2859359828687521,8,9,7,2,7,3,5
9401,0,0,2.150893475748726,0.10424776069973818,33,52,35,11,41,12,21
9402,0,0,3.0624997157951515,0.04468088240379087,21,31,17,6,25,6,15
9403,1,1,2.949096551968996,0.9502207715921286,12,17,8,2,15,10,2
9404,0,0,5.2251468414779545,0.005350785035478145,32,46,26,7,39,9,23
9405,0,0,0.6250511861269951,0.3486335114791528,7,7,3,1,6,1,6
9406,0,0,3.7433726109875916,0.023126622187755852,18,25,13,3,22,2,16
9407,0,0,0.37892181877243214,0.40638696756496917,21,31,16,7,24,8,13
9408,0,0,0.017587145926421854,0.49560332684488273,23,32,19,11,21,10,13
9409,1,1,2.0875518320646664,0.889687382396362,16,20,14,3,17,10,6
9410,0,0,1.5556442016975156,0.1742725644852423,22,31,19,7,24,7,15
9411,0,1,0.23873750704132346,0.5594025043085135,3,2,0,1,1,2,1
9412,0,0,0.962939898090852,0.27628996457538646,7,8,3,1,7,1,6
9413,1,0,0.7646797202110408,0.31763111170219027,6,6,3,1,5,1,5
9414,0,0,4.516979525041903,0.010803962925859167,8,8,3,1,7,1,7
9415,1,1,2.0321350976443497,0.8841299856582532,7,7,4,1,6,6,1
9416,0,0,3.444153182774835,0.03094370312672634,24,37,22,8,29,7,17
9417,1,1,0.7672338157319991,0.6829222089877209,30,44,27,11,33,13,17
9418,0,0,0.9159982909389073,0.2857739712776307,12,15,8,3,12,4,8
9419,1,0,0.2597033974641521,0.4354366210672628,1,0,0,0,0,0,1
9420,0,0,2.821495625003733,0.056173585700104445,20,25,12,6,19,7,13
9421,0,0,0.8411477816500945,0.3012931029960403,12,16,10,4,12,4,8
9422,1,0,3.201186636846527,0.03912109196441527,15,17,9,2,15,2,13
9423,1,1,1.0657316286804286,0.743784342510615,11,14,7,2,12,8,3
9424,0,0,2.3847195818825795,0.08434535092861906,21,32,18,9,23,8,13
9425,0,0,3.4815487544936268,0.029841808721773888,14,18,11,2,16,1,13
9426,0,0,0.6398149756641263,0.34528836559512466,8,8,3,2,6,2,6
9427,1,1,4.0188628254579575,0.9823439469594505,7,9,4,0,9,7,0
9428,1,0,0.16123293090308866,0.45977886213194563,8,7,3,1,6,2,6
9429,0,0,1.6115993624710272,0.16636668152373923,11,11,6,3,8,3,8
9430,1,1,1.2030977423805977,0.7690753961957901,3,2,1,0,2,3,0
9431,0,1,1.3559367368960609,0.7950985173356303,38,63,42,15,48,21,17
9432,1,1,2.547770903669189,0.9274236191603243,21,30,18,9,21,11,10
9433,1,1,3.689193435643687,0.9756172262854603,14,19,12,2,17,12,2
9434,1,1,0.4737387642313289,0.6162682891319848,27,42,24,13,29,11,16
9435,1,1,1.6247783217668743,0.835453064987696,14,18,10,3,15,9,5
9436,0,0,2.6471402951618463,0.06616548476585749,21,25,13,3,22,4,17
9437,1,1,5.209595909688002,0.9945658106218302,19,28,19,2,26,17,2
9438,0,0,1.940386704246503,0.1256053791537456,19,27,15,8,19,8,11
9439,0,1,1.9049095087969206,0.8704461767628984,28,42,24,11,31,13,15
9440,1,1,4.067137746801652,0.9831620343591332,19,29,19,3,26,16,3
9441,1,1,2.167248727494217,0.8972696400142173,12,14,5,4,10,7,5
9442,0,1,0.7972911751657783,0.6893947392443218,12,15,9,5,10,5,7
9443,0,0,0.6383702840149219,0.34561503177276376,26,37,23,7,30,13,13
9444,1,1,3.8281032486146644,0.9787121950291081,9,13,7,0,13,9,0
9445,0,1,3.7833714765247586,0.9777599935799041,12,17,12,0,17,12,0
9446,0,0,1.7906112816931063,0.14299779491048747,10,10,4,1,9,1,9
9447,0,0,1.9589782780638674,0.12357766385844282,16,18,11,3,15,4,12
9448,0,0,1.7561654597234617,0.14727123962347166,17,23,13,5,18,5,12
9449,0,0,1.300349541199934,0.2141061956233803,6,6,2,1,5,1,5
9450,0,0,5.395625638219371,0.004515895552738902,17,22,14,2,20,3,14
9451,1,1,1.8481105054165718,0.863905102012462,18,24,14,5,19,10,8
9452,0,0,1.6367325659026983,0.16291015336347237,10,11,4,3,8,4,6
9453,1,1,0.22107123845978727,0.5550438146364566,31,47,29,14,33,14,17
9454,0,0,3.4818913320138627,0.02983189226301486,16,23,13,4,19,4,12
9455,0,0,6.37972662188776,0.0016927162827279352,46,72,43,19,53,18,28
9456,0,0,1.0061725750633626,0.26772955170200086,14,20,13,4,16,4,10
9457,0,0,4.093546342522278,0.0164063186440514,19,24,15,2,22,3,16
9458,1,1,0.5344487360655221,0.6305201099666105,7,7,4,2,5,5,2
9459,0,0,2.670179653288078,0.06475608746122052,27,41,25,10,31,9,18
9460,1,1,4.62644806421229,0.9903054356496068,30,44,27,8,36,20,10
9461,0,0,1.2549413954951025,0.22184593182448586,17,22,15,7,15,8,9
9462,0,1,1.0300521542857108,0.7369260069046186,9,10,6,2,8,5,4
9463,0,1,0.011212049826569315,0.5028029830931058,10,11,4,4,7,5,5
9464,0,0,5.750024338165707,0.0031726058711211147,21,29,17,3,26,4,17
9465,1,1,2.5492756261179204,0.9275248354817658,33,51,32,13,38,18,15
9466,1,1,0.528783320122723,0.6291992960251668,13,15,8,4,11,6,7
9467,0,0,1.1895765400423524,0.23333467980255695,17,20,11,5,15,7,10
9468,1,0,4.6148798629326615,0.009806258065389706,24,34,22,7,27,7,17
9469,0,1,0.8926391326941769,0.7094344965138928,17,21,12,5,16,10,7
9470,0,0,1.7966143395844645,0.142263699063233,19,24,14,5,19,5,14
9471,1,1,5.553552629750978,0.9961412763756577,23,34,26,3,31,19,4
9472,1,1,1.7074542366491905,0.846505795407375,9,12,7,1,11,8,1
9473,1,1,3.549550474824614,0.9720652222077845,10,15,9,0,15,10,0
9474,0,1,0.6044387758523329,0.6466711703755315,5,4,2,1,3,3,2
9475,1,1,1.1936292056827567,0.7673895163273305,17,25,16,7,18,9,8
9476,1,1,1.1789429723303622,0.7647576941518595,12,15,10,3,12,7,5
9477,1,1,1.1202072407309802,0.7540271554531357,23,34,21,9,25,10,13
9478,0,0,4.238938240989483,0.014217834982913069,16,20,11,1,19,1,15
9479,1,1,2.677572352848489,0.9356901966464701,11,16,11,1,15,10,1
9480,1,1,1.2605093380386962,0.779113775025718,14,17,9,4,13,7,7
9481,1,1,0.7792626936145186,0.6855211857807776,6,7,3,1,6,5,1
9482,0,0,1.70239308899479,0.15415297229031721,9,11,7,1,10,1,8
9483,0,0,3.7445189799184955,0.023100737824424233,10,10,6,0,10,0,10
9484,0,0,3.5501369346280782,0.02791885722091403,22,32,20,7,25,8,14
9485,0,0,0.7512095267052445,0.3205578081473438,16,22,13,6,16,6,10
9486,1,1,1.8647004509117313,0.8658438837336122,17,22,16,5,17,10,7
9487,1,0,2.268942114044748,0.09372803372632776,13,16,9,1,15,1,12
9488,1,1,3.793040645578696,0.9779692849568504,17,23,12,5,18,11,6
9489,0,0,8.118438699003848,0.000297904781356495,25,33,17,4,29,4,21
9490,0,0,2.0963883109520873,0.10944835416586607,7,8,5,0,8,0,7
9491,1,1,3.9361861127812876,0.9808513013697843,27,41,27,8,33,18,9
9492,1,1,2.4437033341461096,0.9200997667430116,24,35,23,7,28,15,9
9493,1,1,1.7476387345951558,0.8516547298167846,7,8,5,1,7,6,1
9494,1,0,1.4937794759966292,0.18335512630472495,10,9,4,2,7,3,7
9495,0,0,3.905453555060623,0.019734529504776277,18,23,15,4,19,4,14
9496,1,1,3.769404677764671,0.9774542448914776,10,15,8,0,15,10,0
9497,0,0,1.0240804516859392,0.26423334045241087,15,16,7,3,13,6,9
9498,1,1,0.057299487908731295,0.5143209539412053,5,4,2,1,3,3,2
9499,1,1,1.143554220954332,0.7583316004634629,3,2,1,0,2,3,0
9500,0,0,2.034002091588315,0.11567888885108424,21,29,17,8,21,7,14
9501,0,0,2.3578867930791745,0.08644092633127687,11,10,2,2,8,2,9
9502,0,0,2.2448047957647184,0.09579853558269436,9,8,2,1,7,1,8
9503,1,0,1.4625708627244565,0.18807443335006535,21,28,18,5,23,5,16
9504,0,0,0.7069870868504715,0.33026492532617013,7,7,2,3,4,4,3
9505,1,1,1.4786968328648473,0.8143756643148927,20,29,19,6,23,12,8
9506,1,1,1.9151611852245145,0.8715978706537966,5,6,3,0,6,5,0
9507,1,1,2.773175939039204,0.9412089724398014,15,20,12,3,17,10,5
9508,0,0,2.677069219375969,0.06434008557107895,15,17,8,2,15,3,12
9509,0,0,1.0822193128524626,0.25308626210658236,8,9,6,1,8,1,7
9510,0,0,4.9466777623517375,0.007056828088968015,22,30,19,2,28,3,19
9511,0,1,1.508978534397598,0.8189097763608998,8,8,4,1,7,6,2
9512,1,1,1.7875929638277759,0.8566319132435288,24,35,23,7,28,12,12
9513,0,0,1.5209278168655995,0.17932493428862595,20,27,15,4,23,6,14
9514,0,0,1.548832930816201,0.17525489313427056,20,27,16,6,21,5,15
9515,1,1,0.7006124276619814,0.6683235412759404,19,28,20,4,24,13,6
9516,1,1,5.767924941561951,0.9968835049902612,15,22,13,1,21,14,1
9517,0,0,5.813259326492543,0.0029787767520390585,18,24,15,0,24,0,18
9518,1,1,1.3662793560177786,0.7967783624041858,8,10,4,2,8,6,2
9519,0,1,0.515405378079425,0.6260727639177883,21,29,15,9,20,13,8
9520,0,0,2.702959319899334,0.06279895903445909,15,20,11,5,15,5,10
9521,1,1,1.627897113005691,0.8358813606567559,11,13,8,2,11,8,3
9522,0,0,4.306721819716341,0.013298427771442745,11,12,5,0,12,0,11
9523,0,0,3.165384597596007,0.04048934381323899,20,28,15,3,25,2,18
9524,0,1,0.21926226491995515,0.5545970077505054,16,21,11,5,16,8,8
9525,0,0,3.1764648368496466,0.040061061969940526,16,22,12,4,18,4,12
9526,0,0,1.108719422683861,0.2481097048304638,5,4,1,1,3,1,4
9527,0,0,1.0459220327145924,0.26000895102280164,16,23,14,3,20,4,12
9528,0,0,5.003244643922162,0.006671314837298548,26,38,21,10,28,8,18
9529,1,1,3.2219048265303316,0.9616503243608615,23,34,20,6,28,14,9
9530,0,0,2.2247425931698195,0.09755049534829374,5,4,2,0,4,0,5
9531,0,0,3.536055266306773,0.028303576310592216,23,34,20,5,29,5,18
9532,1,1,2.104468771000161,0.8913367615540487,4,3,1,0,3,4,0
9533,0,0,5.604973196480879,0.0036660299395655516,9,10,6,0,10,0,9
9534,1,1,0.9892936235125811,0.7289483771912463,3,2,1,0,2,3,0
9535,1,1,4.006905071133796,0.9821353472141875,9,12,7,0,12,9,0
9536,0,1,0.8611920858368145,0.7029096550549514,16,22,12,8,14,9,7
9537,1,1,1.9690165836412645,0.8775054453449982,21,28,14,8,20,12,9
9538,1,1,1.742191213396509,0.8509651764677207,16,20,10,5,15,7,9
9539,1,1,4.435970656635092,0.9882950638713578,14,19,10,2,17,11,3
9540,0,0,3.133519327449193,0.04174559647906784,25,34,21,11,23,8,17
9541,0,0,3.394120318543531,0.03247972543065536,11,14,9,0,14,0,11
9542,1,1,1.9381686831037255,0.8741508161796654,9,11,7,1,10,8,1
9543,0,1,0.7329227257530093,0.6754463166599478,5,5,2,1,4,4,1
9544,1,1,1.7596058118269438,0.8531602840404543,18,27,18,3,24,13,5
9545,0,0,2.553183560007904,0.0722129018796509,23,33,19,8,25,11,12
9546,0,0,4.523892598430046,0.010730330576676717,10,11,6,0,11,0,10
9547,0,0,1.6422924005881683,0.1621533765603953,12,15,8,5,10,4,8
9548,0,0,4.887729057819294,0.007482118480637734,19,22,12,6,16,6,13
9549,1,0,2.515148495063863,0.07480301395347899,26,41,25,8,33,7,19
9550,0,0,4.119103450407568,0.01599895659050099,40,63,40,14,49,14,26
9551,0,0,3.255163075911586,0.03714180203290662,25,35,22,7,28,9,16
9552,0,0,2.554119182422786,0.07215024194724085,31,46,28,10,36,12,19
9553,1,1,2.052724097225468,0.8862225843293279,6,6,2,1,5,5,1
9554,0,0,2.1901057485720985,0.10064252147545705,3,2,0,1,1,1,2
9555,0,0,3.3553571998742373,0.03372017315531972,28,40,27,5,35,7,21
9556,0,0,0.0008068416708604254,0.4997982895932276,11,13,6,5,8,6,5
9557,0,0,0.9193389100720095,0.28509261507587436,20,25,14,6,19,9,11
9558,0,0,1.6207921669179595,0.16509564966399526,19,27,20,4,23,6,13
9559,1,1,0.8017813404981282,0.6903553981264092,8,9,5,3,6,5,3
9560,1,1,1.6606693799585683,0.8403278388876713,6,7,3,1,6,5,1
9561,0,0,6.165443368016339,0.0020963826834937693,16,23,12,3,20,2,14
9562,1,1,0.8970597040943535,0.7103448963388594,13,18,14,2,16,10,3
9563,1,0,0.6222494514772894,0.3492700218393412,10,10,6,1,9,2,8
9564,0,0,3.5553488661218444,0.027777756047743463,15,19,12,3,16,2,13
9565,0,0,4.0166251949353295,0.017694905130428373,17,22,13,3,19,4,13
9566,0,0,1.2322272495130389,0.2257918427270248,4,3,1,0,3,0,4
9567,1,1,1.0882745719063154,0.7480566730228515,7,7,3,2,5,5,2
9568,1,1,1.152102619932267,0.7598947594806297,7,8,5,1,7,6,1
9569,0,0,0.4664230827914464,0.38546320059268446,17,22,15,7,15,8,9
9570,0,0,3.9503289641687385,0.018884865849247756,19,27,17,9,18,6,13
9571,0,0,1.130725344478603,0.24402726599284819,13,17,10,4,13,5,8
9572,1,1,2.133119459984578,0.8940807855934287,43,67,40,17,50,19,24
9573,1,1,2.0885148610428694,0.8897818622021582,5,6,3,0,6,5,0
9574,1,1,0.574737386891663,0.6398555822866918,2,1,0,0,1,2,0
9575,0,0,2.474048974453134,0.07769758632066914,13,16,7,5,11,6,7
9576,0,0,2.16652871552648,0.10279674739529276,11,14,6,3,11,2,9
9577,0,0,2.0581119812629494,0.11323527339345218,16,20,9,3,17,4,12
9578,0,0,0.9812053432526089,0.27265268269232446,3,2,1,0,2,0,3
9579,0,1,2.117447510501724,0.8925874544667338,11,12,7,2,10,7,4
9580,1,1,1.2030977423805977,0.7690753961957901,3,2,1,0,2,3,0
9581,0,0,3.538558149758663,0.02823482200611127,19,26,14,6,20,6,13
9582,1,1,1.9491155431173366,0.875350168764885,6,6,2,1,5,5,1
9583,1,0,0.23126743987891185,0.44243946196340556,7,6,3,2,4,3,4
9584,0,0,3.4699286624667893,0.03018006941076501,15,17,11,2,15,3,12
9585,1,1,0.574737386891663,0.6398555822866918,2,1,0,0,1,2,0
9586,0,0,0.16853920408271716,0.45796465469235914,10,10,4,1,9,2,8
9587,1,0,1.119125104891101,0.24617360366962227,13,16,10,1,15,2,11
9588,0,0,2.2358576537235613,0.09657635530532416,22,31,17,8,23,9,13
9589,1,1,3.0010638600710893,0.9526221653329674,9,12,8,0,12,9,0
9590,0,0,6.380390106489841,0.0016915954632190644,40,58,33,9,49,10,30
9591,1,1,3.6082577495803996,0.9736159624958071,14,16,9,4,12,10,4
9592,0,0,6.093553631616109,0.0022522885184923513,18,22,13,2,20,3,15
9593,1,1,0.35845812118193154,0.5886671375003292,7,6,2,2,4,3,4
9594,1,1,1.3335018883359604,0.7914192982227894,11,12,6,2,10,6,5
9595,0,1,0.5941495023328187,0.64431666679219,29,43,22,15,28,10,19
9596,0,0,1.8967527233883539,0.13047644363109567,16,21,12,6,15,6,10
9597,1,1,2.4724459190996004,0.9221874598602582,10,14,9,1,13,9,1
9598,1,1,1.1108514792546498,0.7522878194114063,7,8,4,1,7,5,2
9599,0,0,2.6522668772462206,0.0658494291218632,32,49,32,16,33,17,15
9600,0,1,0.38957625286510655,0.5961806866402436,19,26,15,7,19,11,8
9601,0,1,0.7925200021667513,0.6883721676305274,6,6,4,1,5,5,1
9602,0,0,2.9265686555579946,0.050855698826066664,27,39,25,7,32,7,20
9603,0,0,3.253292976245807,0.037208738997340896,9,11,5,0,11,0,9
9604,1,1,3.5608015609553716,0.9723691217024167,13,18,12,1,17,12,1
9605,1,0,0.2982357761165321,0.42598881891719087,8,7,3,1,6,3,5
9606,0,0,3.302882477822745,0.03547243560549762,15,19,9,3,16,3,12
9607,0,0,2.2386277346256884,0.09633493745414579,5,5,2,0,5,0,5
9608,0,0,2.2710821635421388,0.09354640929175762,14,17,11,3,14,4,10
9609,0,1,0.23993427416473612,0.5596974521047327,24,34,21,10,24,9,15
9610,0,0,4.033718560155642,0.017400228307045018,12,14,8,2,12,1,11
9611,1,1,2.045427444550442,0.8854847714244023,4,3,1,0,3,4,0
9612,1,1,5.154053412939655,0.9942572250290003,25,40,27,8,32,19,6
9613,0,1,0.8021871956541009,0.6904421489784704,18,24,15,9,15,10,8
9614,0,0,0.6979284160305061,0.33227168458333334,24,36,23,5,31,6,18
9615,1,1,0.8887583367829444,0.7086338704212298,16,21,12,6,15,8,8
9616,1,1,2.832916878480861,0.9444288871021503,10,13,9,1,12,9,1
9617,1,1,4.046352929908357,0.9828144753509086,9,13,8,0,13,9,0
9618,1,1,0.8728625542505324,0.7053409866914508,8,7,3,3,4,3,5
9619,0,1,1.0157299346006559,0.7341400083767686,32,48,31,16,32,15,17
9620,1,1,4.254090350783542,0.9859929765251287,14,19,10,3,16,11,3
9621,0,0,5.898813278837409,0.0027351958901692397,14,16,9,0,16,0,14
9622,1,1,8.270266017489304,0.9997440483508676,15,24,17,0,24,15,0
9623,0,0,1.7823338084699576,0.14401519518535655,11,14,6,1,13,1,10
9624,0,0,3.533038753114753,0.028386656065423455,23,34,18,5,29,5,18
9625,0,0,0.9823490301016777,0.2724259334792778,26,38,23,9,29,8,18
9626,1,1,0.43095411768140335,0.6061014798942036,15,20,15,4,16,9,6
9627,0,0,3.1586961213859306,0.040749990933372504,22,28,17,5,23,7,15
9628,0,0,4.638681868827496,0.009577814490176029,8,8,3,0,8,0,8
9629,1,1,1.819907143013139,0.8605549845634111,4,3,1,0,3,4,0
9630,1,1,1.3680693954184853,0.7970680562687502,13,16,10,4,12,9,4
9631,1,1,2.0853945154756195,0.8894754772072475,8,10,5,1,9,6,2
9632,0,0,3.380516827723728,0.03290994181399409,35,53,34,13,40,17,18
9633,0,1,0.2811902792832568,0.5698380125747493,8,9,5,5,4,5,3
9634,0,0,1.9239821822872836,0.12741815896227293,23,28,14,6,22,7,16
9635,0,0,1.992853884399952,0.11995526240267695,18,24,12,6,18,6,12
9636,1,1,1.8065565833382902,0.8589451910166233,25,38,24,7,31,13,12
9637,1,1,1.8037227327453844,0.8586014969805285,6,6,4,1,5,5,1
9638,0,0,3.965112234444199,0.01861289736826055,7,6,3,0,6,0,7
9639,0,0,0.9683333947901827,0.2752128165826059,10,11,5,2,9,3,7
9640,1,1,0.1941864819509287,0.5483946423066415,16,20,12,8,12,10,6
9641,1,1,1.1552679569852446,0.7604718149482323,10,12,6,3,9,7,3
9642,1,1,2.347431081729807,0.9127298195369904,6,7,3,1,6,5,1
9643,1,1,1.5203835982887588,0.8205949604449727,12,17,10,3,14,10,2
9644,1,1,4.764917013806706,0.9915484421074755,21,32,23,2,30,18,3
9645,0,0,0.7201978519981214,0.3273494160613446,28,40,24,4,36,8,20
9646,1,1,2.2064945102067446,0.9008312059168936,5,4,1,1,3,4,1
9647,0,1,0.4049275113791495,0.5998709698515254,18,24,14,8,16,9,9
9648,1,1,1.4669419730058466,0.8125921359566051,4,3,2,0,3,4,0
9649,1,1,1.4669419730058466,0.8125921359566051,4,3,2,0,3,4,0
9650,1,1,0.2315640268601511,0.5576337008757586,34,51,31,18,33,15,19
9651,0,0,4.4072614436052175,0.012041740696855152,13,15,9,3,12,2,11
9652,1,1,5.696759289591927,0.9966544042324788,26,42,29,8,34,21,5
9653,1,1,1.3355399899299132,0.7917555375976331,6,6,3,1,5,4,2
9654,1,1,2.4817946604952237,0.9228556622872068,11,16,13,0,16,11,0
9655,0,1,1.9299483373504083,0.8732437014939096,18,26,16,6,20,11,7
9656,1,1,5.707313289829864,0.9966894116967171,17,26,15,2,24,15,2
9657,1,1,1.4919569062323437,0.816371811834951,14,17,10,4,13,7,7
9658,0,0,0.8942905859395429,0.290225195332093,16,21,13,5,16,6,10
9659,1,1,2.3933054667121274,0.9163153852989736,31,47,30,12,35,18,13
9660,0,0,5.020115136780807,0.0065604426985483855,12,14,9,2,12,3,9
9661,0,0,6.699292944522005,0.001230267111893224,26,37,25,8,29,9,17
9662,1,0,3.126293155225564,0.04203562347654155,8,9,6,0,9,0,8
9663,1,0,1.5644753033494667,0.17300540774666862,19,25,15,6,19,8,11
9664,1,0,0.8369975785258927,0.3021675052102283,2,1,0,0,1,0,2
9665,0,0,0.9770119646974715,0.2734850773476184,4,3,0,1,2,1,3
9666,1,1,3.5658917305987705,0.9725055530563248,11,12,5,3,9,8,3
9667,1,1,1.7529172178746386,0.8523203707465464,5,4,1,1,3,4,1
9668,1,1,0.383873806722534,0.5948070772080283,19,25,16,7,18,9,10
9669,0,1,1.0867143618065938,0.7477625097345713,17,24,11,8,16,8,9
9670,1,0,0.8899161814120448,0.2911271249509,10,12,7,3,9,4,6
9671,0,0,7.195638416125835,0.0007492873640971842,26,34,21,2,32,3,23
9672,1,1,5.011776424058336,0.9933849863234165,20,31,17,3,28,17,3
9673,1,1,3.028309189608505,0.9538367800033973,13,18,10,3,15,9,4
9674,1,1,0.7737813684756012,0.6843383114440782,22,31,18,6,25,11,11
9675,0,0,5.416087261682279,0.004424836648068142,20,26,13,5,21,3,17
9676,0,0,3.5136386888066253,0.0289266500499733,18,20,10,4,16,5,13
9677,0,0,3.5688426507646027,0.02741565367863097,26,39,25,7,32,9,17
9678,1,0,1.38671690789513,0.19993240108607846,12,12,5,4,8,4,8
9679,1,0,0.7274571862024353,0.32575297824271643,24,35,22,5,30,10,14
9680,0,1,1.9437028419115407,0.8747583758772588,18,26,18,3,23,14,4
9681,1,1,0.2652153879162802,0.5659179147281538,7,7,3,2,5,4,3
9682,0,1,0.5421210281139686,0.6323056848415807,8,9,4,3,6,4,4
9683,0,0,5.676339441039211,0.0034143789488366716,24,35,21,4,31,4,20
9684,0,0,3.3874336997312686,0.03269050919386551,31,43,24,7,36,9,22
9685,0,0,0.8753018237498549,0.2941523015930314,16,21,11,4,17,5,11
9686,0,0,5.268984277217939,0.0051224629791294385,28,43,27,9,34,7,21
9687,1,1,1.0783130151068776,0.7461746043761766,9,11,5,3,8,5,4
9688,0,0,3.0283162128089143,0.046162910750783936,23,30,15,7,23,6,17
9689,1,1,1.0708500969652581,0.7447585471461284,11,12,4,5,7,6,5
9690,1,0,4.406035077508709,0.012056339186121257,29,44,27,12,32,12,17
9691,1,1,2.0545913195342194,0.886410724570032,21,32,21,4,28,14,7
9692,1,1,5.66083390091904,0.9965324516950597,31,46,29,8,38,20,11
9693,1,1,3.938662760889524,0.9808977624846087,16,25,19,1,24,15,1
9694,1,1,3.536805034122776,0.9717170368755974,19,28,18,3,25,14,5
9695,1,1,0.7664694579758033,0.6827566722308145,11,14,7,5,9,7,4
9696,1,1,4.0006397182625335,0.9820250857101989,15,23,16,2,21,14,1
9697,0,0,4.005341578268109,0.017892105749648057,28,44,27,8,36,10,18
9698,0,0,6.944993625546473,0.0009625191381541498,22,26,16,1,25,2,20
9699,0,0,5.50214166152229,0.004061465551510435,18,21,11,3,18,4,14
9700,0,1,0.8714828826797918,0.7050541613282739,20,27,14,8,19,10,10
9701,1,1,1.3520524554886784,0.7944649769893688,4,3,1,1,2,3,1
9702,0,0,1.8886221854716796,0.13140164680071753,22,28,17,5,23,8,14
9703,1,1,1.1537181635979148,0.7601893992632094,10,12,6,5,7,6,4
9704,1,1,5.560712031288993,0.9961686984036036,36,57,36,12,45,23,13
9705,1,1,3.6974146947072057,0.9758120328602302,9,13,7,0,13,9,0
9706,1,1,3.5027249940454,0.9707652042016475,21,30,18,4,26,15,6
9707,1,0,1.8558987474671031,0.1351818028995514,10,12,7,1,11,1,9
9708,0,1,0.5833884202281572,0.6418467085361386,10,11,5,4,7,4,6
9709,0,0,0.27080895659421456,0.4327085081592228,10,11,6,2,9,5,5
9710,0,1,1.6751929861585282,0.8422669535288712,13,18,14,1,17,11,2
9711,0,0,2.580001676529485,0.0704366211214611,18,24,15,3,21,2,16
9712,0,0,1.1605159366126174,0.23857354942600906,22,31,18,6,25,9,13
9713,1,0,1.0904507962217167,0.2515334000302565,16,21,12,6,15,6,10
9714,0,0,4.070292075265824,0.01678582697783615,7,6,1,1,5,1,6
9715,0,0,2.7455523883566464,0.06033832658332616,29,43,24,11,32,10,19
9716,0,0,3.4844363562980423,0.029758322368899415,15,21,14,4,17,4,11
9717,1,1,6.485940711305995,0.998477595484364,26,39,23,6,33,19,7
9718,1,1,6.756847138108061,0.9988384609108633,29,45,30,7,38,19,10
9719,0,0,1.7138836526620516,0.15266066641688203,7,7,2,1,6,1,6
9720,1,0,1.4107097862302462,0.19612212858164835,21,29,19,7,22,9,12
9721,1,1,0.20435794000914753,0.5509124237751435,7,6,3,4,2,4,3
9722,0,0,0.4969844514868931,0.37824959514960854,11,15,8,5,10,4,7
9723,0,0,4.530232545387871,0.010663239169934835,13,17,10,0,17,0,13
9724,1,1,2.061124295307161,0.8870668500166025,11,12,7,2,10,8,3
9725,1,1,0.7115859591859197,0.6707515040600824,6,7,3,1,6,5,1
9726,1,1,1.5538432714026398,0.8254681266521359,13,17,9,4,13,9,4
9727,1,0,0.49326788819345513,0.3791240394300449,35,51,29,10,41,12,23
9728,0,0,2.341239167424411,0.0877646538902801,12,15,10,0,15,0,12
9729,1,1,3.039041005743113,0.9543070303678703,10,12,5,2,10,7,3
9730,0,0,3.3493754785388408,0.03391562086919331,16,18,12,2,16,3,13
9731,1,1,0.4844065357805465,0.6187878727293703,20,29,17,8,21,11,9
9732,0,0,2.434780882576568,0.080558641422381,10,12,6,0,12,0,10
9733,1,1,5.583241754276223,0.9962537317110248,39,64,41,15,49,25,14
9734,1,1,3.940124397225384,0.9809251304228362,11,15,10,1,14,10,1
9735,0,1,0.9336883206869413,0.7178229663259129,7,8,5,2,6,5,2
9736,1,0,3.860544276215516,0.020622301599416692,14,15,8,3,12,6,8
9737,0,0,0.12232558732976972,0.4694566800453519,7,7,3,1,6,2,5
9738,0,0,2.7343127945077557,0.06097874267505543,11,13,8,3,10,3,8
9739,1,1,0.565270126845216,0.6376710668526973,7,7,2,2,5,5,2
9740,1,1,3.808276127248485,0.9782951595818231,19,30,20,5,25,16,3
9741,0,0,5.6213770351379715,0.0036065986491372604,33,51,31,9,42,9,24
9742,0,0,3.1278118936555663,0.04197450847983142,19,25,14,5,20,4,15
9743,0,0,4.022953434893157,0.017585244025110636,27,40,24,12,28,12,15
9744,0,0,4.383614817965494,0.01232632886588092,22,29,16,4,25,4,18
9745,0,0,0.2597033974641521,0.4354366210672628,1,0,0,0,0,0,1
9746,0,0,3.256829146899503,0.037082265447135554,16,22,14,0,22,0,16
9747,0,0,3.608111184503228,0.026387802717537934,35,56,33,16,40,15,20
9748,0,0,2.140825748830501,0.10519163944902821,9,11,4,2,9,1,8
9749,0,0,3.293903872121584,0.03578091543353357,26,41,25,9,32,7,19
9750,1,1,0.264691787436492,0.5657892853054185,21,27,14,6,21,10,11
9751,0,0,1.313464280896608,0.21190772197294183,11,13,6,1,12,1,10
9752,0,0,0.7912177347323756,0.3119072579813287,8,8,5,2,6,3,5
9753,1,1,1.2218373014895394,0.7723867187299912,8,9,5,2,7,6,2
9754,1,1,0.3776086365640301,0.5932962059214266,6,5,2,2,3,3,3
9755,1,1,1.0282506891232979,0.7365766149074016,10,12,6,3,9,7,3
9756,1,1,4.844582110440452,0.9921905614192489,12,17,11,2,15,9,3
9757,1,1,3.457640636977121,0.9694581856509296,8,11,7,0,11,8,0
9758,0,0,6.966566475082611,0.0009419965784449591,21,25,13,3,22,4,17
9759,1,1,3.740045216038797,0.9767980866339686,13,16,8,3,13,7,6
9760,1,1,2.411067374267562,0.9176673622005637,18,26,17,4,22,13,5
9761,1,1,1.3965687272485794,0.801638832773613,20,27,14,7,20,10,10
9762,0,0,3.686908442477301,0.02443718882620216,6,5,1,0,5,0,6
9763,1,1,4.648314150566886,0.9905131278005657,24,38,24,5,33,18,6
9764,1,1,1.3536351935998332,0.7947233024434175,11,13,7,2,11,7,4
9765,0,0,4.974749473885316,0.006862826077325135,8,8,3,0,8,0,8
9766,0,0,2.065903164625433,0.11245529124670683,17,24,13,6,18,6,11
9767,0,0,9.093837200971393,0.00011234348485134049,31,45,28,3,42,6,25
9768,1,0,0.06556599900448057,0.4836143698441103,12,16,9,4,12,5,7
9769,1,1,0.5934867990408605,0.6441647787688016,5,5,2,1,4,4,1
9770,0,0,4.540727679651315,0.010553087103033265,18,22,13,3,19,4,14
9771,0,0,2.6801713054967937,0.06415359081365934,15,19,10,4,15,4,11
9772,0,0,3.1249992333132486,0.042087758825641974,18,23,12,4,19,4,14
9773,0,0,4.96573189029219,0.006924561585205047,34,51,30,18,33,13,21
9774,1,1,0.3017073203074587,0.5748598323105247,23,33,18,9,24,13,10
9775,0,0,2.56932622915253,0.07113881270698252,10,11,6,3,8,3,7
9776,0,0,0.5582753783829171,0.3639465977125753,15,17,8,6,11,6,9
9777,1,1,3.836051060901436,0.9788771562929387,19,27,17,4,23,12,7
9778,0,1,0.05254718185675289,0.5131337735150517,12,17,10,6,11,6,6
9779,1,1,3.644261554304149,0.9745252224554447,20,32,21,3,29,17,3
9780,1,1,1.868702407807221,0.866308063832484,12,13,6,3,10,7,5
9781,0,0,2.1930099728361823,0.1003799543855648,17,24,15,7,17,6,11
9782,0,0,5.14759228926339,0.005779784726247517,27,39,24,6,33,6,21
9783,0,0,3.333923338686195,0.03442557823000947,16,19,9,4,15,6,10
9784,0,0,6.754105466618921,0.001164724303018061,28,43,28,3,40,3,25
9785,1,1,1.6994594895754618,0.845464127963528,6,6,3,0,6,6,0
9786,0,0,0.5987796520709077,0.3546229397499544,10,11,6,2,9,3,7
9787,1,1,2.565473216923148,0.9286061665521855,36,55,33,16,39,17,19
9788,1,1,3.9818588633769654,0.9816905508427806,18,26,17,5,21,15,3
9789,0,0,1.4602421367195455,0.18843029382751464,12,12,4,2,10,3,9
9790,1,1,2.432842434693944,0.9192976629958087,6,6,2,1,5,5,1
9791,0,0,2.982297218898474,0.04823206369543631,20,29,19,5,24,5,15
9792,1,1,2.9326059134524227,0.9494349270265641,18,22,12,6,16,10,8
9793,0,0,0.7988310370967335,0.3102756268860555,16,20,13,4,16,6,10
9794,1,0,1.0496188437826293,0.2592982999903386,11,12,5,1,11,2,9
9795,1,1,0.9585435308874635,0.7228301009996425,15,21,12,8,13,8,7
9796,0,1,0.2243644554887485,0.555856992893091,13,17,11,4,13,6,7
9797,1,1,0.49255880117473616,0.6207090349837163,13,15,7,5,10,5,8
9798,0,0,0.07705553439590485,0.4807456424429005,4,3,0,1,2,1,3
9799,0,0,0.5794780867920994,0.3590526947271756,9,10,5,2,8,3,6
9800,0,0,0.9606052689968814,0.2767570263059641,12,15,8,3,12,4,8
9801,1,0,0.6785098490565302,0.33659396995447277,6,5,2,1,4,2,4
9802,0,0,2.3110195532240727,0.0902144291018282,13,16,8,2,14,3,10
9803,0,0,3.044404907986619,0.04545964515770817,25,35,22,9,26,10,15
9804,0,0,0.14600089707888086,0.4635644751805431,8,7,3,2,5,3,5
9805,0,0,5.530752408862088,0.003947362743192073,17,20,12,3,17,2,15
9806,0,0,3.191307397056928,0.03949415440181958,18,26,16,9,17,7,11
9807,1,1,5.745848648950293,0.9968141609084891,30,49,34,5,44,23,7
9808,1,1,0.967970995710469,0.7247148895227871,15,20,13,4,16,7,8
9809,0,0,0.4693798766548456,0.3847630289861006,10,10,5,3,7,4,6
9810,0,0,7.000392678596406,0.0009106938400648135,23,35,22,0,35,0,23
9811,1,1,0.7988931469934333,0.68973766476478,17,22,13,8,14,9,8
9812,1,0,0.1361955706349743,0.46600364163457086,2,1,0,1,0,1,1
9813,1,1,3.789786771442956,0.977899069918498,10,13,7,1,12,9,1
9814,1,0,0.16113294103143905,0.4598036979421116,8,8,4,1,7,2,6
9815,1,1,0.25893820093551034,0.5643752601840872,9,10,4,2,8,6,3
9816,0,0,4.566677396502142,0.010285540564050288,27,40,25,9,31,8,19
9817,0,1,2.649443924002721,0.9339767087921325,26,35,21,9,26,12,14
9818,1,1,1.6061275961918389,0.832873059725155,19,26,14,5,21,13,6
9819,0,0,1.1961085416219759,0.2321682085820842,12,14,7,4,10,5,7
9820,1,0,0.625344925584848,0.3485668096846629,26,35,21,7,28,10,16
9821,0,0,3.6550182672605107,0.0252090921058582,18,24,12,5,19,5,13
9822,1,1,3.330846238621063,0.9654719908915405,15,22,15,3,19,13,2
9823,0,1,0.8915920256107108,0.709218601474199,15,19,11,3,16,10,5
9824,1,0,7.058883956601621,0.0008589985497327035,38,54,34,10,44,12,26
9825,1,1,5.315483514799807,0.9951091363612733,14,23,15,2,21,13,1
9826,0,0,0.7949871466317306,0.31109883670333605,3,2,1,0,2,0,3
9827,1,1,1.3589784870665762,0.7955936249394978,15,18,9,4,14,9,6
9828,1,1,2.8613500884595218,0.9459024265349396,16,24,14,4,20,12,4
9829,1,0,1.67247875992339,0.15809397554958937,13,17,10,3,14,4,9
9830,1,1,3.228800128509382,0.9619038081523759,15,21,13,2,19,10,5
9831,0,0,4.123432828745888,0.015930941856624692,15,18,11,2,16,5,10
9832,1,1,2.344917934921436,0.9125294293503143,8,8,4,1,7,7,1
9833,0,0,2.0478900091353185,0.11426575779898307,17,21,12,4,17,5,12
9834,1,1,1.3330824979742377,0.7913500589845027,6,6,4,1,5,5,1
9835,0,0,1.4326131978459218,0.19269184425645114,24,33,19,7,26,9,15
9836,0,0,2.788606283017094,0.05794298529359754,9,9,4,0,9,0,9
9837,0,0,1.733991783861535,0.15007769868609322,18,25,16,7,18,6,12
9838,1,1,3.7271981509545817,0.9765051356586897,17,26,17,4,22,14,3
9839,1,1,0.6226609977168942,0.650823508781694,9,10,5,3,7,6,3
9840,0,0,5.010427193692244,0.0066238857184217625,17,22,13,5,17,4,13
9841,1,1,4.5173519536451625,0.9892000165819304,14,18,11,2,16,12,2
9842,0,1,0.2279941091269979,0.5567528991490394,13,14,7,4,10,6,7
9843,1,0,0.5222292535131827,0.37233110758307275,9,11,7,2,9,3,6
9844,0,0,3.0931415523091417,0.04339104735610144,27,36,22,7,29,7,20
9845,0,0,1.0859066066319976,0.25238987447750794,11,14,8,2,12,3,8
9846,0,0,8.645281368478422,0.00017592420516421292,21,26,17,2,24,3,18
9847,0,0,0.15442743400439163,0.4614696831263918,26,36,22,8,28,13,13
9848,0,1,0.32485316429622557,0.5805065480043441,11,15,7,4,11,6,5
9849,1,1,0.42637769605571574,0.6050083647934958,25,37,22,10,27,12,13
9850,1,0,0.2746713845095112,0.4317606383514072,15,17,12,2,15,5,10
9851,0,1,0.6305959754162891,0.6526245855249551,6,6,3,1,5,4,2
9852,1,1,2.6555387629465197,0.9343515496374354,7,9,5,0,9,7,0
9853,0,0,2.2116678561610374,0.0987075940049632,10,11,6,2,9,2,8
9854,1,0,1.86215475347828,0.13445209552612924,30,46,29,10,36,10,20
9855,0,0,0.8732597420535764,0.29457647048324254,10,10,2,2,8,2,8
9856,1,1,2.693854083689047,0.9366630119351566,41,65,45,15,50,23,18
9857,1,1,1.7087040539182972,0.8466681185134312,10,12,5,3,9,6,4
9858,0,0,1.266886862176106,0.21979063568772217,33,48,27,11,37,13,20
9859,0,0,0.8207781511145251,0.305598504979287,10,10,4,1,9,2,8
9860,0,0,0.038997123647690035,0.4902519544392955,20,28,16,7,21,7,13
9861,0,1,0.8147329402072601,0.6931171470976136,9,10,7,2,8,5,4
9862,1,1,3.2771661769426634,0.9636371150532735,9,13,9,0,13,9,0
9863,0,0,2.788667059185441,0.05793966787936933,20,29,20,4,25,4,16
9864,1,1,0.22996072239953746,0.5572381639017931,5,4,1,1,3,4,1
9865,1,1,2.1195609830012585,0.8927899157719764,28,44,31,9,35,16,12
9866,1,1,1.916031798695131,0.8716952738621173,11,14,9,2,12,5,6
9867,0,1,0.32708058460606515,0.581048869018767,5,4,1,2,2,3,2
9868,0,0,1.8785899471247771,0.13255091908924843,7,6,3,0,6,0,7
9869,1,1,1.1787564835265298,0.7647241425323239,14,17,12,3,14,6,8
9870,0,0,0.4606832891829762,0.3868237411963128,13,14,9,2,12,3,10
9871,0,0,1.305464658164303,0.2132467605298458,16,22,14,5,17,5,11
9872,1,1,2.9158254104243895,0.9486232218773704,18,26,19,2,24,13,5
9873,0,1,0.7072140246513461,0.6697852691133392,9,10,4,2,8,6,3
9874,0,0,9.431862935565647,8.012336391094443e-05,27,38,21,4,34,3,24
9875,1,1,4.09274682780149,0.9835807744762588,12,18,11,1,17,11,1
9876,0,0,4.7716900238483975,0.00839498774736025,15,17,10,3,14,3,12
9877,1,1,0.06992087267950542,0.5174731000218942,3,2,0,1,1,2,1
9878,1,1,2.239671917829636,0.9037559251037764,12,15,10,3,12,8,4
9879,0,0,0.8112903901225157,0.30761558957131996,15,16,8,4,12,6,9
9880,0,0,2.7920905736373585,0.05775308589995887,8,9,5,0,9,0,8
9881,0,0,4.572220843973979,0.01022926258682122,20,23,13,2,21,3,17
9882,1,1,4.312280319323777,0.9867743115523624,23,31,18,7,24,13,10
9883,1,1,0.883376866899491,0.7075215018309762,23,35,20,9,26,10,13
9884,1,1,3.3987893180109916,0.9676666770695672,12,15,10,2,13,10,2
9885,1,0,0.5573097588833669,0.36417015781343465,39,59,37,14,45,17,22
9886,0,0,2.254498025438615,0.09496218003187973,21,27,13,6,21,7,14
9887,0,1,2.5009284008161154,0.9242068787033277,8,10,6,1,9,7,1
9888,0,0,1.5730203962289693,0.1717862365680053,17,21,12,4,17,5,12
9889,1,1,1.3263295481339439,0.7902328508746316,38,58,35,15,43,18,20
9890,0,1,0.20070626554238968,0.5500088035792008,16,21,14,5,16,6,10
9891,1,1,2.0689652257604436,0.8878499678303332,9,11,6,2,9,7,2
9892,0,0,3.144238388124191,0.0413189029772848,26,38,24,7,31,6,20
9893,1,1,3.789770231562168,0.9778987124478467,12,16,13,1,15,11,1
9894,1,1,2.3318211896376835,0.9114783905624522,13,17,8,3,14,10,3
9895,0,0,2.398519879654345,0.08328563272538336,9,10,7,0,10,0,9
9896,0,0,1.3001033227001377,0.21414762842975743,13,16,9,5,11,5,8
9897,0,0,5.101792412003811,0.006049015202626795,18,25,15,4,21,4,14
9898,1,1,0.6082704717867533,0.6475461724389344,5,4,2,1,3,3,2
9899,1,1,2.3291262622050004,0.9112607076453858,13,16,10,3,13,10,3
9900,1,1,3.3979554949805135,0.9676405783396298,19,28,18,4,24,14,5
9901,1,1,3.381256476644043,0.9671135907704456,7,8,5,0,8,7,0
9902,0,0,4.292347468735116,0.013488367513522115,30,47,28,11,36,8,22
9903,0,0,1.001734792969227,0.2686004771197311,12,14,7,2,12,3,9
9904,1,1,2.5070075616494947,0.924631618311393,19,27,17,7,20,12,7
9905,0,0,3.160700414846639,0.04067171632187494,23,29,19,4,25,9,14
9906,1,1,5.229591162364687,0.994672816401535,15,23,13,1,22,14,1
9907,1,1,0.8429054866686698,0.6990767919884697,29,43,25,9,34,14,15
9908,0,0,3.3130364816342857,0.035126659013058226,23,29,16,4,25,6,17
9909,1,0,0.4791361854895979,0.3824561231849255,10,12,6,3,9,4,6
9910,0,0,0.40316053728711787,0.40055322424664686,15,19,11,6,13,5,10
9911,1,0,1.108213544090328,0.24820408915420222,22,29,15,8,21,8,14
9912,1,1,4.364047679083051,0.9874331658255957,19,31,22,4,27,16,3
9913,1,1,1.1076526396552195,0.7516912319590616,19,25,17,7,18,10,9
9914,1,1,3.270355824737082,0.963397721082949,19,26,16,5,21,14,5
9915,1,1,0.6396968305439685,0.6546849255216205,21,29,16,9,20,10,11
9916,0,0,0.5262910784984889,0.37138234972848405,9,10,6,3,7,2,7
9917,1,1,1.143554220954332,0.7583316004634629,3,2,1,0,2,3,0
9918,1,1,2.544957137080967,0.9272339992798654,11,15,7,4,11,9,2
9919,0,0,2.56695979210307,0.07129534111186941,24,37,22,7,30,9,15
9920,1,1,2.675196481984736,0.9355470827921955,28,41,28,5,36,18,10
9921,0,1,1.2602578155115407,0.7790704860916952,8,10,6,1,9,7,1
9922,1,1,2.0579708180565595,0.8867505512050652,25,35,21,9,26,15,10
9923,0,0,1.5575252271997873,0.17400204766066818,11,11,6,2,9,3,8
9924,0,0,3.817953438394653,0.021500303225658657,16,19,9,1,18,1,15
9925,1,1,1.2080940171564327,0.7699615336136143,5,5,2,1,4,4,1
9926,1,1,0.18873850739059772,0.5470450555642745,4,3,1,1,2,3,1
9927,1,0,1.834683871898542,0.13768123564732093,13,14,7,2,12,3,10
9928,0,0,3.583070398188803,0.02703882459877205,26,40,26,7,33,6,20
9929,1,0,0.2597033974641521,0.4354366210672628,1,0,0,0,0,0,1
9930,1,1,4.161673550873564,0.9846575973073832,18,29,21,3,26,16,2
9931,1,1,0.8352289935300174,0.6974594364529657,7,7,5,1,6,3,4
9932,1,1,2.101462063759034,0.8910452024644215,7,7,2,2,5,5,2
9933,0,1,0.48012659660530366,0.6177777682684433,18,25,15,7,18,9,9
9934,0,0,1.8906313738131844,0.13117249736037262,20,25,13,4,21,6,14
9935,0,0,4.326536398129712,0.01304092096944176,11,11,4,1,10,1,10
9936,0,0,2.082359647555408,0.11082323002060135,15,20,11,2,18,1,14
9937,0,0,2.49866765569228,0.07595163510685143,27,38,23,8,30,8,19
9938,1,1,0.4227894866752191,0.6041505564651741,28,39,25,9,30,15,13
9939,0,0,3.0932815146502612,0.043385238133510584,10,12,7,3,9,1,9
9940,0,1,0.9052254579829775,0.7120221510171032,14,17,9,5,12,8,6
9941,0,0,3.1376578138342643,0.041580358621275404,18,26,16,3,23,2,16
9942,0,1,0.6614863716338912,0.6595942021391128,31,47,28,16,31,15,16
9943,0,0,1.5364267157832465,0.17705532568578952,14,20,14,6,14,6,8
9944,0,0,5.7914387659831235,0.003044289620252494,18,19,10,2,17,2,16
9945,0,0,2.3743477171173,0.08514984367025735,10,10,4,2,8,3,7
9946,1,1,0.139955413449405,0.5349318529438842,9,11,6,2,9,5,4
9947,1,1,4.485081512719979,0.9888497613892241,14,20,11,2,18,12,2
9948,1,1,3.1296274622039575,0.958098439659145,14,18,8,5,13,8,6
9949,0,0,2.3220260986051335,0.08931512347786208,25,35,19,5,30,6,19
9950,0,1,0.09220556442264893,0.5230350733252769,23,33,19,10,23,9,14
9951,0,0,0.022047187818660996,0.4944884262983116,9,10,4,3,7,4,5
9952,0,0,1.8219631849418212,0.13919847304586652,13,15,8,4,11,4,9
9953,1,1,4.510243006639886,0.9891238045357433,12,16,8,2,14,10,2
9954,1,1,0.9593960286943828,0.7230008637125085,42,67,42,19,48,21,21
9955,0,0,3.8532605179107238,0.02076992663358279,16,22,11,5,17,5,11
9956,1,1,9.571157230638782,0.999930294193656,26,41,28,4,37,23,3
9957,1,1,0.6407927914948115,0.6549326502133543,9,9,5,2,7,5,4
9958,0,0,0.19299972764986306,0.4518992836873379,24,34,24,6,28,8,16
9959,1,1,6.397968116959743,0.9983378306115231,26,38,25,8,30,19,7
9960,0,0,6.001416938646189,0.0024691307269263385,13,14,7,1,13,2,11
9961,1,1,0.11031797229254914,0.527551556742324,14,17,9,6,11,6,8
9962,1,1,1.5418742524721565,0.8237370212135686,15,18,10,5,13,9,6
9963,0,0,1.3595362779803988,0.20431567959902308,21,30,16,8,22,8,13
9964,1,1,1.9148101765915808,0.8715585823906109,24,34,24,5,29,15,9
9965,0,0,0.08803379607749767,0.478005753670632,12,14,10,1,13,4,8
9966,0,0,1.2517781331540312,0.22239248724113214,20,29,21,6,23,7,13
9967,1,0,0.6903816110915137,0.33394818733800924,14,17,8,4,13,5,9
9968,0,0,0.5417441381855799,0.3677819446284467,9,12,5,3,9,2,7
9969,0,0,2.0138796847655422,0.11775332902251612,6,5,2,1,4,1,5
9970,0,1,0.9363890886651722,0.7183696934357173,8,8,3,2,6,5,3
9971,1,1,3.3986487022491465,0.9676622772112696,23,35,22,6,29,16,7
9972,1,1,2.991593481520437,0.9521929002383731,25,37,25,4,33,18,7
9973,0,1,0.8127095190312956,0.6926865856452709,24,36,23,12,24,12,12
9974,0,1,0.15080105775824504,0.5376289815252986,11,13,7,3,10,7,4
9975,1,0,2.151992298600223,0.10414519705177427,9,10,5,0,10,0,9
9976,0,0,0.47345715710017044,0.38379830797696435,16,19,12,4,15,8,8
9977,0,0,0.9721483371383801,0.2744525002089091,15,21,12,5,16,5,10
9978,0,0,2.7314409231003505,0.06114339447759254,6,8,4,0,8,0,6
9979,0,0,0.899829735661205,0.28908548800562794,11,12,5,2,10,2,9
9980,1,1,4.2947745615816935,0.9865438903248984,27,41,24,8,33,18,9
9981,0,1,0.6488670410528745,0.6567551075671276,7,6,4,2,4,4,3
9982,0,0,1.9777593518689756,0.12155789501425673,15,20,10,8,12,8,7
9983,0,0,2.0224861787709054,0.11686215930121668,22,32,20,5,27,6,16
9984,1,1,1.9771726251240838,0.8783794394683149,11,12,6,4,8,7,4
9985,1,1,3.536127013932857,0.9716983968605585,6,8,4,0,8,6,0
9986,0,0,4.137583367909886,0.015710614656889388,9,11,5,1,10,1,8
9987,0,0,2.5830567124991344,0.07023685403009827,14,17,9,2,15,3,11
9988,1,1,1.0299631138693868,0.7369087446251259,14,18,10,5,13,8,6
9989,1,0,1.8399886655302005,0.13705263308872095,6,5,2,0,5,0,6
9990,1,0,0.6855088330038481,0.33503289928392743,19,26,14,5,21,8,11
9991,1,1,2.8375464918005697,0.9446713635960792,15,20,13,4,16,10,5
9992,1,0,4.711965321360886,0.008907049158910385,8,7,3,0,7,0,8
9993,0,0,3.75293298860241,0.022911618085884156,21,28,14,5,23,6,15
9994,0,0,2.6781986065064665,0.06427212941367055,12,16,10,0,16,0,12
9995,0,0,1.6799265246436574,0.1571051984788261,11,14,8,2,12,3,8
9996,1,0,1.9775613143259754,0.12157904335955527,11,12,7,3,9,3,8
9997,0,0,2.99401329027871,0.047697066695406076,17,21,13,2,19,3,14
9998,1,1,0.15018794141298386,0.537476567063524,10,11,6,4,7,5,5
9999,0,1,1.0374601535634826,0.7383596437900342,26,34,18,7,27,14,12
