,y_true,y_pred,default_final_strength,predicted_prob,num_args,num_rels,num_rels_not_flat,num_atts,num_supp,num_pos_args,num_neg_args
0,0,0,4.846117652943484,0.007797549492390088,9,11,7,4,7,4,5
1,0,0,6.051134898270439,0.002349653715585154,3,2,0,1,1,1,2
2,0,0,4.438033879149002,0.011681092943337523,15,17,12,11,6,8,7
3,1,1,4.909041841252362,0.9926745031811716,33,43,35,14,29,22,11
4,0,0,3.0310600765570723,0.04604224356501707,12,13,8,8,5,7,5
5,0,0,4.29427303851675,0.01346276904007948,4,3,2,2,1,2,2
6,1,1,2.9101592651856114,0.9483463667814125,29,36,28,9,27,21,8
7,0,0,5.799889619815508,0.0030187485106257794,1,0,0,0,0,0,1
8,0,0,3.7931556197309337,0.022028238019470958,7,6,2,4,2,5,2
9,0,0,4.805775872553557,0.008115942606363946,4,3,1,2,1,3,1
10,0,0,4.964677528451384,0.006931815793170704,6,5,2,3,2,4,2
11,0,0,5.407305055146868,0.004463693393272239,2,1,0,1,0,1,1
12,0,0,5.759848187888262,0.003141688696947087,5,4,2,2,2,3,2
13,0,0,5.315317610927732,0.004891671149758414,4,3,1,2,1,3,1
14,0,0,4.730377005657917,0.008745977022377893,3,2,0,2,0,2,1
15,0,0,4.392223927617708,0.012221957046324672,20,23,18,14,9,13,7
16,1,0,2.771250515688802,0.058897660726651924,26,32,25,18,14,16,10
17,0,0,4.960032473082803,0.00696386461081,7,7,4,5,2,4,3
18,0,0,5.4480236677496405,0.004286352106499192,10,10,7,7,3,5,5
19,0,0,5.673162354650634,0.0034252067611814097,4,3,1,2,1,2,2
20,0,0,4.1711281633507395,0.015200224291545439,6,5,1,3,2,4,2
21,0,0,5.799889619815508,0.0030187485106257794,1,0,0,0,0,0,1
22,0,0,4.510190605566882,0.01087675920440978,17,18,13,10,8,7,10
23,0,0,4.336220378688211,0.012916865833034419,7,6,2,4,2,6,1
24,0,0,4.381842183719618,0.012347928273693465,6,6,4,4,2,3,3
25,1,1,4.806802258283971,0.9918923157047637,26,33,26,9,24,20,6
26,0,0,5.342650072071191,0.0047604082521656155,5,4,1,2,2,3,2
27,0,0,3.7559697683170037,0.022843733087600016,8,9,6,5,4,6,2
28,0,0,3.1636499955394735,0.040556786768008,15,17,11,8,9,8,7
29,0,0,5.407305055146868,0.004463693393272239,2,1,0,1,0,1,1
30,0,0,5.236649399472811,0.005289913661792323,6,5,2,4,1,3,3
31,0,0,2.4657758878395186,0.07829251640234736,22,26,19,15,11,12,10
32,0,0,4.586793855859888,0.010082764522703735,7,7,4,6,1,4,3
33,0,0,5.172816607202447,0.005636628468964622,5,5,2,3,2,2,3
34,0,0,5.799889619815508,0.0030187485106257794,1,0,0,0,0,0,1
35,0,0,5.514260698752805,0.004012737873124839,2,1,0,1,0,1,1
36,0,0,5.799889619815508,0.0030187485106257794,1,0,0,0,0,0,1
37,0,0,4.399609701586096,0.012133112171280103,6,5,2,2,3,4,2
38,0,0,5.799889619815508,0.0030187485106257794,1,0,0,0,0,0,1
39,0,0,1.2569584068964774,0.22149792987317563,26,30,22,16,14,17,9
40,0,0,4.069444894315513,0.016799814630891308,7,8,5,5,3,4,3
41,0,0,3.2336864688570457,0.03791753611585491,13,14,10,7,7,8,5
42,0,0,6.336763819333141,0.0017668936472347019,2,1,0,0,1,0,2
43,0,0,5.051363361689013,0.0063598940155511485,7,6,3,3,3,5,2
44,0,0,3.3970288591734237,0.032388449325567725,8,7,1,5,2,4,4
45,0,0,5.799889619815508,0.0030187485106257794,1,0,0,0,0,0,1
46,0,0,5.260491196707735,0.00516592803824234,4,3,1,1,2,2,2
47,1,0,4.1192406284551915,0.015996797141250574,5,4,0,3,1,3,2
48,0,0,5.342650072071191,0.0047604082521656155,5,4,1,2,2,3,2
49,0,0,2.452755910864002,0.07923724819345301,11,13,9,6,7,8,3
50,0,0,4.3692629173757345,0.01250228299835221,6,5,2,4,1,4,2
51,0,0,3.885942480881528,0.020115530838262896,7,6,2,4,2,6,1
52,0,0,5.799889619815508,0.0030187485106257794,1,0,0,0,0,0,1
53,0,0,4.469996428057817,0.011317797870002977,6,6,2,3,3,4,2
54,0,0,5.149102370710952,0.0057711136991546175,12,12,7,4,8,4,8
55,0,0,5.091404793616259,0.0061117915143070745,3,2,1,1,1,2,1
56,0,0,5.673162354650634,0.0034252067611814097,4,3,1,2,1,2,2
57,0,0,6.051134898270439,0.002349653715585154,3,2,0,1,1,1,2
58,0,0,5.799889619815508,0.0030187485106257794,1,0,0,0,0,0,1
59,0,0,2.5856859548414026,0.0700653488303532,15,16,10,10,6,9,6
60,0,0,4.9995856187629855,0.006695606317442149,5,4,1,2,2,3,2
61,0,0,5.35699666317524,0.00469291840947994,7,7,4,3,4,4,3
62,0,0,4.974862275645032,0.006862057294013013,5,4,1,2,2,3,2
63,0,0,3.320110950454021,0.034887672579148266,10,11,7,6,5,7,3
64,0,0,5.799889619815508,0.0030187485106257794,1,0,0,0,0,0,1
65,0,0,1.851686614556157,0.13567499073311384,7,6,1,4,2,5,2
66,0,0,5.290762537175642,0.005012663810283202,4,3,0,2,1,2,2
67,0,0,5.407305055146868,0.004463693393272239,2,1,0,1,0,1,1
68,0,0,2.6426718346317353,0.06644211608709927,9,8,2,6,2,7,2
69,0,0,5.407305055146868,0.004463693393272239,2,1,0,1,0,1,1
70,1,1,7.901603637547943,0.9996299874812867,54,78,68,30,48,36,18
71,0,0,5.407305055146868,0.004463693393272239,2,1,0,1,0,1,1
72,0,0,4.206605035149957,0.014678197878461252,6,6,4,5,1,3,3
73,0,0,2.484674326279858,0.076939574888373,7,7,3,4,3,6,1
74,0,0,1.936530566424076,0.1260295054268138,7,7,3,3,4,5,2
75,0,0,1.4923775118154792,0.18356514404462598,22,27,21,16,11,12,10
76,0,1,2.7665401925306172,0.9408407089456478,46,66,57,26,40,30,16
77,0,0,4.346964828229314,0.012780588392940273,18,21,15,9,12,8,10
78,0,0,5.407305055146868,0.004463693393272239,2,1,0,1,0,1,1
79,0,0,5.4022869017054616,0.004486048450040969,3,2,1,1,1,2,1
80,0,0,5.514260698752805,0.004012737873124839,2,1,0,1,0,1,1
81,0,0,4.514945580955398,0.010825721811521971,8,7,3,4,3,6,2
82,0,0,3.8801283541433613,0.02023045280832758,14,14,9,8,6,8,6
83,1,1,3.346601134252481,0.9659933591273671,14,13,7,1,12,13,1
84,0,0,6.85209848772375,0.001056118204361578,9,9,6,1,8,1,8
85,0,0,5.407305055146868,0.004463693393272239,2,1,0,1,0,1,1
86,0,0,5.8233869831373255,0.0029488494871803272,8,8,6,3,5,2,6
87,0,0,5.799889619815508,0.0030187485106257794,1,0,0,0,0,0,1
88,0,0,5.016005926720618,0.006587278453385359,2,1,0,1,0,1,1
89,0,0,3.7512797734183954,0.022948657283788365,6,5,1,4,1,5,1
90,1,1,1.6907537897340568,0.844323264839246,14,18,13,2,16,12,2
91,1,1,6.152215442398646,0.9978757615986156,21,27,18,6,21,17,4
92,1,1,0.6422359620909228,0.6552587278477291,18,22,15,8,14,13,5
93,0,0,2.3926220831395164,0.08373703248940767,14,13,7,9,4,9,5
94,0,0,2.5338372967015657,0.0735198422549157,12,15,11,9,6,8,4
95,0,0,5.407305055146868,0.004463693393272239,2,1,0,1,0,1,1
96,0,0,5.208361967321795,0.005440862487363307,4,3,1,2,1,3,1
97,0,0,1.8308952031612606,0.13813166353744533,44,65,61,29,36,25,19
98,0,0,5.342650072071191,0.0047604082521656155,5,4,1,2,2,3,2
99,0,0,1.963427242156051,0.12309661974606512,16,20,16,11,9,10,6
100,1,1,3.5036114924305,0.9707903526375152,25,28,18,7,21,16,9
101,0,0,4.962456797997326,0.006947119532219492,4,3,0,2,1,2,2
102,0,0,4.628367711095057,0.009676151962998425,2,1,0,1,0,1,1
103,0,0,4.1438643380870355,0.015613781910147284,5,4,1,3,1,4,1
104,0,0,2.5523048008642286,0.0722717992963865,28,39,33,21,18,15,13
105,0,0,4.8796129895499885,0.007542631065824867,4,3,0,2,1,2,2
106,0,0,3.7332304701471872,0.023356862806968137,9,9,3,5,4,5,4
107,0,0,5.398713394089096,0.004502035754896938,11,12,8,4,8,5,6
108,0,0,4.805775872553557,0.008115942606363946,4,3,1,2,1,3,1
109,1,0,1.3950067454125383,0.19860966125733814,7,7,3,5,2,5,2
110,0,0,5.799889619815508,0.0030187485106257794,1,0,0,0,0,0,1
111,0,0,4.876350718671545,0.007567090850389535,2,1,0,1,0,1,1
112,0,0,6.34760078680134,0.0017478825437210466,6,6,2,3,3,2,4
113,0,0,5.342650072071191,0.0047604082521656155,5,4,1,2,2,3,2
114,0,0,4.579307554395523,0.010157760775186708,10,9,5,4,5,4,6
115,0,0,5.407305055146868,0.004463693393272239,2,1,0,1,0,1,1
116,1,1,7.792569885439905,0.9995873796309342,29,36,24,7,29,23,6
117,0,0,4.876350718671545,0.007567090850389535,2,1,0,1,0,1,1
118,0,0,5.091404793616259,0.0061117915143070745,3,2,1,1,1,2,1
119,1,1,5.385205245223491,0.9954370168534908,42,58,51,20,38,27,15
120,0,0,5.342650072071191,0.0047604082521656155,5,4,1,2,2,3,2
121,0,0,2.4657758878395186,0.07829251640234736,22,26,19,15,11,12,10
122,0,0,3.756158191308245,0.022839527507131696,15,17,10,7,10,7,8
123,0,0,5.887227673327688,0.0027669808767897264,7,7,4,4,3,3,4
124,0,0,5.26199121693244,0.005158224791728783,5,5,3,5,0,2,3
125,0,0,5.799889619815508,0.0030187485106257794,1,0,0,0,0,0,1
126,0,0,4.232888085804799,0.01430288176921879,4,4,2,4,0,2,2
127,0,0,5.799889619815508,0.0030187485106257794,1,0,0,0,0,0,1
128,1,1,1.634979567413203,0.8368506481840299,18,22,15,7,15,15,3
129,0,0,4.441766565528984,0.011638078857637901,9,11,7,7,4,5,4
130,0,0,5.799889619815508,0.0030187485106257794,1,0,0,0,0,0,1
131,0,0,5.799889619815508,0.0030187485106257794,1,0,0,0,0,0,1
132,0,0,3.013409777709078,0.046823727608514276,12,14,8,9,5,8,4
133,1,1,0.5914949897619293,0.6437080921982372,32,45,38,17,28,18,14
134,0,0,4.8911953119411065,0.0074564215002005385,6,5,2,4,1,4,2
135,0,0,4.456757084413442,0.011466904742437278,5,4,1,2,2,3,2
136,0,0,5.799889619815508,0.0030187485106257794,1,0,0,0,0,0,1
137,0,0,5.091404793616259,0.0061117915143070745,3,2,1,1,1,2,1
138,0,0,5.315317610927732,0.004891671149758414,4,3,1,2,1,3,1
139,0,0,3.191756984689359,0.03947710311049324,9,11,7,7,4,7,2
140,0,0,5.559933770248842,0.0038342730724496565,5,4,3,4,0,2,3
141,0,0,4.471622155093019,0.011299620908488683,23,26,20,13,13,13,10
142,0,0,5.799889619815508,0.0030187485106257794,1,0,0,0,0,0,1
143,0,0,5.799889619815508,0.0030187485106257794,1,0,0,0,0,0,1
144,0,0,4.024588752624863,0.017557014547281646,14,16,12,10,6,9,5
145,1,1,9.23721635407993,0.9999026612794265,38,53,43,19,34,26,12
146,0,0,5.407305055146868,0.004463693393272239,2,1,0,1,0,1,1
147,0,0,5.9689760229069835,0.0025503373920675587,2,1,0,0,1,0,2
148,0,0,5.799889619815508,0.0030187485106257794,1,0,0,0,0,0,1
149,0,0,4.023675416285661,0.017572775415540032,9,9,5,7,2,6,3
150,0,0,3.975640677784248,0.018421551563499006,8,10,7,6,4,6,2
151,0,0,5.799889619815508,0.0030187485106257794,1,0,0,0,0,0,1
152,0,0,4.628367711095057,0.009676151962998425,2,1,0,1,0,1,1
153,0,0,5.566206711044696,0.003810387547119598,4,3,1,2,1,2,2
154,1,1,3.3481076902833866,0.9660428150484552,35,48,38,19,29,20,15
155,0,0,4.027687172896533,0.017503650433667306,7,7,4,3,4,6,1
156,0,0,5.342650072071191,0.0047604082521656155,5,4,1,2,2,3,2
157,0,0,5.600946531990434,0.0036807671280731924,3,2,1,1,1,2,1
158,0,0,5.091404793616259,0.0061117915143070745,3,2,1,1,1,2,1
159,0,0,4.26126959884695,0.01390821728904601,7,9,7,5,4,5,2
160,0,0,5.799889619815508,0.0030187485106257794,1,0,0,0,0,0,1
161,0,0,4.981461308873592,0.006817231121581169,14,14,11,8,6,9,5
162,0,0,5.653727981650926,0.003492189821910796,8,8,4,4,4,4,4
163,0,1,0.18705829473390523,0.5466286882952591,27,32,24,13,19,17,10
164,0,0,1.702981166723423,0.15407630852770404,12,15,10,9,6,9,3
165,1,1,2.064618217415715,0.8874163954512951,36,49,40,19,30,22,14
166,0,0,3.5746553903633513,0.02726108761266144,8,8,5,6,2,4,4
167,0,0,3.0521017766402854,0.04512682047231786,9,11,7,7,4,7,2
168,1,1,3.4539818450197615,0.9693496661588045,31,37,28,13,24,20,11
169,0,0,5.799889619815508,0.0030187485106257794,1,0,0,0,0,0,1
170,0,0,4.964677528451384,0.006931815793170704,6,5,2,3,2,4,2
171,0,0,3.638461135117387,0.025619174708508274,7,7,5,4,3,4,3
172,0,0,5.799889619815508,0.0030187485106257794,1,0,0,0,0,0,1
173,0,0,3.6938421484865227,0.024272433115027914,5,5,3,2,3,4,1
174,1,1,11.378241729839239,0.999988558382264,39,51,39,11,40,32,7
175,0,0,5.799889619815508,0.0030187485106257794,1,0,0,0,0,0,1
176,1,1,8.999071754647902,0.9998764908445482,39,53,44,18,35,26,13
177,0,0,5.6585503336017995,0.003475448181518237,4,3,0,2,1,2,2
178,0,0,5.799889619815508,0.0030187485106257794,1,0,0,0,0,0,1
179,0,0,4.4783636411846155,0.011224553034327567,9,8,4,6,2,5,4
180,0,0,2.7330036054051923,0.06105375038330951,7,7,4,3,4,6,1
181,1,1,1.2476055708786644,0.776885098838071,31,41,33,16,25,20,11
182,1,1,5.526685118231205,0.9960366132527129,39,52,41,16,36,24,15
183,0,0,6.051134898270439,0.002349653715585154,3,2,0,1,1,1,2
184,0,0,6.051134898270439,0.002349653715585154,3,2,0,1,1,1,2
185,0,0,2.7641757636297424,0.05929103116841472,6,6,2,4,2,5,1
186,0,0,5.091404793616259,0.0061117915143070745,3,2,1,1,1,2,1
187,0,0,2.4109241837992768,0.08234345705547108,15,17,13,10,7,9,6
188,0,0,3.634253963833106,0.0257244074894889,5,4,1,3,1,4,1
189,1,1,4.156497169731381,0.9845792011451683,27,33,25,11,22,18,9
190,0,0,5.208361967321795,0.005440862487363307,4,3,1,2,1,3,1
191,0,0,3.975640677784248,0.018421551563499006,8,10,7,6,4,6,2
192,0,0,4.805775872553557,0.008115942606363946,4,3,1,2,1,3,1
193,0,0,1.889939107788944,0.13125141248527594,21,24,19,11,13,14,7
194,0,0,4.579904581716258,0.010151759671023886,6,5,3,3,2,4,2
195,0,0,2.756713502154477,0.05970861467839694,15,18,14,7,11,9,6
196,1,1,4.403212935321161,0.9879099999936295,27,34,26,7,27,22,5
197,0,0,0.25601579289760146,0.436343365541787,20,26,22,12,14,13,7
198,0,0,5.799889619815508,0.0030187485106257794,1,0,0,0,0,0,1
199,0,0,4.876350718671545,0.007567090850389535,2,1,0,1,0,1,1
200,0,0,3.7376699485727354,0.023255806450972805,7,7,5,4,3,4,3
201,0,0,6.096355508346409,0.0022460008701149503,4,4,2,2,2,1,3
202,0,0,4.621750515261701,0.009739767574295954,4,3,1,3,0,2,2
203,0,0,5.407305055146868,0.004463693393272239,2,1,0,1,0,1,1
204,0,0,5.407305055146868,0.004463693393272239,2,1,0,1,0,1,1
205,0,0,2.626101372449308,0.06747735517905762,8,8,3,5,3,5,3
206,0,0,5.799889619815508,0.0030187485106257794,1,0,0,0,0,0,1
207,0,0,5.944179254664502,0.0026142007247450527,3,2,0,1,1,1,2
208,0,0,5.514260698752805,0.004012737873124839,2,1,0,1,0,1,1
209,0,0,1.093250256458238,0.25100672815448033,24,31,24,15,16,12,12
210,0,0,4.619226291671562,0.00976414362282585,8,7,2,4,3,4,4
211,0,0,5.091404793616259,0.0061117915143070745,3,2,1,1,1,2,1
212,0,0,3.0563452484721085,0.04494432015735583,16,20,14,8,12,10,6
213,0,0,4.5436899846574,0.010522200350230326,9,8,2,4,4,5,4
214,0,0,6.051134898270439,0.002349653715585154,3,2,0,1,1,1,2
215,0,0,4.501640445930183,0.010969131460374593,5,4,1,3,1,3,2
216,0,0,5.673162354650634,0.0034252067611814097,4,3,1,2,1,2,2
217,0,0,5.133763931542861,0.0058597932315829215,7,6,2,3,3,4,3
218,0,0,2.7454979750853474,0.06034141175972785,20,25,19,11,14,11,9
219,1,1,7.095599381170153,0.9991719423512,37,52,42,20,32,25,12
220,0,0,1.4690592254408061,0.18708564918156545,13,13,8,9,4,9,4
221,1,1,5.17526683418829,0.9943770880808821,35,48,40,18,30,26,9
222,0,0,4.876350718671545,0.007567090850389535,2,1,0,1,0,1,1
223,0,0,4.721386317193682,0.008824266916877654,6,6,4,3,3,4,2
224,0,0,5.208361967321795,0.005440862487363307,4,3,1,2,1,3,1
225,0,0,5.9587912757133354,0.0025763773937679257,3,2,1,1,1,1,2
226,0,0,4.198636618147886,0.014793889885942768,11,11,7,6,5,8,3
227,0,0,3.3327238306520894,0.03446547270088329,20,26,23,15,11,12,8
228,0,0,5.091404793616259,0.0061117915143070745,3,2,1,1,1,2,1
229,1,0,2.7593160866627566,0.05956266381226538,17,22,18,10,12,12,5
230,0,0,5.354689268224798,0.004703708335532353,6,5,3,4,1,3,3
231,0,0,4.27823014185618,0.013677514723720474,11,11,8,3,8,4,7
232,0,0,4.628367711095057,0.009676151962998425,2,1,0,1,0,1,1
233,0,0,4.204245412108431,0.014712363622750635,4,3,1,3,0,2,2
234,0,0,4.628367711095057,0.009676151962998425,2,1,0,1,0,1,1
235,0,0,6.031700525270732,0.0023956539117193643,7,7,3,3,4,3,4
236,0,0,3.3494031462540677,0.033914714338468155,10,9,3,6,3,7,3
237,0,0,4.855501154391389,0.007725285994165554,4,3,0,2,1,2,2
238,0,0,3.158150424616095,0.040771327255199274,4,3,1,2,1,3,1
239,0,0,4.855501154391389,0.007725285994165554,4,3,0,2,1,2,2
240,0,0,4.512514877301882,0.010851782037481716,9,11,7,6,5,6,3
241,0,0,4.801393798482676,0.008151294771311157,10,10,7,7,3,5,5
242,0,0,5.799889619815508,0.0030187485106257794,1,0,0,0,0,0,1
243,0,0,0.7065116292124882,0.330370100289051,51,73,66,34,39,28,23
244,0,0,4.222757616742387,0.01444640923223417,5,4,3,2,2,3,2
245,0,0,4.26126959884695,0.01390821728904601,7,9,7,5,4,5,2
246,0,0,5.799889619815508,0.0030187485106257794,1,0,0,0,0,0,1
247,0,0,4.805775872553557,0.008115942606363946,4,3,1,2,1,3,1
248,0,0,5.091404793616259,0.0061117915143070745,3,2,1,1,1,2,1
249,0,0,3.763373669285296,0.022679046533079616,11,12,8,6,6,6,5
250,1,1,7.392065703682143,0.9993842574597083,38,51,44,16,35,26,12
251,0,0,5.799889619815508,0.0030187485106257794,1,0,0,0,0,0,1
252,0,0,5.600946531990434,0.0036807671280731924,3,2,1,1,1,2,1
253,0,0,3.866278474547307,0.02050680566507157,11,13,9,6,7,6,5
254,0,0,4.970792099969046,0.006889851165279404,4,3,1,3,0,2,2
255,0,0,4.438326936451781,0.011677710184924361,4,3,1,3,0,2,2
256,0,0,1.975166585157237,0.12183502649211664,16,20,16,8,12,10,6
257,0,0,4.060363911502269,0.016950470531415407,10,10,8,6,4,7,3
258,0,0,5.944179254664502,0.0026142007247450527,3,2,0,1,1,1,2
259,0,0,4.917639560675063,0.0072632397280323335,11,11,6,7,4,7,4
260,0,0,2.738203512053759,0.06075633905247946,11,11,7,6,5,7,4
261,0,0,4.483766154002906,0.011164750968186032,3,2,0,2,0,2,1
262,0,0,5.799889619815508,0.0030187485106257794,1,0,0,0,0,0,1
263,0,0,4.140157050334374,0.01567086533492601,7,9,7,4,5,4,3
264,1,0,0.5232924131216166,0.37208268023041546,12,14,10,8,6,8,4
265,0,0,5.5360456942462815,0.003926605256317384,10,10,7,4,6,4,6
266,0,0,5.0268428941888175,0.006516740435345114,6,6,2,4,2,3,3
267,0,0,4.986317511352883,0.006784429581169871,5,4,0,2,2,2,3
268,0,0,5.546576536554456,0.00388563159047961,5,4,1,2,2,3,2
269,0,0,3.5181454345223573,0.02880032442225633,7,7,4,3,4,6,1
270,0,0,2.6508903303386107,0.06593415566133709,10,11,7,6,5,7,3
271,0,0,3.265929116249189,0.03675869656397257,11,12,7,8,4,7,4
272,0,0,4.690503843096533,0.009098515569898824,7,6,1,4,2,4,3
273,0,0,5.121676134084166,0.005930632429180682,3,2,0,2,0,2,1
274,0,0,5.799889619815508,0.0030187485106257794,1,0,0,0,0,0,1
275,0,0,4.876350718671545,0.007567090850389535,2,1,0,1,0,1,1
276,0,0,5.514260698752805,0.004012737873124839,2,1,0,1,0,1,1
277,0,0,5.6585503336017995,0.003475448181518237,4,3,0,2,1,2,2
278,0,0,5.600946531990434,0.0036807671280731924,3,2,1,1,1,2,1
279,1,0,0.13407110103022557,0.4665323416610524,19,22,17,12,10,10,9
280,0,0,5.799889619815508,0.0030187485106257794,1,0,0,0,0,0,1
281,0,0,5.799889619815508,0.0030187485106257794,1,0,0,0,0,0,1
282,1,1,5.272690998311793,0.9948963926895499,51,76,69,27,49,35,16
283,0,0,2.1113003710579807,0.10800332695078552,11,12,8,5,7,7,4
284,0,0,5.514260698752805,0.004012737873124839,2,1,0,1,0,1,1
285,0,0,3.342493747998085,0.03414182784821285,9,11,8,3,8,8,1
286,0,0,5.799889619815508,0.0030187485106257794,1,0,0,0,0,0,1
287,0,0,5.091404793616259,0.0061117915143070745,3,2,1,1,1,2,1
288,0,0,6.051134898270439,0.002349653715585154,3,2,0,1,1,1,2
289,0,0,4.250980658869152,0.014050035860663113,6,6,4,5,1,3,3
290,0,0,5.213766125614278,0.0054116972047763,6,6,4,4,2,4,2
291,0,0,4.876350718671545,0.007567090850389535,2,1,0,1,0,1,1
292,0,0,6.50259990928068,0.0014972902245438124,6,6,5,0,6,0,6
293,1,1,6.7134784510181085,0.9987870406319042,60,88,76,29,59,39,21
294,0,0,3.951276502784909,0.018867317639127412,22,27,25,16,11,11,11
295,0,0,5.614621943092617,0.0036309552673419176,5,4,1,3,1,2,3
296,0,0,2.552537362594175,0.07225620791215626,8,9,5,4,5,7,1
297,1,1,4.173202094323393,0.9848307895555329,43,60,51,26,34,27,16
298,0,0,2.440604607088961,0.08012833660823715,18,18,12,10,8,12,6
299,0,0,3.9721850755256662,0.018484140542518013,8,7,2,4,3,6,2
300,0,0,5.117344679201073,0.005956223073278921,12,12,6,8,4,7,5
301,0,0,1.6544598882255603,0.16050709359819992,12,12,8,7,5,9,3
302,0,0,2.6508402729573093,0.06593723860439538,29,39,34,17,22,18,11
303,0,0,4.0471083005825985,0.017172770952559313,12,13,10,8,5,7,5
304,0,0,5.023440035953948,0.006538808503524507,3,2,1,2,0,1,2
305,1,1,2.44592087912251,0.9202626403936919,51,73,63,28,45,30,21
306,0,0,5.9689760229069835,0.0025503373920675587,2,1,0,0,1,0,2
307,0,0,5.9587912757133354,0.0025763773937679257,3,2,1,1,1,1,2
308,1,1,1.86951829220021,0.866402530021519,27,37,33,12,25,16,11
309,0,0,4.74962345350667,0.008580688124617208,5,4,1,3,1,3,2
310,0,0,3.9198828848958085,0.01945731885008606,4,3,1,2,1,3,1
311,1,1,8.468525500335275,0.9997900697977172,44,57,46,20,37,28,16
312,0,0,3.4353795118877866,0.03120787756662735,7,6,2,4,2,6,1
313,0,0,4.85270373140404,0.0077467594936287965,7,6,3,3,3,5,2
314,0,0,5.799889619815508,0.0030187485106257794,1,0,0,0,0,0,1
315,0,0,3.936299669993248,0.019146565912169122,7,8,4,3,5,5,2
316,0,0,5.407305055146868,0.004463693393272239,2,1,0,1,0,1,1
317,0,0,5.078999315968552,0.006187611383011493,2,1,0,1,0,1,1
318,0,0,5.445024155666567,0.004299173015741786,6,6,4,6,0,2,4
319,0,0,5.352617037751442,0.004713419619325254,6,6,4,4,2,3,3
320,0,0,5.642799947480607,0.003530426405587206,7,7,5,1,6,1,6
321,0,0,5.799889619815508,0.0030187485106257794,1,0,0,0,0,0,1
322,0,0,3.532673765558938,0.02839672446683994,19,18,13,12,6,12,7
323,0,0,4.481606239397662,0.011188621834508417,5,5,2,5,0,3,2
324,0,0,4.964677528451384,0.006931815793170704,6,5,2,3,2,4,2
325,0,0,6.13798900087393,0.0021546091634404574,4,3,0,1,2,1,3
326,0,0,3.4082132274238206,0.03203976474792547,6,6,3,3,3,5,1
327,0,0,5.342650072071191,0.0047604082521656155,5,4,1,2,2,3,2
328,1,1,6.383858742172273,0.998314252026722,42,59,50,17,42,31,11
329,0,0,4.876350718671545,0.007567090850389535,2,1,0,1,0,1,1
330,0,0,2.9777792655950934,0.04843988747637529,13,15,9,8,7,9,4
331,0,0,4.970792099969046,0.006889851165279404,4,3,1,3,0,2,2
332,0,0,5.121676134084166,0.005930632429180682,3,2,0,2,0,2,1
333,0,0,5.514260698752805,0.004012737873124839,2,1,0,1,0,1,1
334,0,0,5.514260698752805,0.004012737873124839,2,1,0,1,0,1,1
335,0,0,5.6585503336017995,0.003475448181518237,4,3,0,2,1,2,2
336,0,0,5.799889619815508,0.0030187485106257794,1,0,0,0,0,0,1
337,0,0,5.799889619815508,0.0030187485106257794,1,0,0,0,0,0,1
338,0,0,3.4353108760080326,0.031209952766876548,7,6,2,4,2,6,1
339,0,0,3.191756984689359,0.03947710311049324,9,11,7,7,4,7,2
340,0,0,5.407305055146868,0.004463693393272239,2,1,0,1,0,1,1
341,0,0,4.876350718671545,0.007567090850389535,2,1,0,1,0,1,1
342,0,0,4.415938706241467,0.011938945478392804,5,5,3,3,2,3,2
343,0,0,4.27869531491603,0.01367124075375703,6,5,1,3,2,4,2
344,1,1,8.142190022101039,0.9997090854507122,43,57,46,21,36,27,16
345,0,0,3.175558307196144,0.04009593817056589,13,14,9,7,7,8,5
346,0,0,5.178547045637907,0.005604601000488207,6,5,2,2,3,4,2
347,0,0,3.2615294209922028,0.03691479664985453,9,10,6,7,3,6,3
348,1,0,1.2850179272258844,0.2166972720359932,16,21,16,10,11,11,5
349,0,0,2.7454979750853474,0.06034141175972785,20,25,19,11,14,11,9
350,0,0,5.091404793616259,0.0061117915143070745,3,2,1,1,1,2,1
351,0,0,5.407305055146868,0.004463693393272239,2,1,0,1,0,1,1
352,0,0,5.015661406801298,0.006589533335822795,10,11,9,7,4,4,6
353,0,0,5.121676134084166,0.005930632429180682,3,2,0,2,0,2,1
354,0,0,5.9689760229069835,0.0025503373920675587,2,1,0,0,1,0,2
355,0,0,6.336763819333141,0.0017668936472347019,2,1,0,0,1,0,2
356,0,0,4.805775872553557,0.008115942606363946,4,3,1,2,1,3,1
357,0,0,1.3804480396348104,0.20093705226124847,9,9,5,5,4,7,2
358,0,0,5.407305055146868,0.004463693393272239,2,1,0,1,0,1,1
359,0,0,1.9146126475786573,0.12846353146358247,18,21,17,10,11,12,6
360,0,0,5.407305055146868,0.004463693393272239,2,1,0,1,0,1,1
361,0,0,4.805775872553557,0.008115942606363946,4,3,1,2,1,3,1
362,0,0,3.989044469526,0.018180739588448236,10,10,4,6,4,6,4
363,0,0,4.8796129895499885,0.007542631065824867,4,3,0,2,1,2,2
364,0,0,5.944179254664502,0.0026142007247450527,3,2,0,1,1,1,2
365,0,0,4.805775872553557,0.008115942606363946,4,3,1,2,1,3,1
366,0,0,4.79337039490585,0.0082164194472506,3,2,0,2,0,2,1
367,0,0,6.336763819333141,0.0017668936472347019,2,1,0,0,1,0,2
368,0,0,5.0271818581886905,0.006514546257080256,17,23,20,9,14,5,12
369,0,0,3.9448670161520774,0.018986332450041,10,12,9,8,4,5,5
370,0,0,6.113265657755978,0.002208423154050898,4,3,0,1,2,1,3
371,0,0,5.2855026892438435,0.005038965914938132,6,5,2,2,3,4,2
372,1,1,5.883342656664962,0.9972222783657569,42,59,51,22,37,28,14
373,0,0,5.407305055146868,0.004463693393272239,2,1,0,1,0,1,1
374,0,0,5.799889619815508,0.0030187485106257794,1,0,0,0,0,0,1
375,0,0,5.290762537175642,0.005012663810283202,4,3,0,2,1,2,2
376,0,0,3.975640677784248,0.018421551563499006,8,10,7,6,4,6,2
377,0,0,6.492232219079701,0.001512870808544231,10,10,6,2,8,3,7
378,0,0,3.0115620867856414,0.0469062614784439,7,7,5,3,4,5,2
379,0,0,5.799889619815508,0.0030187485106257794,1,0,0,0,0,0,1
380,0,0,2.7409243799622813,0.060601258144676096,11,12,7,7,5,7,4
381,0,0,5.127595997126477,0.005895833994130517,4,3,0,2,1,2,2
382,0,0,5.799889619815508,0.0030187485106257794,1,0,0,0,0,0,1
383,0,0,0.8975466531813101,0.28955492170312525,15,18,12,10,8,10,5
384,0,0,5.799889619815508,0.0030187485106257794,1,0,0,0,0,0,1
385,0,0,5.799889619815508,0.0030187485106257794,1,0,0,0,0,0,1
386,1,1,3.6696388324848233,0.9751477045893701,42,61,56,24,37,29,13
387,0,0,4.271955161000131,0.013762425819977664,11,12,9,8,4,8,3
388,0,0,3.3972114359361028,0.03238272796097008,8,8,4,6,2,5,3
389,0,0,4.552538566598461,0.010430471377632977,10,9,5,6,3,6,4
390,0,0,4.9185277730845645,0.007256838087838946,7,6,2,4,2,4,3
391,0,0,2.1796651837247203,0.10159148272173191,19,26,23,14,12,10,9
392,1,1,8.490750992078036,0.9997946831844273,42,63,54,19,44,32,10
393,0,0,4.117514702510424,0.016023987475099033,7,8,5,5,3,5,2
394,0,0,5.799889619815508,0.0030187485106257794,1,0,0,0,0,0,1
395,0,0,4.912256712866794,0.0073021557959952466,8,7,4,4,3,4,4
396,0,0,4.355073815378216,0.012678678505473662,6,7,5,4,3,3,3
397,0,0,4.230108038920534,0.014342128698490608,17,23,20,9,14,8,9
398,0,0,4.288624670880827,0.013537994494292827,17,20,16,14,6,8,9
399,0,0,5.799889619815508,0.0030187485106257794,1,0,0,0,0,0,1
400,0,0,3.1683426772931167,0.04037457862510907,15,15,11,9,6,9,6
401,0,0,5.799889619815508,0.0030187485106257794,1,0,0,0,0,0,1
402,0,0,4.137465909000369,0.015712431120271653,7,6,3,3,3,5,2
403,0,0,3.8771144009134137,0.020290279386716792,8,8,7,4,4,4,4
404,0,0,4.7776901345244305,0.008345186800954973,13,16,12,8,8,8,5
405,0,0,3.9796207671443504,0.018349720574719952,7,7,3,3,4,5,2
406,0,0,4.674683899468694,0.009242257256093955,5,4,3,2,2,3,2
407,0,0,4.805775872553557,0.008115942606363946,4,3,1,2,1,3,1
408,1,1,7.4740154179116995,0.9994326776522603,52,70,59,24,46,36,16
409,1,1,0.2309353033950199,0.5574786027897001,10,12,7,1,11,9,1
410,0,0,5.6862041092802995,0.003380976135044955,19,21,16,9,12,10,9
411,0,0,1.4619276115164155,0.18817267908890156,14,16,10,9,7,11,3
412,0,0,5.6585503336017995,0.003475448181518237,4,3,0,2,1,2,2
413,0,0,5.407305055146868,0.004463693393272239,2,1,0,1,0,1,1
414,0,0,5.799889619815508,0.0030187485106257794,1,0,0,0,0,0,1
415,1,1,2.2071633242488033,0.9008909379655559,27,36,29,13,23,17,10
416,0,0,5.511736475162666,0.004022838916481142,6,5,1,2,3,3,3
417,1,1,4.282856552976343,0.9863847573805605,50,74,65,27,47,33,17
418,1,1,2.7135784207099354,0.937823136757392,23,30,22,8,22,19,4
419,0,0,3.561605302137544,0.02760929204805951,13,16,13,7,9,8,5
420,0,0,1.103799904809371,0.24902858398537264,17,20,13,15,5,10,7
421,0,0,3.5155271705813393,0.028873649953070735,4,3,1,2,1,3,1
422,0,0,3.2998677341235774,0.0355757270486301,16,17,12,11,6,9,7
423,0,0,5.9689760229069835,0.0025503373920675587,2,1,0,0,1,0,2
424,0,0,5.222494072124503,0.005364922024991725,14,18,17,8,10,6,8
425,0,0,5.342650072071191,0.0047604082521656155,5,4,1,2,2,3,2
426,0,0,1.154653753536122,0.2396400828313583,17,19,12,11,8,11,6
427,0,0,2.1645707008565394,0.1029774747576534,8,8,4,4,4,5,3
428,1,1,7.484771325266199,0.9994387436131119,24,29,20,7,22,18,6
429,0,0,5.799889619815508,0.0030187485106257794,1,0,0,0,0,0,1
430,0,0,3.395338079960541,0.03244147930968466,11,10,4,6,4,9,2
431,0,0,5.4022869017054616,0.004486048450040969,3,2,1,1,1,2,1
432,1,1,2.313875442033673,0.9100196960603354,26,35,28,12,23,17,9
433,0,0,4.349529027742456,0.012748275646490725,20,25,20,9,16,8,12
434,0,0,5.121676134084166,0.005930632429180682,3,2,0,2,0,2,1
435,0,0,4.964677528451384,0.006931815793170704,6,5,2,3,2,4,2
436,0,0,4.628367711095057,0.009676151962998425,2,1,0,1,0,1,1
437,0,0,4.805775872553557,0.008115942606363946,4,3,1,2,1,3,1
438,0,0,5.461060951384979,0.004231067325223825,5,4,0,2,2,2,3
439,0,0,4.501640445930183,0.010969131460374593,5,4,1,3,1,3,2
440,1,0,0.5573717019674964,0.3641558149972536,12,13,7,7,6,10,2
441,0,0,5.315317610927732,0.004891671149758414,4,3,1,2,1,3,1
442,0,0,5.799889619815508,0.0030187485106257794,1,0,0,0,0,0,1
443,0,0,5.262117863559905,0.005157574930405362,7,6,1,3,3,4,3
444,0,0,5.121676134084166,0.005930632429180682,3,2,0,2,0,2,1
445,0,1,0.8043399274595355,0.6909020674653013,22,27,19,9,18,14,8
446,0,0,4.658601875708168,0.009390685998041381,13,13,7,4,9,6,7
447,0,0,5.407305055146868,0.004463693393272239,2,1,0,1,0,1,1
448,0,0,5.799889619815508,0.0030187485106257794,1,0,0,0,0,0,1
449,0,0,5.9689760229069835,0.0025503373920675587,2,1,0,0,1,0,2
450,1,1,8.188060409556217,0.9997221247603967,39,53,44,13,40,31,8
451,0,0,4.8924617057911854,0.007447054986768342,5,4,2,2,2,4,1
452,0,0,5.234264116868242,0.00530247967525288,5,4,2,3,1,2,3
453,1,1,8.891109234423565,0.999862411998118,68,105,96,37,68,44,24
454,0,0,4.64197229694695,0.009546651541666895,10,11,7,8,3,6,4
455,0,0,5.165241910612691,0.005679242931927009,3,2,0,1,1,1,2
456,0,0,5.209815672930047,0.005433001761877443,3,2,0,1,1,1,2
457,0,0,1.467210042230736,0.18736704423224537,6,5,2,4,1,4,2
458,0,0,1.5293018768682005,0.1780958524944879,10,9,2,6,3,8,2
459,0,0,5.023906220121401,0.006535780843253347,16,18,14,8,10,7,9
460,0,0,6.051134898270439,0.002349653715585154,3,2,0,1,1,1,2
461,0,0,4.1711281633507395,0.015200224291545439,6,5,1,3,2,4,2
462,0,0,4.964677528451384,0.006931815793170704,6,5,2,3,2,4,2
463,1,1,8.437316534811135,0.9997834162267706,39,56,46,13,43,32,7
464,0,0,5.407305055146868,0.004463693393272239,2,1,0,1,0,1,1
465,0,0,1.5015269587582765,0.18219789375240802,23,27,20,14,13,15,8
466,0,0,5.260491196707735,0.00516592803824234,4,3,1,1,2,2,2
467,0,0,5.514260698752805,0.004012737873124839,2,1,0,1,0,1,1
468,0,0,4.797454114186533,0.008183208331022263,3,2,0,1,1,1,2
469,1,1,4.4675451486005455,0.98865474015235,41,57,50,20,37,25,16
470,0,0,4.794954481106146,0.0082035209225364,8,8,5,7,1,5,3
471,0,0,4.856455490995367,0.0077179738615793525,7,6,2,5,1,4,3
472,0,0,4.805775872553557,0.008115942606363946,4,3,1,2,1,3,1
473,0,0,3.7931556197309337,0.022028238019470958,7,6,2,4,2,5,2
474,0,0,0.8871479043542321,0.2916987503208188,18,21,14,11,10,13,5
475,0,0,2.332569591310939,0.08846124284159795,15,16,12,7,9,10,5
476,1,1,2.377446313242097,0.9150912248717564,25,31,25,10,21,17,8
477,0,0,4.964677528451384,0.006931815793170704,6,5,2,3,2,4,2
478,0,0,2.8830241900251385,0.05299914623794788,12,13,9,7,6,8,4
479,0,0,5.407305055146868,0.004463693393272239,2,1,0,1,0,1,1
480,0,0,5.078999315968552,0.006187611383011493,2,1,0,1,0,1,1
481,0,0,5.37715003355842,0.004599717628684052,7,7,5,7,0,3,4
482,0,0,5.799889619815508,0.0030187485106257794,1,0,0,0,0,0,1
483,1,1,2.211853198693224,0.9013088936567712,38,51,42,18,33,24,14
484,0,0,5.799889619815508,0.0030187485106257794,1,0,0,0,0,0,1
485,0,0,5.407305055146868,0.004463693393272239,2,1,0,1,0,1,1
486,0,0,3.833335767716219,0.02117905998901637,8,9,7,4,5,5,3
487,0,0,4.8802244975093405,0.007538054854596576,4,3,0,2,1,2,2
488,0,0,4.349880238447971,0.012743856150200239,8,7,2,4,3,5,3
489,0,0,1.6547056277472145,0.16047398429525261,17,22,17,10,12,12,5
490,0,0,5.342650072071191,0.0047604082521656155,5,4,1,2,2,3,2
491,0,0,5.799889619815508,0.0030187485106257794,1,0,0,0,0,0,1
492,0,0,5.091404793616259,0.0061117915143070745,3,2,1,1,1,2,1
493,1,1,2.042793332705151,0.8852173972159825,41,59,53,22,37,26,15
494,0,0,3.597684312365563,0.026657011556515897,6,5,2,4,1,4,2
495,0,0,5.342650072071191,0.0047604082521656155,5,4,1,2,2,3,2
496,0,0,5.342650072071191,0.0047604082521656155,5,4,1,2,2,3,2
497,1,1,3.174263761960667,0.9598542073689905,36,46,37,15,31,27,9
498,0,0,5.023440035953948,0.006538808503524507,3,2,1,2,0,1,2
499,0,0,5.121676134084166,0.005930632429180682,3,2,0,2,0,2,1
500,0,0,5.7804552468158,0.003077807455894588,5,5,3,2,3,2,3
501,0,0,4.964677528451384,0.006931815793170704,6,5,2,3,2,4,2
502,0,0,6.220221301361915,0.001984857548593899,4,3,0,1,2,1,3
503,0,0,5.078999315968552,0.006187611383011493,2,1,0,1,0,1,1
504,0,0,4.276457498525227,0.013701449089758677,10,11,6,6,5,7,3
505,0,0,1.9514106641958708,0.12439962106776703,10,11,6,7,4,5,5
506,0,0,4.805775872553557,0.008115942606363946,4,3,1,2,1,3,1
507,0,0,4.986317511352883,0.006784429581169871,5,4,0,2,2,2,3
508,0,0,3.9198828848958085,0.01945731885008606,4,3,1,2,1,3,1
509,1,1,1.354540853145008,0.7948710106525663,20,27,21,8,19,16,4
510,0,0,5.6585503336017995,0.003475448181518237,4,3,0,2,1,2,2
511,1,1,4.051085176209039,0.9828942215014619,32,42,34,17,25,23,9
512,0,0,4.964677528451384,0.006931815793170704,6,5,2,3,2,4,2
513,0,0,5.799889619815508,0.0030187485106257794,1,0,0,0,0,0,1
514,0,0,5.342650072071191,0.0047604082521656155,5,4,1,2,2,3,2
515,0,0,5.541918677121197,0.003903701715591845,5,5,3,4,1,2,3
516,1,1,0.7622402120674252,0.6818399103525408,13,15,13,5,10,9,4
517,0,0,2.4087403101222753,0.08250862771665124,11,12,6,5,7,7,4
518,0,0,5.407305055146868,0.004463693393272239,2,1,0,1,0,1,1
519,1,1,10.877972987073509,0.9999811310313614,57,81,70,27,54,35,22
520,0,0,3.2816893479334883,0.03620472216016912,4,3,1,3,0,2,2
521,0,0,5.009702337036822,0.0066286569884848046,4,3,1,2,1,3,1
522,0,0,4.805775872553557,0.008115942606363946,4,3,1,2,1,3,1
523,0,0,5.576391458238344,0.0037719223052550266,3,2,0,1,1,1,2
524,0,0,2.1095058257926134,0.10817633259960902,13,13,8,6,7,9,4
525,0,0,5.091404793616259,0.0061117915143070745,3,2,1,1,1,2,1
526,0,0,5.799889619815508,0.0030187485106257794,1,0,0,0,0,0,1
527,0,0,5.870523377300958,0.0028134584116151773,4,3,2,0,3,0,4
528,0,0,2.9054650478043564,0.05188406652519084,10,9,4,6,3,6,4
529,0,0,4.711211598898519,0.008913705268396854,12,13,9,6,7,7,5
530,0,0,3.634253963833106,0.0257244074894889,5,4,1,3,1,4,1
531,0,0,5.209467348625759,0.005434884251047545,6,5,2,4,1,3,3
532,0,0,4.893042260605959,0.00744276498677654,4,3,1,2,1,1,3
533,0,0,2.804118769063798,0.05710201076674515,9,11,7,7,4,7,2
534,0,0,5.799889619815508,0.0030187485106257794,1,0,0,0,0,0,1
535,1,0,1.1873581875362147,0.23373175474046914,17,19,12,11,8,12,5
536,0,0,4.512514877301882,0.010851782037481716,9,11,7,6,5,6,3
537,0,0,5.143706984246117,0.00580215408610929,7,6,2,3,3,5,2
538,0,0,5.600946531990434,0.0036807671280731924,3,2,1,1,1,2,1
539,1,1,2.8446386937936943,0.9450408874852588,29,38,30,11,27,19,10
540,0,0,4.577933521090609,0.010171585406520967,5,5,3,4,1,3,2
541,0,0,5.083088407765173,0.006162516936001783,6,5,1,3,2,3,3
542,0,0,4.218751149602885,0.014503563259857355,4,4,2,2,2,3,1
543,0,0,6.051134898270439,0.002349653715585154,3,2,0,1,1,1,2
544,0,0,4.937660029754844,0.0071202973103520195,5,4,0,3,1,3,2
545,0,0,3.634253963833106,0.0257244074894889,5,4,1,3,1,4,1
546,0,0,5.979571295884791,0.002523526346721372,7,7,3,4,3,3,4
547,0,0,5.407305055146868,0.004463693393272239,2,1,0,1,0,1,1
548,0,0,5.078999315968552,0.006187611383011493,2,1,0,1,0,1,1
549,0,0,4.1711281633507395,0.015200224291545439,6,5,1,3,2,4,2
550,0,0,2.873322228058905,0.05348820712168911,10,9,3,6,3,8,2
551,0,0,5.514260698752805,0.004012737873124839,2,1,0,1,0,1,1
552,0,0,5.799889619815508,0.0030187485106257794,1,0,0,0,0,0,1
553,0,0,5.342650072071191,0.0047604082521656155,5,4,1,2,2,3,2
554,0,0,6.051134898270439,0.002349653715585154,3,2,0,1,1,1,2
555,0,0,3.9666242892406443,0.018585297578399884,18,23,18,13,10,11,7
556,0,0,4.18371339297201,0.015012978672041655,10,11,7,6,5,7,3
557,1,0,2.0130849694117803,0.11783591508336755,13,13,5,8,5,9,4
558,0,0,4.484421815981337,0.011157514714390082,12,13,9,7,6,6,6
559,0,0,5.407305055146868,0.004463693393272239,2,1,0,1,0,1,1
560,0,0,2.6425810183972254,0.06644774941845566,9,9,5,4,5,8,1
561,1,1,4.156497169731381,0.9845792011451683,27,33,25,11,22,18,9
562,0,0,5.514260698752805,0.004012737873124839,2,1,0,1,0,1,1
563,0,0,5.407305055146868,0.004463693393272239,2,1,0,1,0,1,1
564,0,0,4.397492216490133,0.012158518371788829,8,8,5,6,2,5,3
565,0,0,4.590721797608843,0.010043634684410607,3,2,0,2,0,2,1
566,0,0,4.288155279952283,0.013544264508984938,14,18,15,10,8,6,8
567,0,0,5.9689760229069835,0.0025503373920675587,2,1,0,0,1,0,2
568,0,0,5.9689760229069835,0.0025503373920675587,2,1,0,0,1,0,2
569,0,0,5.799889619815508,0.0030187485106257794,1,0,0,0,0,0,1
570,0,0,5.628278993133892,0.0035818806185758945,4,3,1,1,2,2,2
571,0,0,5.407305055146868,0.004463693393272239,2,1,0,1,0,1,1
572,1,1,8.179344776443301,0.9997196929988439,48,61,48,19,42,33,15
573,0,0,4.805775872553557,0.008115942606363946,4,3,1,2,1,3,1
574,0,0,5.799889619815508,0.0030187485106257794,1,0,0,0,0,0,1
575,0,0,5.576391458238344,0.0037719223052550266,3,2,0,1,1,1,2
576,0,0,4.313535633722772,0.01320931563546035,11,14,10,7,7,7,4
577,0,0,4.147927587529292,0.01555145256110424,9,10,7,6,4,6,3
578,0,0,4.805775872553557,0.008115942606363946,4,3,1,2,1,3,1
579,0,0,5.26725120517555,0.005131302680574712,4,3,0,2,1,2,2
580,0,0,4.358503290489491,0.012635820246550633,9,9,5,6,3,6,3
581,0,0,5.797365396225368,0.0030263550422693353,5,4,1,1,3,2,3
582,0,0,4.805775872553557,0.008115942606363946,4,3,1,2,1,3,1
583,1,1,3.150819421377366,0.9589409971453231,54,79,71,33,46,34,20
584,0,0,4.805775872553557,0.008115942606363946,4,3,1,2,1,3,1
585,0,0,5.407305055146868,0.004463693393272239,2,1,0,1,0,1,1
586,0,0,4.244225582426846,0.01414391927857972,8,7,2,5,2,5,3
587,0,0,3.5710799810947735,0.02735606045742911,14,17,14,8,9,9,5
588,0,0,4.108433824236012,0.016167798726029692,10,9,3,5,4,6,4
589,0,0,2.4610858291457376,0.07863163425859221,26,34,30,19,15,13,13
590,0,0,4.518669049593135,0.01078592149173152,10,9,5,6,3,5,5
591,0,0,5.810726587283707,0.002986308220212841,5,5,2,3,2,2,3
592,0,0,0.3731897168599998,0.4077704989560368,16,19,14,7,12,11,5
593,0,0,0.9183142388036183,0.2853015042428906,15,16,10,8,8,10,5
594,0,0,4.559687486135038,0.010356940206226684,6,5,1,4,1,4,2
595,0,0,5.673162354650634,0.0034252067611814097,4,3,1,2,1,2,2
596,0,0,4.628367711095057,0.009676151962998425,2,1,0,1,0,1,1
597,0,0,5.842248757742109,0.002893909673604922,5,4,1,2,2,2,3
598,0,0,5.799889619815508,0.0030187485106257794,1,0,0,0,0,0,1
599,0,0,6.336763819333141,0.0017668936472347019,2,1,0,0,1,0,2
600,0,0,4.29427303851675,0.01346276904007948,4,3,2,2,1,2,2
601,0,0,4.438326936451781,0.011677710184924361,4,3,1,3,0,2,2
602,0,0,4.719584685259491,0.00884003866147276,9,8,3,5,3,6,3
603,0,0,3.7271115262475094,0.023496851841500965,9,10,6,4,6,6,3
604,1,1,2.9406712251633387,0.9498207279430764,23,29,21,12,17,15,8
605,0,0,5.514260698752805,0.004012737873124839,2,1,0,1,0,1,1
606,0,0,5.683347101844282,0.0033906166223451883,3,2,0,1,1,1,2
607,0,0,1.4864806206293455,0.18445055471786287,7,6,4,3,3,5,2
608,0,0,5.799889619815508,0.0030187485106257794,1,0,0,0,0,0,1
609,0,0,5.121676134084166,0.005930632429180682,3,2,0,2,0,2,1
610,0,0,2.5846916398770254,0.0701301623125884,7,8,5,5,3,5,2
611,1,1,10.411430111943746,0.9999699142884457,55,79,68,26,53,34,21
612,1,1,7.991027610576392,0.9996616284613372,50,74,66,30,44,33,17
613,0,0,4.477561017561893,0.011233464498236034,10,11,6,7,4,5,5
614,0,0,3.9278617329907752,0.019305674783555826,14,15,10,6,9,6,8
615,1,1,7.420654950094098,0.9994016014340447,48,71,62,24,47,35,13
616,0,0,4.231992528986199,0.014315513099678712,8,7,1,5,2,4,4
617,1,1,10.51211010909061,0.999972795749098,49,70,59,28,42,32,17
618,0,0,4.885746859979758,0.0074968529320808,6,6,3,3,3,3,3
619,0,0,4.0619157334630644,0.016924631660262035,31,42,37,15,27,15,16
620,0,0,3.8345450812606496,0.021154004816743233,13,14,10,6,8,10,3
621,0,0,4.686414751299912,0.009135455828281569,3,2,0,2,0,2,1
622,0,0,4.257813996588369,0.013955689803812787,7,6,2,3,3,5,2
623,0,0,5.407305055146868,0.004463693393272239,2,1,0,1,0,1,1
624,0,0,4.876350718671545,0.007567090850389535,2,1,0,1,0,1,1
625,0,0,5.352617037751442,0.004713419619325254,6,6,4,4,2,3,3
626,0,0,2.762602978401464,0.05937881504419784,6,5,1,4,1,5,1
627,0,0,6.051134898270439,0.002349653715585154,3,2,0,1,1,1,2
628,0,0,4.043586446435044,0.017232313525518905,5,5,3,4,1,3,2
629,0,0,6.336763819333141,0.0017668936472347019,2,1,0,0,1,0,2
630,0,0,5.429335905308819,0.004366854503191964,6,5,2,2,3,4,2
631,0,0,5.407305055146868,0.004463693393272239,2,1,0,1,0,1,1
632,0,0,2.9968656527872177,0.04756767354627889,7,7,5,3,4,5,2
633,0,0,3.9088981810455197,0.019668003069719497,17,21,16,10,11,9,8
634,0,0,4.606832784728484,0.009884704982723203,6,5,2,3,2,5,1
635,0,0,4.628367711095057,0.009676151962998425,2,1,0,1,0,1,1
636,0,0,5.9689760229069835,0.0025503373920675587,2,1,0,0,1,0,2
637,0,0,2.576166564002107,0.07068814032872084,42,62,56,31,31,25,17
638,1,1,6.676762690707223,0.9987417353228764,49,70,62,21,49,35,14
639,1,0,4.514945580955398,0.010825721811521971,8,7,3,4,3,6,2
640,0,0,3.7857941340626446,0.022187385722151842,7,6,2,5,1,5,2
641,0,0,5.673162354650634,0.0034252067611814097,4,3,1,2,1,2,2
642,0,0,4.964677528451384,0.006931815793170704,6,5,2,3,2,4,2
643,0,0,3.0137288937458324,0.04680948711526933,24,32,29,14,18,15,9
644,0,0,4.805775872553557,0.008115942606363946,4,3,1,2,1,3,1
645,0,0,4.606832784728484,0.009884704982723203,6,5,2,3,2,5,1
646,0,0,3.367725041122175,0.03331950596655198,11,12,8,6,6,9,2
647,0,0,2.472924503880449,0.07777820491146215,19,23,17,15,8,14,5
648,0,0,2.1128381163709626,0.10785527198276901,15,20,16,10,10,11,4
649,0,0,5.799889619815508,0.0030187485106257794,1,0,0,0,0,0,1
650,0,0,2.7502280779013994,0.06007377048298346,21,27,25,10,17,14,7
651,0,0,4.62042130202123,0.009752596066994856,6,6,3,4,2,3,3
652,0,0,1.4588051002756224,0.1886501500458575,10,11,6,5,6,9,1
653,1,1,1.6631417450108144,0.840659294259285,23,27,21,8,19,16,7
654,0,0,4.882100749740239,0.0075240311370597945,6,5,1,4,1,3,3
655,0,0,6.096355508346409,0.0022460008701149503,4,4,2,2,2,1,3
656,0,0,4.623421362051979,0.00972366561023219,3,2,0,2,0,2,1
657,0,0,5.810726587283707,0.002986308220212841,5,5,2,3,2,2,3
658,0,0,5.72333988097676,0.003258125250769184,5,4,2,2,2,2,3
659,0,0,5.407305055146868,0.004463693393272239,2,1,0,1,0,1,1
660,0,0,3.5625691615652753,0.027583427074447164,10,12,8,7,5,6,4
661,0,0,5.799889619815508,0.0030187485106257794,1,0,0,0,0,0,1
662,0,0,4.461289414803552,0.011415642489576383,9,8,3,4,4,6,3
663,1,1,1.9577641459315114,0.876290777964422,39,56,49,21,35,27,12
664,0,0,4.1711281633507395,0.015200224291545439,6,5,1,3,2,4,2
665,0,0,5.514260698752805,0.004012737873124839,2,1,0,1,0,1,1
666,0,0,5.121676134084166,0.005930632429180682,3,2,0,2,0,2,1
667,0,1,1.5670495826001005,0.8273625960844926,50,76,69,35,41,28,22
668,0,0,4.342738790032355,0.012834019287163323,3,2,0,2,0,2,1
669,0,0,5.799889619815508,0.0030187485106257794,1,0,0,0,0,0,1
670,0,0,4.805775872553557,0.008115942606363946,4,3,1,2,1,3,1
671,0,0,2.5696348592344354,0.07111842172221394,22,29,24,14,15,12,10
672,0,0,5.799889619815508,0.0030187485106257794,1,0,0,0,0,0,1
673,0,0,4.805775872553557,0.008115942606363946,4,3,1,2,1,3,1
674,0,0,4.436845356099791,0.011694821986450221,5,5,2,2,3,3,2
675,0,0,5.514260698752805,0.004012737873124839,2,1,0,1,0,1,1
676,1,1,5.422425248730603,0.9956029963016673,54,81,73,30,51,35,19
677,0,0,4.974862275645032,0.006862057294013013,5,4,1,2,2,3,2
678,0,0,5.407305055146868,0.004463693393272239,2,1,0,1,0,1,1
679,0,0,5.944179254664502,0.0026142007247450527,3,2,0,1,1,1,2
680,1,1,0.20471048730082675,0.5509996452026352,16,20,14,5,15,11,5
681,0,0,6.051134898270439,0.002349653715585154,3,2,0,1,1,1,2
682,0,0,5.576391458238344,0.0037719223052550266,3,2,0,1,1,1,2
683,0,0,5.407305055146868,0.004463693393272239,2,1,0,1,0,1,1
684,0,0,5.673162354650634,0.0034252067611814097,4,3,1,2,1,2,2
685,0,0,5.260491196707735,0.00516592803824234,4,3,1,1,2,2,2
686,0,0,3.2830684611071477,0.03615663023596072,13,16,12,10,6,8,5
687,0,0,5.494826325753098,0.004091163475947623,6,6,3,3,3,3,3
688,0,0,5.407305055146868,0.004463693393272239,2,1,0,1,0,1,1
689,0,0,4.805775872553557,0.008115942606363946,4,3,1,2,1,3,1
690,0,0,4.964677528451384,0.006931815793170704,6,5,2,3,2,4,2
691,0,0,4.483766154002906,0.011164750968186032,3,2,0,2,0,2,1
692,0,0,5.275369664794895,0.005090024234010393,12,13,9,9,4,6,6
693,0,0,5.091404793616259,0.0061117915143070745,3,2,1,1,1,2,1
694,0,0,5.600946531990434,0.0036807671280731924,3,2,1,1,1,2,1
695,0,0,5.342650072071191,0.0047604082521656155,5,4,1,2,2,3,2
696,0,0,5.330244594423483,0.0048195448217384085,4,3,0,2,1,2,2
697,0,0,4.135565187148412,0.01574185390500049,8,7,2,6,1,5,3
698,0,0,4.628367711095057,0.009676151962998425,2,1,0,1,0,1,1
699,0,0,5.944179254664502,0.0026142007247450527,3,2,0,1,1,1,2
700,0,0,1.3686863940672804,0.20283216214034416,8,8,4,4,4,7,1
701,1,1,1.9718051041653064,0.8778048670189992,31,41,32,15,26,19,12
702,0,0,6.336763819333141,0.0017668936472347019,2,1,0,0,1,0,2
703,0,0,5.614621943092617,0.0036309552673419176,5,4,1,3,1,2,3
704,0,0,5.407305055146868,0.004463693393272239,2,1,0,1,0,1,1
705,1,0,3.470215552414091,0.03017167349381822,22,27,22,10,17,10,12
706,0,0,5.576391458238344,0.0037719223052550266,3,2,0,1,1,1,2
707,0,0,3.3310469408191143,0.03452131915997447,9,10,6,7,3,5,4
708,0,0,5.571131610306546,0.0037917388863005774,5,4,2,1,3,3,2
709,0,0,5.065177713776766,0.006273187624137533,4,3,2,3,0,2,2
710,0,0,4.340214566442215,0.012866038809272062,7,6,1,3,3,4,3
711,0,0,2.657092967050632,0.06555318178682035,19,24,20,14,10,10,9
712,0,0,2.6517152299574827,0.0658833708851162,7,6,1,4,2,5,2
713,1,1,5.125582568491499,0.9940923534056888,23,26,17,6,20,19,4
714,0,0,5.407305055146868,0.004463693393272239,2,1,0,1,0,1,1
715,0,0,5.2865694759789985,0.0050336203229873755,11,11,8,8,3,6,5
716,0,0,5.734628305611749,0.00322167078344493,10,10,6,5,5,4,6
717,0,0,5.6585503336017995,0.003475448181518237,4,3,0,2,1,2,2
718,0,0,5.799889619815508,0.0030187485106257794,1,0,0,0,0,0,1
719,0,0,4.021892179458668,0.017603587666997877,5,4,1,3,1,4,1
720,0,0,5.576391458238344,0.0037719223052550266,3,2,0,1,1,1,2
721,0,0,4.922733046259093,0.00722660524873886,5,4,1,3,1,4,1
722,0,0,5.234264116868242,0.00530247967525288,5,4,2,3,1,2,3
723,0,0,4.232888085804799,0.01430288176921879,4,4,2,4,0,2,2
724,0,0,1.8982908260043736,0.1303020414466728,17,18,11,12,6,9,8
725,0,0,2.401346061125693,0.08307011017816857,12,13,8,6,7,8,4
726,0,0,3.523684988106526,0.02864578209982882,6,5,3,3,2,4,2
727,0,0,5.673162354650634,0.0034252067611814097,4,3,1,2,1,2,2
728,0,0,5.407305055146868,0.004463693393272239,2,1,0,1,0,1,1
729,0,0,5.342650072071191,0.0047604082521656155,5,4,1,2,2,3,2
730,0,0,5.683347101844282,0.0033906166223451883,3,2,0,1,1,1,2
731,0,0,4.748488856009377,0.008590345597121685,15,19,15,9,10,9,6
732,0,0,5.407305055146868,0.004463693393272239,2,1,0,1,0,1,1
733,1,1,4.764157257527382,0.9915420728734705,33,48,41,16,32,24,9
734,0,0,5.342650072071191,0.0047604082521656155,5,4,1,2,2,3,2
735,0,0,5.091404793616259,0.0061117915143070745,3,2,1,1,1,2,1
736,0,0,5.799889619815508,0.0030187485106257794,1,0,0,0,0,0,1
737,0,0,3.729842110252532,0.023434280726861045,6,5,2,4,1,4,2
738,0,0,3.6649149252710647,0.024967035016100758,12,11,5,5,6,7,5
739,0,0,5.209815672930047,0.005433001761877443,3,2,0,1,1,1,2
740,0,0,3.8525265146071455,0.020784860439162278,12,14,11,8,6,8,4
741,0,0,3.801614440979815,0.021846744552090347,8,9,6,5,4,6,2
742,0,1,0.2096007223093279,0.5522091805616138,35,52,48,20,32,22,13
743,0,0,5.133763931542861,0.0058597932315829215,7,6,2,3,3,4,3
744,0,0,4.964677528451384,0.006931815793170704,6,5,2,3,2,4,2
745,0,0,5.799889619815508,0.0030187485106257794,1,0,0,0,0,0,1
746,0,0,6.051134898270439,0.002349653715585154,3,2,0,1,1,1,2
747,0,0,2.11599682283983,0.10755170957682325,22,28,22,16,12,14,8
748,0,0,4.1711281633507395,0.015200224291545439,6,5,1,3,2,4,2
749,1,0,1.7874806296735262,0.1433818834798798,32,43,35,22,21,16,16
750,1,1,8.188200180921747,0.9997221635858942,27,33,23,8,25,20,7
751,0,0,5.799889619815508,0.0030187485106257794,1,0,0,0,0,0,1
752,1,0,0.03953083865357421,0.49011857710085405,18,18,10,10,8,13,5
753,0,0,0.6642833896478653,0.3397780648931058,14,16,13,5,11,11,3
754,0,0,5.375767320828881,0.004606052800751992,3,2,1,2,0,1,2
755,0,0,4.805775872553557,0.008115942606363946,4,3,1,2,1,3,1
756,0,0,1.010602468046283,0.2668619633479309,19,24,16,13,11,9,10
757,1,0,0.058946019161011165,0.48526776072334576,34,45,37,21,24,21,13
758,1,1,6.9816367407319735,0.9990720800516609,33,44,35,12,32,26,7
759,0,0,5.689143358769352,0.0033710866439109477,6,5,1,3,2,2,4
760,0,0,3.978564253102541,0.01836876125842235,5,4,2,2,2,4,1
761,0,0,4.876350718671545,0.007567090850389535,2,1,0,1,0,1,1
762,1,1,7.06713949405797,0.9991480577366313,44,65,56,24,41,31,13
763,0,0,3.8033403669245818,0.02180989286048962,6,5,1,3,2,4,2
764,0,0,2.3493110390036507,0.08712055030998433,7,7,5,2,5,6,1
765,0,0,4.436507774730444,0.011698724413100825,11,11,6,5,6,5,6
766,0,0,4.876350718671545,0.007567090850389535,2,1,0,1,0,1,1
767,0,0,1.4118862516194906,0.19593671542674873,28,36,29,19,17,15,13
768,0,0,5.161555149209109,0.005700100020728627,5,4,2,4,0,2,3
769,0,0,2.2336836441386025,0.09676620268683156,9,10,7,4,6,7,2
770,0,0,3.882236971409594,0.020188699777533792,5,4,1,3,1,4,1
771,0,0,5.827636736693275,0.0029363809149152154,5,4,0,2,2,2,3
772,0,0,4.805775872553557,0.008115942606363946,4,3,1,2,1,3,1
773,0,0,6.051134898270439,0.002349653715585154,3,2,0,1,1,1,2
774,0,0,5.799889619815508,0.0030187485106257794,1,0,0,0,0,0,1
775,1,1,9.07860392802756,0.9998859322516463,28,36,25,11,25,21,7
776,0,0,5.799889619815508,0.0030187485106257794,1,0,0,0,0,0,1
777,0,0,2.8556894004088305,0.054387968896430716,9,8,4,5,3,7,2
778,0,0,5.6535321801603935,0.0034928712762544167,5,4,1,2,2,3,2
779,0,0,3.975640677784248,0.018421551563499006,8,10,7,6,4,6,2
780,1,1,3.3525710562107287,0.9661889275522575,30,40,32,14,26,21,9
781,0,0,2.597983928290551,0.0692682840514266,12,12,7,8,4,8,4
782,0,0,4.26126959884695,0.01390821728904601,7,9,7,5,4,5,2
783,0,0,2.7713975713830328,0.05888951014554289,13,16,11,10,6,8,5
784,0,0,4.68704907930179,0.009129715679166095,3,2,1,1,1,2,1
785,0,0,4.817231108261407,0.008024244797877778,4,3,0,2,1,2,2
786,1,1,0.6184905970404619,0.6498751806458228,37,47,38,20,27,19,18
787,0,0,3.315086648107826,0.03505723936422933,9,9,5,5,4,7,2
788,0,0,3.039268578434883,0.04568304732299422,9,11,8,5,6,6,3
789,0,0,5.600946531990434,0.0036807671280731924,3,2,1,1,1,2,1
790,0,0,4.772657345944051,0.008386939091125312,4,3,0,2,1,2,2
791,0,0,2.753252322730301,0.05990323378270446,8,9,5,3,6,6,2
792,1,1,2.7135784207099354,0.937823136757392,23,30,22,8,22,19,4
793,0,0,5.407305055146868,0.004463693393272239,2,1,0,1,0,1,1
794,0,0,1.515004851413548,0.1801982585129166,14,15,9,8,7,10,4
795,0,0,4.054860652111106,0.017042416371467528,7,7,6,3,4,4,3
796,1,0,0.6975042939544878,0.3323657900589718,35,49,43,22,27,19,16
797,0,0,4.805775872553557,0.008115942606363946,4,3,1,2,1,3,1
798,0,0,1.4473231807526918,0.19041387298663093,41,58,52,29,29,22,19
799,0,0,3.480448071020925,0.02987369140779461,2,1,0,1,0,1,1
800,0,0,5.528343752216111,0.003956844378065538,9,8,6,6,2,5,4
801,0,0,5.209815672930047,0.005433001761877443,3,2,0,1,1,1,2
802,0,0,5.799889619815508,0.0030187485106257794,1,0,0,0,0,0,1
803,0,0,0.7156281452923619,0.32835642063257275,28,40,36,19,21,16,12
804,0,0,5.759848187888262,0.003141688696947087,5,4,2,2,2,3,2
805,0,0,6.096355508346409,0.0022460008701149503,4,4,2,2,2,1,3
806,1,1,4.264153182329154,0.9861312750372933,34,44,35,11,33,28,6
807,0,0,5.342650072071191,0.0047604082521656155,5,4,1,2,2,3,2
808,0,0,5.407305055146868,0.004463693393272239,2,1,0,1,0,1,1
809,0,0,5.091404793616259,0.0061117915143070745,3,2,1,1,1,2,1
810,0,0,4.160004191985295,0.015367642134214599,6,5,1,3,2,4,2
811,0,0,5.231828928870026,0.005315339226973914,10,11,7,7,4,5,5
812,1,1,9.460661113292327,0.9999221509579913,57,83,73,25,58,38,19
813,0,0,2.24675697046405,0.09562956929436894,9,9,4,5,4,8,1
814,0,0,5.342650072071191,0.0047604082521656155,5,4,1,2,2,3,2
815,0,0,5.799889619815508,0.0030187485106257794,1,0,0,0,0,0,1
816,0,0,3.492399805097504,0.02952925459722755,6,6,3,4,2,4,2
817,0,0,4.876350718671545,0.007567090850389535,2,1,0,1,0,1,1
818,0,0,3.369342065989761,0.03326746198631736,14,17,14,10,7,8,6
819,1,1,1.3173459749257121,0.7887398070156648,20,22,14,4,18,16,4
820,1,0,2.7399646500203967,0.06065591741227949,20,28,26,12,16,11,9
821,0,0,1.9159665784945292,0.1283120207130488,8,7,2,5,2,7,1
822,0,0,5.198466284833665,0.005494673505278214,9,8,4,5,3,5,4
823,1,1,9.863176921592709,0.9999479460031374,33,47,38,12,35,27,6
824,0,0,4.229809531557472,0.014346349139359171,7,6,2,3,3,5,2
825,0,0,5.509649160084729,0.00403121073327406,4,3,2,3,0,1,3
826,0,0,3.334696257895469,0.03439989528497844,7,7,3,4,3,4,3
827,1,1,1.1625809345212286,0.7618013677392569,17,20,15,2,18,15,2
828,0,0,5.799889619815508,0.0030187485106257794,1,0,0,0,0,0,1
829,0,0,5.799889619815508,0.0030187485106257794,1,0,0,0,0,0,1
830,0,0,5.850463431750746,0.0028703024788195863,13,16,14,5,11,4,9
831,0,0,5.121676134084166,0.005930632429180682,3,2,0,2,0,2,1
832,0,0,1.2105315363618319,0.22960701523113325,9,9,5,5,4,7,2
833,0,0,2.9584562116126056,0.049338365718766486,10,10,7,7,3,5,5
834,0,0,5.165837740549993,0.005675879277547202,9,8,4,7,1,4,5
835,0,0,5.407305055146868,0.004463693393272239,2,1,0,1,0,1,1
836,0,0,5.955702215817241,0.002584327683401444,7,8,5,3,5,1,6
837,0,0,4.3784259660168185,0.012389660091107646,9,9,6,6,3,7,2
838,0,0,3.1294629702488064,0.04190816450284096,13,15,9,8,7,7,6
839,0,0,3.9991347838767517,0.018001498395315285,8,9,4,4,5,3,5
840,0,0,4.03858208625626,0.017317269242102418,15,18,16,8,10,8,7
841,0,0,2.8835756111323065,0.05297147710278538,9,8,2,5,3,7,2
842,0,0,4.177336155898342,0.015107574887641362,16,18,11,7,11,6,10
843,0,0,4.876350718671545,0.007567090850389535,2,1,0,1,0,1,1
844,1,1,9.085949158158106,0.9998867669413888,34,44,33,13,31,25,9
845,0,0,3.828763564335854,0.0212740518821658,10,12,9,6,6,6,4
846,0,0,0.46403877930609294,0.3860281515684444,10,10,7,6,4,6,4
847,0,0,4.375851378823306,0.01242120272375935,18,20,16,15,5,10,8
848,0,0,2.597697972252199,0.0692867219621075,19,22,16,12,10,15,4
849,0,0,2.8907139268637163,0.052614520502212714,11,11,4,6,5,8,3
850,0,0,5.342650072071191,0.0047604082521656155,5,4,1,2,2,3,2
851,0,0,5.514260698752805,0.004012737873124839,2,1,0,1,0,1,1
852,0,0,5.6585503336017995,0.003475448181518237,4,3,0,2,1,2,2
853,0,0,4.964677528451384,0.006931815793170704,6,5,2,3,2,4,2
854,0,0,2.8506196483036232,0.05464929564478804,9,11,8,5,6,6,3
855,1,1,8.490750992078036,0.9997946831844273,42,63,54,19,44,32,10
856,0,0,5.091404793616259,0.0061117915143070745,3,2,1,1,1,2,1
857,0,0,5.511736475162666,0.004022838916481142,6,5,1,2,3,3,3
858,0,0,4.8595902461880085,0.00769400364136108,8,7,1,4,3,4,4
859,0,0,5.091404793616259,0.0061117915143070745,3,2,1,1,1,2,1
860,0,0,3.809297714866651,0.021683158887902065,15,17,14,9,8,9,6
861,0,0,3.2495149885869132,0.03734431945724781,7,7,6,3,4,5,2
862,0,0,3.1542506758692133,0.04092411606307955,7,6,3,3,3,6,1
863,0,0,5.799889619815508,0.0030187485106257794,1,0,0,0,0,0,1
864,0,0,5.407305055146868,0.004463693393272239,2,1,0,1,0,1,1
865,0,0,3.3408878314959143,0.03419482445018096,12,12,7,7,5,7,5
866,0,0,3.882236971409594,0.020188699777533792,5,4,1,3,1,4,1
867,0,0,5.799889619815508,0.0030187485106257794,1,0,0,0,0,0,1
868,0,0,5.799889619815508,0.0030187485106257794,1,0,0,0,0,0,1
869,0,0,2.7811138360233087,0.05835332212880606,13,16,12,9,7,8,5
870,0,0,5.407305055146868,0.004463693393272239,2,1,0,1,0,1,1
871,0,0,5.375767320828881,0.004606052800751992,3,2,1,2,0,1,2
872,1,0,0.4347275247546447,0.39299800915904304,17,22,16,10,12,12,5
873,0,0,5.799889619815508,0.0030187485106257794,1,0,0,0,0,0,1
874,0,0,5.407305055146868,0.004463693393272239,2,1,0,1,0,1,1
875,0,0,5.799889619815508,0.0030187485106257794,1,0,0,0,0,0,1
876,0,0,5.407305055146868,0.004463693393272239,2,1,0,1,0,1,1
877,0,0,5.799889619815508,0.0030187485106257794,1,0,0,0,0,0,1
878,1,1,4.099171307598914,0.9836842057857252,50,72,65,23,49,33,17
879,1,1,4.171872085766141,0.9848109075998489,34,42,31,15,27,24,10
880,0,0,5.055422447402633,0.006334294173789723,13,14,10,9,5,8,5
881,0,0,3.149688618842243,0.0411035492386721,11,11,5,5,6,8,3
882,0,0,5.407305055146868,0.004463693393272239,2,1,0,1,0,1,1
883,0,0,4.218751149602885,0.014503563259857355,4,4,2,2,2,3,1
884,0,0,5.091404793616259,0.0061117915143070745,3,2,1,1,1,2,1
885,0,0,5.799889619815508,0.0030187485106257794,1,0,0,0,0,0,1
886,0,0,1.1715541067148347,0.2365741870691107,29,38,34,20,18,18,11
887,0,0,3.5671148833216484,0.02746176056679428,8,8,4,4,4,6,2
888,0,0,2.6135722032299915,0.06827002789159742,18,18,11,13,5,10,8
889,0,0,5.143706984246117,0.00580215408610929,7,6,2,3,3,5,2
890,0,0,4.6011436655991185,0.009940539913229407,9,9,5,7,2,4,5
891,0,0,5.375767320828881,0.004606052800751992,3,2,1,2,0,1,2
892,0,0,4.794365955379737,0.008208310685372311,7,7,5,5,2,4,3
893,0,0,5.6585503336017995,0.003475448181518237,4,3,0,2,1,2,2
894,1,0,0.0605119170113948,0.4848766352243229,34,44,40,20,24,20,14
895,0,0,3.2006975171893464,0.039139482426817085,17,21,16,12,9,10,7
896,0,0,5.121676134084166,0.005930632429180682,3,2,0,2,0,2,1
897,1,1,3.68471488107566,0.9755104620539148,30,36,26,13,23,21,9
898,0,0,5.404717477235538,0.004475206747797444,14,16,11,7,9,6,8
899,0,0,5.6585503336017995,0.003475448181518237,4,3,0,2,1,2,2
900,1,0,3.0487125227001988,0.04527309010931857,23,32,27,18,14,11,12
901,0,0,4.726046862878943,0.008783597096493123,6,6,4,3,3,4,2
902,0,0,5.6015987522649855,0.003678376067530742,8,8,4,5,3,4,4
903,0,0,3.4082132274238206,0.03203976474792547,6,6,3,3,3,5,1
904,1,1,2.9827828428275067,0.951790224336176,26,37,30,12,25,19,7
905,0,0,5.799889619815508,0.0030187485106257794,1,0,0,0,0,0,1
906,0,0,3.5676088201952654,0.027448571770872898,8,10,6,4,6,3,5
907,0,0,3.946540893243073,0.018955180153483853,5,4,2,3,1,3,2
908,0,0,3.33824224760085,0.03428230403518229,11,13,9,8,5,5,6
909,0,0,2.417055761863187,0.08188132147578986,8,8,4,5,3,6,2
910,0,0,2.293023404881725,0.09170241017035419,21,26,22,11,15,14,7
911,0,0,5.342650072071191,0.0047604082521656155,5,4,1,2,2,3,2
912,0,0,2.9463967382334726,0.04990708832839241,15,17,12,10,7,9,6
913,0,0,3.7512797734183954,0.022948657283788365,6,5,1,4,1,5,1
914,0,0,4.690335573730671,0.009100032766826138,7,6,2,4,2,5,2
915,0,0,5.576391458238344,0.0037719223052550266,3,2,0,1,1,1,2
916,0,0,5.799889619815508,0.0030187485106257794,1,0,0,0,0,0,1
917,0,0,2.88986967727584,0.05265661906199215,8,8,3,7,1,6,2
918,0,0,5.799889619815508,0.0030187485106257794,1,0,0,0,0,0,1
919,0,0,5.799889619815508,0.0030187485106257794,1,0,0,0,0,0,1
920,0,0,5.799889619815508,0.0030187485106257794,1,0,0,0,0,0,1
921,0,0,6.220221301361915,0.001984857548593899,4,3,0,1,2,1,3
922,1,1,2.3159416527203387,0.9101887420701431,49,76,69,30,46,29,20
923,0,0,3.0137288937458324,0.04680948711526933,24,32,29,14,18,15,9
924,0,0,5.280577789981994,0.0050637175508434495,5,4,1,3,1,3,2
925,0,0,4.805775872553557,0.008115942606363946,4,3,1,2,1,3,1
926,0,0,5.799889619815508,0.0030187485106257794,1,0,0,0,0,0,1
927,1,1,0.5022372470210792,0.6229849483334242,36,48,41,24,24,20,16
928,1,1,12.7282659395273,0.9999970339187049,47,64,51,23,41,33,14
929,0,0,6.336763819333141,0.0017668936472347019,2,1,0,0,1,0,2
930,0,0,4.140157050334374,0.01567086533492601,7,9,7,4,5,4,3
931,0,0,4.3452265502226055,0.012802539257508072,5,4,1,4,0,3,2
932,0,0,4.378164860880503,0.012392855421199722,8,7,3,4,3,6,2
933,0,0,5.514260698752805,0.004012737873124839,2,1,0,1,0,1,1
934,1,1,3.3272781523439487,0.9653528480380232,32,39,30,11,28,23,9
935,0,0,5.208361967321795,0.005440862487363307,4,3,1,2,1,3,1
936,0,0,4.876350718671545,0.007567090850389535,2,1,0,1,0,1,1
937,0,0,5.407305055146868,0.004463693393272239,2,1,0,1,0,1,1
938,0,0,3.6699411398175696,0.024844970147822165,11,11,7,7,4,9,2
939,1,1,5.385205245223491,0.9954370168534908,42,58,51,20,38,27,15
940,0,0,5.673162354650634,0.0034252067611814097,4,3,1,2,1,2,2
941,0,0,3.581054216465279,0.027091916365288404,8,7,1,4,3,5,3
942,0,0,4.964677528451384,0.006931815793170704,6,5,2,3,2,4,2
943,0,0,5.799889619815508,0.0030187485106257794,1,0,0,0,0,0,1
944,0,0,5.799889619815508,0.0030187485106257794,1,0,0,0,0,0,1
945,0,0,4.765734440626311,0.008444710501973929,8,7,3,4,3,6,2
946,0,0,5.799889619815508,0.0030187485106257794,1,0,0,0,0,0,1
947,1,0,1.7528683315775115,0.14768578269507726,37,50,44,26,24,19,18
948,1,1,5.151216635140104,0.9942410048765022,43,65,58,22,43,28,15
949,1,1,4.618203529887077,0.9902259625329369,25,33,25,12,21,15,10
950,0,0,5.514260698752805,0.004012737873124839,2,1,0,1,0,1,1
951,0,0,4.805775872553557,0.008115942606363946,4,3,1,2,1,3,1
952,0,0,6.336763819333141,0.0017668936472347019,2,1,0,0,1,0,2
953,0,0,4.967068692797474,0.006915374969687749,16,20,16,13,7,7,9
954,1,1,7.411514919805914,0.9993961102995902,47,63,54,25,38,31,16
955,0,0,5.673162354650634,0.0034252067611814097,4,3,1,2,1,2,2
956,0,0,5.209600908671765,0.005434162360434147,9,9,6,6,3,5,4
957,0,0,5.581928026244115,0.0037511746270362245,9,8,5,6,2,4,5
958,0,0,4.8924617057911854,0.007447054986768342,5,4,2,2,2,4,1
959,0,0,3.50288164329965,0.029230350401160288,9,9,4,7,2,6,3
960,0,0,4.797454114186533,0.008183208331022263,3,2,0,1,1,1,2
961,0,0,4.9724891463848975,0.0068782490387316875,5,4,3,2,2,3,2
962,0,0,4.471852397076339,0.011297048948392896,8,7,2,4,3,5,3
963,0,0,6.051134898270439,0.002349653715585154,3,2,0,1,1,1,2
964,0,0,5.683347101844282,0.0033906166223451883,3,2,0,1,1,1,2
965,1,0,1.0702666096870566,0.2553523856885773,10,10,5,6,4,8,2
966,0,0,3.975640677784248,0.018421551563499006,8,10,7,6,4,6,2
967,0,0,5.121676134084166,0.005930632429180682,3,2,0,2,0,2,1
968,0,0,6.336763819333141,0.0017668936472347019,2,1,0,0,1,0,2
969,1,1,1.833943375674095,0.8622308252650984,20,25,17,6,19,17,3
970,0,0,5.209815672930047,0.005433001761877443,3,2,0,1,1,1,2
971,0,0,1.1081681679301942,0.24821255638884776,17,22,16,10,12,11,6
972,0,0,6.34760078680134,0.0017478825437210466,6,6,2,3,3,2,4
973,0,0,5.799889619815508,0.0030187485106257794,1,0,0,0,0,0,1
974,0,0,3.7470058643641138,0.023044682580065645,8,7,2,5,2,5,3
975,1,1,6.485113708709169,0.9984763378502546,61,91,81,29,62,40,21
976,0,0,3.6376906868359544,0.025638414310832913,20,25,20,12,13,10,10
977,0,0,5.799889619815508,0.0030187485106257794,1,0,0,0,0,0,1
978,0,0,3.4353795118877866,0.03120787756662735,7,6,2,4,2,6,1
979,0,0,4.628367711095057,0.009676151962998425,2,1,0,1,0,1,1
980,0,0,5.143706984246117,0.00580215408610929,7,6,2,3,3,5,2
981,0,0,5.799889619815508,0.0030187485106257794,1,0,0,0,0,0,1
982,0,0,4.628367711095057,0.009676151962998425,2,1,0,1,0,1,1
983,0,0,5.810726587283707,0.002986308220212841,5,5,2,3,2,2,3
984,0,0,5.342650072071191,0.0047604082521656155,5,4,1,2,2,3,2
985,0,0,3.561605302137544,0.02760929204805951,13,16,13,7,9,8,5
986,0,0,5.799889619815508,0.0030187485106257794,1,0,0,0,0,0,1
987,0,0,1.8982908260043736,0.1303020414466728,17,18,11,12,6,9,8
988,0,0,5.310810221423775,0.0049136609984561375,8,8,3,4,4,4,4
989,0,0,5.799889619815508,0.0030187485106257794,1,0,0,0,0,0,1
990,0,0,2.9168706695948057,0.051325858994397455,12,14,8,9,5,8,4
991,0,0,5.9393569027136275,0.002626804571313035,7,7,4,3,4,3,4
992,0,0,5.514260698752805,0.004012737873124839,2,1,0,1,0,1,1
993,0,0,4.974862275645032,0.006862057294013013,5,4,1,2,2,3,2
994,0,0,5.121676134084166,0.005930632429180682,3,2,0,2,0,2,1
995,0,0,2.004133481843703,0.11876961559212817,29,42,35,19,23,15,14
996,0,0,4.970792099969046,0.006889851165279404,4,3,1,3,0,2,2
997,0,0,5.23899702471017,0.005277574956774833,10,11,8,9,2,6,4
998,0,0,6.137820731508068,0.0021549709673026607,4,3,1,1,2,2,2
999,0,0,4.784105118668238,0.008292266403375104,7,7,4,6,1,4,3
1000,0,0,5.306650187116029,0.004934043506583219,8,8,5,6,2,3,5
1001,0,0,5.514260698752805,0.004012737873124839,2,1,0,1,0,1,1
1002,0,0,2.6762658008359637,0.06438846865216619,7,8,5,3,5,6,1
1003,0,0,6.288808578096332,0.0018535291154718747,6,5,3,3,2,2,4
1004,1,1,8.671611204070258,0.9998286466179445,52,75,64,25,50,37,15
1005,0,0,4.805775872553557,0.008115942606363946,4,3,1,2,1,3,1
1006,0,0,4.1345423336820755,0.01575770989813352,10,12,8,7,5,7,3
1007,0,0,5.514260698752805,0.004012737873124839,2,1,0,1,0,1,1
1008,0,0,4.26126959884695,0.01390821728904601,7,9,7,5,4,5,2
1009,0,0,4.348230413935319,0.01276463003042072,4,3,2,2,1,2,2
1010,0,0,3.0413724233208046,0.045591415493903,7,7,3,3,4,5,2
1011,1,1,12.7282659395273,0.9999970339187049,47,64,51,23,41,33,14
1012,0,0,5.091404793616259,0.0061117915143070745,3,2,1,1,1,2,1
1013,0,0,5.4132249181891785,0.004437463911351025,3,2,0,1,1,1,2
1014,1,1,5.088532404796678,0.9938707355635241,27,37,28,11,26,19,8
1015,0,0,5.342650072071191,0.0047604082521656155,5,4,1,2,2,3,2
1016,0,0,5.407305055146868,0.004463693393272239,2,1,0,1,0,1,1
1017,0,0,4.288085337056276,0.013545199035043587,7,6,1,4,2,5,2
1018,0,0,5.342650072071191,0.0047604082521656155,5,4,1,2,2,3,2
1019,0,0,4.342738790032355,0.012834019287163323,3,2,0,2,0,2,1
1020,0,0,3.477385905752061,0.029962564670045988,8,10,7,6,4,6,2
1021,0,0,5.799889619815508,0.0030187485106257794,1,0,0,0,0,0,1
1022,0,0,3.7922163955591373,0.02204848080682975,6,5,1,3,2,4,2
1023,0,0,5.514260698752805,0.004012737873124839,2,1,0,1,0,1,1
1024,0,0,2.5785262044211286,0.07053328935724013,14,15,11,6,9,10,4
1025,0,0,2.8414840014976965,0.055123193070351295,16,18,14,10,8,9,7
1026,0,0,3.3624034244220167,0.03349133794136183,10,9,6,3,6,5,5
1027,0,0,5.078999315968552,0.006187611383011493,2,1,0,1,0,1,1
1028,0,0,5.192567490491781,0.005527001567925405,7,6,4,2,4,2,5
1029,0,0,5.514260698752805,0.004012737873124839,2,1,0,1,0,1,1
1030,0,0,3.309897209696697,0.03523321306990701,6,6,2,3,3,4,2
1031,0,0,5.034419888303906,0.006467867884627498,9,10,8,8,2,4,5
1032,0,0,5.091404793616259,0.0061117915143070745,3,2,1,1,1,2,1
1033,0,0,4.856336184804421,0.007718887610581815,8,7,3,5,2,4,4
1034,0,0,3.3409929685814315,0.034191352411363396,10,12,7,7,5,7,3
1035,1,1,7.409898981728157,0.9993951342530828,43,60,52,20,40,29,14
1036,0,0,4.805775872553557,0.008115942606363946,4,3,1,2,1,3,1
1037,0,0,4.606832784728484,0.009884704982723203,6,5,2,3,2,5,1
1038,0,0,3.0030461268825457,0.04728844889902373,14,16,12,9,7,10,4
1039,0,0,5.799889619815508,0.0030187485106257794,1,0,0,0,0,0,1
1040,0,0,4.342738790032355,0.012834019287163323,3,2,0,2,0,2,1
1041,0,0,4.8796129895499885,0.007542631065824867,4,3,0,2,1,2,2
1042,0,0,5.364838074507993,0.004656433890479428,5,4,3,3,1,2,3
1043,1,1,2.845431857988708,0.9450820687910646,22,26,20,7,19,16,6
1044,0,0,3.651361709503466,0.02529910303854066,12,15,11,6,9,7,5
1045,0,0,2.3939391498382943,0.08363603574574907,13,15,13,5,10,10,3
1046,0,0,4.805775872553557,0.008115942606363946,4,3,1,2,1,3,1
1047,0,0,4.599317736967322,0.009958526291209524,5,4,2,4,0,2,3
1048,0,0,2.125785342151924,0.10661576789901261,8,8,5,3,5,7,1
1049,0,0,4.200317470359477,0.014769411382788755,8,8,5,3,5,3,5
1050,1,1,1.2526939010008658,0.7777658399571082,33,44,37,20,24,21,12
1051,0,0,5.280577789981994,0.0050637175508434495,5,4,1,3,1,3,2
1052,0,0,4.876350718671545,0.007567090850389535,2,1,0,1,0,1,1
1053,0,0,4.805775872553557,0.008115942606363946,4,3,1,2,1,3,1
1054,0,0,3.0595209497492486,0.04480820213473091,18,22,17,14,8,9,9
1055,0,0,2.0274885856371387,0.11634687260340149,24,30,25,11,19,14,10
1056,1,1,7.734700985259616,0.9995628080754985,39,56,47,18,38,28,11
1057,0,0,4.68704907930179,0.009129715679166095,3,2,1,1,1,2,1
1058,0,0,5.078999315968552,0.006187611383011493,2,1,0,1,0,1,1
1059,0,0,3.844484018000168,0.020949180584641236,3,2,0,2,0,2,1
1060,0,0,2.9034688615642503,0.051982351023720175,42,61,54,34,27,19,23
1061,0,0,2.314632762659709,0.08991831086482449,7,7,3,4,3,6,1
1062,0,0,5.330244594423483,0.0048195448217384085,4,3,0,2,1,2,2
1063,0,0,2.557136878320944,0.07194848419575772,18,18,10,8,10,10,8
1064,0,0,4.436845356099791,0.011694821986450221,5,5,2,2,3,3,2
1065,0,0,4.628367711095057,0.009676151962998425,2,1,0,1,0,1,1
1066,1,1,8.591730382287793,0.9998143998630343,52,73,61,25,48,33,19
1067,0,0,4.79337039490585,0.0082164194472506,3,2,0,2,0,2,1
1068,0,0,4.737811114891246,0.008681761936126242,4,3,1,3,0,2,2
1069,0,0,4.805775872553557,0.008115942606363946,4,3,1,2,1,3,1
1070,0,0,5.799889619815508,0.0030187485106257794,1,0,0,0,0,0,1
1071,0,0,5.016005926720618,0.006587278453385359,2,1,0,1,0,1,1
1072,0,0,5.514260698752805,0.004012737873124839,2,1,0,1,0,1,1
1073,0,0,5.078999315968552,0.006187611383011493,2,1,0,1,0,1,1
1074,0,0,5.091404793616259,0.0061117915143070745,3,2,1,1,1,2,1
1075,0,0,3.838180428316371,0.021078860348146544,5,4,1,3,1,4,1
1076,0,0,0.9378838286035549,0.2813279974682259,8,8,4,6,2,5,3
1077,0,0,4.824067908658061,0.007970007489834119,7,6,3,2,4,2,5
1078,1,1,8.591730382287793,0.9998143998630343,52,73,61,25,48,33,19
1079,0,0,5.158381188958268,0.005718117037592951,6,5,2,4,1,2,4
1080,0,0,2.9780002973796176,0.0484297003724079,12,13,9,6,7,7,5
1081,0,0,5.688071852282985,0.00337468852463918,8,9,6,6,3,3,5
1082,0,0,5.799889619815508,0.0030187485106257794,1,0,0,0,0,0,1
1083,0,0,5.799889619815508,0.0030187485106257794,1,0,0,0,0,0,1
1084,0,0,5.944179254664502,0.0026142007247450527,3,2,0,1,1,1,2
1085,0,0,5.799889619815508,0.0030187485106257794,1,0,0,0,0,0,1
1086,0,0,1.3535634611577443,0.20528840010367377,45,63,56,30,33,26,19
1087,1,1,4.836447055607814,0.9921272742910026,35,49,41,16,33,25,10
1088,1,1,3.507369327751957,0.9708967231729707,16,18,10,2,16,14,2
1089,1,1,2.373492650052965,0.9147835235308712,48,74,67,33,41,27,21
1090,0,0,5.375465204499454,0.0046074381622328575,5,5,2,3,2,2,3
1091,0,0,5.683347101844282,0.0033906166223451883,3,2,0,1,1,1,2
1092,0,0,5.065697895244713,0.006269945731511406,7,7,5,4,3,3,4
1093,0,0,1.1186233208217615,0.2462667326830067,14,15,10,8,7,10,4
1094,0,0,4.342738790032355,0.012834019287163323,3,2,0,2,0,2,1
1095,0,0,1.4756225794907172,0.1860895134540963,13,14,7,9,5,9,4
1096,0,0,4.225823233446171,0.014402826776666044,6,5,1,3,2,4,2
1097,0,0,3.7995428029024945,0.02189105822756343,19,22,19,12,10,10,9
1098,0,0,2.768778050827964,0.05903485586117896,8,9,7,5,4,4,4
1099,0,0,5.342650072071191,0.0047604082521656155,5,4,1,2,2,3,2
1100,0,0,5.7143689412622924,0.003287388674667713,9,9,7,3,6,4,5
1101,0,0,5.260491196707735,0.00516592803824234,4,3,1,1,2,2,2
1102,0,0,3.6024185017645505,0.026534451186174146,10,11,7,5,6,6,4
1103,1,1,1.0671297003874107,0.7440506810904279,13,16,11,5,11,8,5
1104,0,0,5.342650072071191,0.0047604082521656155,5,4,1,2,2,3,2
1105,0,0,4.235783146426417,0.014262123648392744,3,2,0,2,0,2,1
1106,0,0,5.586740210502259,0.003733233875156561,7,7,5,4,3,2,5
1107,0,0,5.576391458238344,0.0037719223052550266,3,2,0,1,1,1,2
1108,0,0,4.876350718671545,0.007567090850389535,2,1,0,1,0,1,1
1109,1,0,0.28616282397409964,0.4289435297311144,10,9,3,6,3,8,2
1110,0,0,5.407305055146868,0.004463693393272239,2,1,0,1,0,1,1
1111,1,1,14.578851872180117,0.999999533893803,52,76,67,22,54,38,14
1112,0,0,3.7564004741707784,0.02283412089150727,10,10,5,6,4,7,3
1113,0,0,3.5135183846652365,0.028930029572670768,14,14,9,10,4,9,5
1114,0,0,6.505850222424617,0.0014924387143764317,3,2,0,0,2,0,3
