,y_true,y_pred,default_final_strength,predicted_prob,num_args,num_rels,num_rels_not_flat,num_atts,num_supp,num_pos_args,num_neg_args
0,1,1,1.9858132786816816,0.8792994980395322,15,15,2,5,10,9,6
1,0,0,4.599097977248854,0.009960693213429073,16,16,2,5,11,5,11
2,0,0,1.217418815743892,0.22839101001722695,10,10,2,5,5,4,6
3,0,1,0.08918196493226249,0.5222807258539972,9,8,1,4,4,4,5
4,0,0,6.197298051383745,0.002030788972150699,18,18,4,6,12,6,12
5,1,1,5.1557114356249025,0.9942666842455808,20,24,12,7,17,14,6
6,0,0,2.5735514249635383,0.0708601252740716,13,12,0,6,6,6,7
7,1,1,6.251362356312601,0.9980758834014184,20,25,11,3,22,17,3
8,1,1,1.6565234107121574,0.8397707600953795,12,13,4,4,9,9,3
9,1,1,2.2965476423587976,0.9085907123288118,22,25,8,6,19,15,7
10,1,1,3.462237501871239,0.9695940009449635,14,14,4,3,11,11,3
11,1,1,4.389597700827247,0.9877462969696563,14,20,11,1,19,13,1
12,0,0,1.0689588072606886,0.2556011406629344,9,8,0,4,4,4,5
13,0,0,1.6301643296033586,0.16380785095884998,19,19,6,10,9,8,11
14,1,1,4.006170439405548,0.9821224531616922,19,27,14,6,21,15,4
15,1,1,2.2593350378653825,0.9054527202563417,16,19,8,8,11,9,7
16,1,1,5.153774726694374,0.9942556335683274,29,40,22,11,29,18,11
17,0,0,2.935630413700734,0.050420069236815745,23,26,10,10,16,11,12
18,0,1,0.4008340507238488,0.5988880332569181,15,16,4,7,9,9,6
19,0,0,4.925753357342325,0.007204968603897299,20,21,9,4,17,3,17
20,0,0,1.9436523552542067,0.12524715535168662,16,16,5,6,10,7,9
21,0,0,2.1800968686018605,0.10155208933670878,15,15,2,8,7,7,8
22,1,0,0.5728509413821573,0.36057924559313514,4,4,2,2,2,1,3
23,1,1,4.934852054754346,0.9928598239342863,16,16,4,4,12,12,4
24,0,1,0.9720008930528112,0.7255181385208761,20,21,6,9,12,12,8
25,0,0,3.199627284850025,0.03917975113651817,22,26,12,11,15,9,13
26,1,0,1.9284754019996069,0.1269194261044705,16,18,7,8,10,6,10
27,0,1,0.45745541801692413,0.6124103572470605,19,22,9,8,14,10,9
28,0,0,3.295305668352831,0.035732584023392966,16,15,2,5,10,4,12
29,1,1,1.8654870066066769,0.865935222380809,30,37,17,10,27,19,11
30,1,1,5.95748352528039,0.9974202598410423,29,37,19,6,31,22,7
31,1,1,4.6312259500008,0.9903511988303088,26,34,17,10,24,17,9
32,1,1,4.7423512246213155,0.9913572249813716,17,22,12,3,19,15,2
33,0,0,3.2002232848622487,0.03915732105696845,22,24,6,9,15,9,13
34,1,1,3.8425339513255565,0.9790107855524385,23,33,18,7,26,17,6
35,1,1,4.1940062529980615,0.9851384705561193,25,31,14,9,22,18,7
36,1,0,0.8213288743349771,0.30548164958743285,26,31,14,9,22,11,15
37,1,1,0.8997629107066467,0.7109007782656869,7,6,1,2,4,5,2
38,0,0,5.401047565925204,0.0044915866295546225,17,16,1,3,13,3,14
39,1,1,6.374197312358557,0.9982979142161961,28,40,20,11,29,21,7
40,0,0,2.362810462164278,0.08605290052907144,13,13,4,5,8,4,9
41,0,0,6.14923770909084,0.0021305597471203974,44,53,27,18,35,13,31
42,0,0,1.2634472414306206,0.22038103963940303,25,29,11,10,19,12,13
43,0,0,2.63646336822792,0.06682825024595418,13,14,5,6,8,5,8
44,0,0,4.045470289060313,0.01720043896879686,14,14,2,5,9,4,10
45,0,0,2.2509276520590555,0.09526947757030912,19,21,6,8,13,8,11
46,0,0,2.698544248740529,0.06305931127847508,21,22,5,9,13,8,13
47,0,0,2.435559385167652,0.0805009973812214,20,20,2,9,11,8,12
48,1,1,4.270154881138003,0.9862131175409786,23,29,11,10,19,14,9
49,0,1,3.0804912079749167,0.9560808151906497,30,34,13,11,23,18,12
50,1,1,5.128978520406387,0.9941122635431221,28,31,10,11,20,17,11
51,0,0,0.9144197341984119,0.2860962750134417,26,28,10,9,19,11,15
52,1,1,1.2110073988265775,0.7704771481233879,15,19,9,6,13,8,7
53,0,0,3.4320975899074906,0.03130725582651872,11,11,4,4,7,2,9
54,0,1,1.7891991629371216,0.8568290634901242,12,11,1,3,8,9,3
55,0,0,5.640275657396677,0.0035393179018260446,20,20,4,7,13,5,15
56,1,1,3.5855803757388265,0.9730271288748529,13,15,6,3,12,11,2
57,0,1,2.24390071424996,0.9041231231901676,13,13,3,3,10,9,4
58,0,0,4.904296925895173,0.0073600818397221435,18,17,1,5,12,5,13
59,1,1,0.6632895553238594,0.6599989538270303,10,9,0,3,6,7,3
60,1,1,7.7788958428492,0.9995817010665707,35,44,18,13,31,24,11
61,0,0,0.1554750968955636,0.46120933328184477,18,19,5,8,11,10,8
62,0,0,3.6289191492591932,0.02585845098107431,21,21,6,6,15,6,15
63,1,0,1.1164719052278382,0.24666629517855276,24,27,8,12,15,12,12
64,0,0,1.6237049105149461,0.16469455132878996,17,17,4,7,10,7,10
65,1,1,3.391361292802727,0.9674334608309145,13,15,5,2,13,11,2
66,0,0,1.9535785620582038,0.1241636764041345,13,12,1,5,7,5,8
67,0,0,0.8344145377476846,0.30271244930862484,7,6,0,2,4,2,5
68,0,0,0.7785503125132904,0.31463241097628525,19,20,5,6,14,8,11
69,1,1,0.022277966719102427,0.5055692613426934,10,9,1,3,6,7,3
70,0,0,3.2362203562185607,0.0378252085728541,15,19,10,6,13,4,11
71,0,0,3.986019190471626,0.018234820214234504,20,19,1,8,11,8,12
72,0,0,3.173051943762077,0.04019251499508081,17,17,4,6,11,7,10
73,1,1,5.941092056357062,0.9973777374444869,26,39,24,10,29,19,7
74,1,1,0.6372654454527797,0.6541350494993916,26,31,16,11,20,14,12
75,0,1,0.6506454600940828,0.6571559008862351,10,9,1,4,5,6,4
76,0,0,3.3150627625621616,0.035058047378919044,16,16,3,6,10,5,11
77,0,0,0.6013981118104414,0.35402389300311743,16,17,9,3,14,6,10
78,1,1,1.8999141197892704,0.8698818053837152,23,29,15,10,19,14,9
79,0,0,4.113687717025826,0.01608444028955225,16,18,8,8,10,4,12
80,0,0,1.4514562770034232,0.1897775447431056,33,40,17,11,29,13,20
81,0,0,2.4241721559702367,0.08134792332384833,20,19,3,6,13,7,13
82,0,0,7.724553265756843,0.0004416490426883968,30,31,10,10,21,9,21
83,0,1,0.6981179328399443,0.6677703616461799,17,17,4,8,9,8,9
84,1,1,1.1170736155073193,0.7534454988049395,13,15,7,4,11,9,4
85,1,0,1.82704972826716,0.13859010973831032,23,31,14,12,19,10,13
86,1,1,5.089831171219203,0.9938786421818685,17,24,13,2,22,15,2
87,0,0,0.7856088377828727,0.31311231389493377,19,20,5,10,10,9,10
88,1,1,4.309548719642514,0.9867386146312283,22,30,18,7,23,17,5
89,1,1,2.507482785746369,0.9246647290406915,26,32,14,11,21,15,11
90,1,1,3.8285162017760666,0.9787207970566013,16,18,6,5,13,12,4
91,1,1,0.5929603198403381,0.6440440918830976,7,7,3,2,5,5,2
92,0,0,0.32571270850067435,0.4192841514083322,28,36,19,12,24,12,16
93,0,0,5.501196615803762,0.004065290025324186,24,24,3,10,14,8,16
94,1,1,1.367995108228595,0.7970560400082725,16,17,5,6,11,11,5
95,0,0,1.2569661402692305,0.2214965963595673,15,14,3,5,9,6,9
96,1,0,6.4324738408943,0.0016058838067997128,28,31,11,13,18,10,18
97,0,1,0.3831878581705226,0.5946417448920297,31,39,20,16,23,17,14
98,0,1,0.206890638954905,0.5515389524430541,15,16,6,7,9,7,8
99,1,1,0.11435300121236791,0.5285571378729703,15,16,6,7,9,8,7
100,1,1,2.370862298711497,0.9145782516302303,20,23,9,8,15,12,8
101,1,0,0.8547553118838043,0.2984362747138327,10,9,1,3,6,4,6
102,1,1,5.1040953928366655,0.9939648155566003,24,32,18,6,26,18,6
103,0,0,3.6364866114869434,0.025668510607081974,18,18,3,7,11,7,11
104,0,0,2.1494659740277315,0.10438113637231305,28,30,11,10,20,10,18
105,1,1,2.0282318085810958,0.8837295165688528,19,23,10,7,16,12,7
106,0,0,0.7934355460990288,0.3114314674940144,20,20,5,9,11,9,11
107,0,0,4.937039760780539,0.007124683703930712,12,12,2,2,10,2,10
108,1,1,3.9574506540668213,0.9812466353175452,18,19,4,6,13,12,6
109,1,1,0.08503900757695515,0.5212469492592776,12,13,6,4,9,7,5
110,0,0,2.4549335343987915,0.07907851709882652,15,14,2,6,8,5,10
111,0,0,3.570163939390075,0.02738044478194046,22,22,6,9,13,7,15
112,1,1,5.904467736748007,0.9972801845700053,32,46,27,12,34,20,12
113,0,0,0.9590704819899565,0.27706433845904643,15,15,3,8,7,7,8
114,0,0,6.860483958168109,0.0010473084201019223,29,29,6,7,22,8,21
115,1,1,6.442137455034345,0.9984095355295616,29,39,21,12,27,19,10
116,0,0,5.232711191212962,0.0053106766649816395,35,40,16,12,28,11,24
117,0,0,2.809585172289762,0.056808403693059284,25,26,6,13,13,11,14
118,1,1,3.5333085845175036,0.9716207851680653,17,18,6,6,12,11,6
119,0,0,2.3645142413046,0.08591899652144142,18,18,8,6,12,7,11
120,0,0,2.787130338011539,0.05802360321569522,30,35,14,13,22,10,20
121,1,1,6.121065765193944,0.9978086981756771,18,21,10,6,15,14,4
122,1,1,5.235797858092594,0.9947056036985549,16,23,14,2,21,15,1
123,0,1,0.13726283436929387,0.5342619311453989,15,19,10,6,13,9,6
124,0,0,3.3663339239188717,0.03336434200147498,9,9,4,1,8,2,7
125,1,1,4.342505410401955,0.9871630236184042,20,23,9,6,17,15,5
126,1,1,1.5420610373515453,0.8237641396811478,9,10,5,4,6,6,3
127,0,0,2.4050060168551197,0.08279175836137531,24,27,11,11,16,8,16
128,1,1,1.7621850461259427,0.8534831106383868,34,52,33,17,35,20,14
129,1,1,2.386532659151514,0.9157945697430833,17,22,12,6,16,12,5
130,0,1,0.5023421829015207,0.6230095947990242,12,11,1,4,7,7,5
131,0,0,3.810509599020534,0.021657466086293264,13,14,6,4,10,3,10
132,0,0,1.6973872620342343,0.15480681182845935,30,35,15,13,22,13,17
133,1,1,4.316153865665691,0.986824769110277,11,10,0,2,8,9,2
134,0,0,6.295292384613413,0.0018415721284716913,19,19,5,7,12,5,14
135,1,1,0.4869847643969587,0.6193958630959068,9,8,1,3,5,6,3
136,0,1,3.8287163832184135,0.9787249657155842,19,22,7,4,18,15,4
137,1,1,3.2919112177891505,0.9641502730838704,21,25,14,8,17,12,9
138,0,0,3.19687099620928,0.0392836426831048,22,21,6,6,15,8,14
139,1,1,0.9387533238100669,0.7188477658647511,35,45,21,17,28,20,15
140,0,0,3.4631994899592726,0.03037765103619361,26,33,18,11,22,11,15
141,0,0,8.149386525807904,0.00028882909931315925,32,33,9,9,24,8,24
142,0,0,4.28206786605654,0.013625838644640509,27,30,11,12,18,9,18
143,1,1,6.428068632871465,0.9983870377719603,20,29,16,2,27,19,1
144,0,0,1.556221650657231,0.1741894842631685,9,8,3,4,4,2,7
145,1,1,3.2283428527581446,0.9618870478012106,10,9,1,2,7,8,2
146,1,1,2.761040322410989,0.9405338458568755,15,18,8,4,14,11,4
147,1,1,0.6942075698479648,0.6669022670705704,14,14,6,4,10,8,6
148,1,1,4.254129375457856,0.9859935154779236,21,28,16,6,22,14,7
149,1,1,8.637509691784919,0.9998227034855303,31,41,22,10,31,23,8
150,1,1,5.264892437483015,0.9948566418088548,19,20,4,3,17,16,3
151,0,1,1.4491284026850098,0.8098642580666454,20,21,7,8,13,11,9
152,0,0,6.0690702794550315,0.002307983842991246,21,22,6,6,16,6,15
153,1,0,0.07341793153676512,0.4816537571908718,14,15,5,9,6,6,8
154,1,1,0.22365276700940573,0.5556812842664224,18,19,4,7,12,10,8
155,0,0,1.3010862247263848,0.21398226387405084,24,27,8,12,15,10,14
156,0,0,4.059258170978652,0.016968905498665254,31,34,8,14,20,14,17
157,1,1,8.422201223970841,0.999780118354153,36,40,13,12,28,24,12
158,0,0,2.4480703564716135,0.07957977484901002,15,14,2,6,8,6,9
159,1,1,4.8316158587286715,0.9920894491817547,14,15,6,2,13,12,2
160,0,0,0.9464836366420601,0.27959254059084004,18,19,5,7,12,6,12
161,1,1,3.3539900753689764,0.9662352532516076,23,27,10,11,16,14,9
162,1,1,7.302287637532914,0.9993264588098647,23,30,16,5,25,18,5
163,0,0,1.9018490035631839,0.12989934674872705,19,18,5,8,10,6,13
164,0,1,2.756815954491178,0.940297137094499,18,17,1,7,10,11,7
165,0,0,0.11090424059664628,0.4723023235754483,26,35,18,11,24,13,13
166,0,0,6.572412855259573,0.0013964663099022001,27,29,9,9,20,6,21
167,0,0,4.322669811895712,0.013090781059468815,19,19,3,5,14,5,14
168,1,1,5.232174336990331,0.9946864866635954,22,29,15,4,25,17,5
169,1,1,1.3212428966100656,0.7893884178056515,12,11,1,4,7,8,4
170,0,0,5.400668283205871,0.0044932828777318745,23,25,8,9,16,7,16
171,1,1,4.786419475889632,0.9917267440819846,19,29,18,5,24,16,3
172,1,1,3.0660920069287947,0.9554722021955007,28,32,9,10,22,17,11
173,0,0,5.5925650903099235,0.003711631923809744,17,16,4,5,11,3,14
174,0,0,1.745855254898549,0.14857073448168168,21,24,9,10,14,10,11
175,1,1,5.380350796429291,0.9954149140435589,27,37,23,8,29,20,7
176,0,0,2.682620319040483,0.06400671401360358,37,41,12,14,27,15,22
177,0,1,1.3266063023001775,0.7902787233142718,9,9,3,1,8,8,1
178,1,1,3.4479552079666593,0.9691701020313456,13,22,16,4,18,11,2
179,0,0,3.997667677478661,0.018027451435028374,17,18,7,6,12,4,13
180,0,0,5.803432251607907,0.0030081052295461985,18,20,6,6,14,5,13
181,0,0,3.7076965647303446,0.023946468688608835,40,51,26,15,36,15,25
182,0,0,2.4776734221104855,0.07743825319064213,17,18,6,6,12,5,12
183,0,0,8.918326136087815,0.00013389427803123244,35,37,13,11,26,9,26
184,0,0,3.9853245996684636,0.01824725915712877,13,12,2,6,6,5,8
185,1,1,4.295405150258404,0.9865522588487468,25,36,20,9,27,15,10
186,1,1,1.1700982446984085,0.7631627734588136,16,19,8,6,13,12,4
187,1,0,0.3159543325118328,0.4216620231899558,9,8,1,3,5,4,5
188,0,0,7.460255708793515,0.0005751779698683901,22,21,5,6,15,7,15
189,1,1,5.273724896947831,0.9949016396872153,18,20,7,3,17,14,4
190,1,1,3.0084177258391724,0.9529529660783468,18,22,9,6,16,13,5
191,0,0,11.930362770787344,6.587284500092494e-06,28,29,9,7,22,4,24
192,0,0,6.107304759115586,0.0022215973210336637,13,13,3,3,10,2,11
193,1,1,3.68806618275402,0.9755903965256402,19,23,12,6,17,13,6
194,1,1,0.350744609224551,0.5867981330611864,14,14,5,4,10,9,5
195,0,0,1.4562920746982995,0.18903509792684536,22,26,9,10,16,10,12
196,1,1,1.8051781952488044,0.8587781051483391,15,17,6,6,11,10,5
197,1,1,5.180156225646754,0.9944043601334034,13,18,10,1,17,12,1
198,1,1,1.9010753128431075,0.8700131814231697,17,18,4,7,11,9,8
199,1,0,0.1928789642548283,0.45192919530209064,23,28,13,8,20,12,11
200,0,1,1.0201798385851082,0.7350076283624893,16,19,9,6,13,11,5
201,0,0,4.35186585162489,0.012718898411605672,15,14,4,4,10,3,12
202,1,1,8.864637374131274,0.9998587216729332,24,38,27,5,33,21,3
203,0,0,2.7056521815241936,0.06264065645965877,17,17,5,7,10,5,12
204,1,1,3.1571530840527067,0.9591896498571116,22,25,8,7,18,14,8
205,0,0,6.894777188703179,0.001012037413870348,19,19,3,3,16,4,15
206,0,0,1.6249120889166366,0.16452854670135442,11,10,1,5,5,4,7
207,0,0,4.147156747056648,0.0155632582322065,25,24,2,8,16,8,17
208,1,1,3.805779880051788,0.9782420915844677,29,34,17,12,22,17,12
209,0,0,2.1445300170087807,0.10484347974805719,14,15,4,5,10,6,8
210,0,0,5.249916663953835,0.005220558465155234,29,32,10,13,19,10,19
211,1,1,8.229141342499446,0.9997333058527845,34,51,34,11,40,25,9
212,1,1,4.948684065170851,0.9929572162391456,21,32,20,9,23,16,5
213,1,1,8.779389269654775,0.9998461516421326,21,25,11,3,22,18,3
214,1,1,6.058446183516157,0.9976674227002975,23,25,6,5,20,18,5
215,0,0,2.8948497130441666,0.0524087481736506,14,13,1,4,9,4,10
216,1,0,2.530995653887583,0.07371363455911484,20,22,8,5,17,7,13
217,0,0,8.586088664355433,0.00018665000388651265,22,22,7,4,18,2,20
218,1,1,4.616696933310467,0.9902113701546721,15,16,4,5,11,11,4
219,0,0,0.040892035095991375,0.4897784155287843,24,25,8,8,17,8,16
220,1,1,0.29962248473536546,0.5743502274749004,16,17,4,6,11,10,6
221,1,1,3.7581954206556327,0.9772058949698539,13,17,10,2,15,10,3
222,0,0,3.6659663162303104,0.024941453067885533,9,8,0,2,6,2,7
223,0,0,3.3518858724473333,0.033833463102586614,25,25,4,11,14,10,15
224,0,1,0.6961497558133045,0.667333571372226,22,25,7,9,16,13,9
225,0,0,2.3514521191800863,0.08695041946651749,14,13,2,5,8,4,10
226,0,0,6.187534244241796,0.0020506734589704756,30,32,11,11,21,9,21
227,1,1,2.732594325544264,0.9389227829461378,17,19,7,7,12,10,7
228,1,1,8.609856280129087,0.999817733118594,25,30,12,6,24,21,4
229,0,0,3.911122380844123,0.019625163674541812,15,15,5,3,12,3,12
230,0,0,0.356283580150186,0.4118595031519173,22,25,10,13,12,8,14
231,1,0,3.229350422350888,0.03807603152514816,15,17,7,5,12,4,11
232,0,1,0.04001415156403443,0.5100022033556944,22,26,10,10,16,14,8
233,1,1,3.292294684733756,0.9641635250774434,26,30,8,11,19,14,12
234,1,1,5.650704204060027,0.9964972716351164,19,22,10,6,16,14,5
235,0,0,2.63646336822792,0.06682825024595418,13,14,5,6,8,5,8
236,0,0,2.737855882592317,0.06077617955921988,25,26,9,10,16,11,14
237,1,1,4.243805058495691,0.9858502157926848,12,12,3,1,11,11,1
238,0,0,0.8542689321683326,0.29853811902151695,18,20,6,9,11,11,7
239,0,1,0.6462632631680103,0.6561679042139481,7,7,2,1,6,6,1
240,0,0,0.7246738379872495,0.32636460344689244,20,20,3,11,9,9,11
241,0,0,6.502264194403215,0.0014977922185226422,17,17,5,3,14,3,14
242,1,1,0.3199943992810139,0.5793228872100078,8,9,3,3,6,5,3
243,1,1,4.759705772832975,0.991504659181275,22,32,20,7,25,17,5
244,1,1,1.8417365190217727,0.8631539530544492,12,16,9,5,11,9,3
245,1,1,2.886504708416172,0.9471752702717087,26,35,19,10,25,17,9
246,1,0,2.195532953741744,0.10015234917415583,19,21,6,10,11,8,11
247,1,1,2.2615286895802367,0.9056403476381941,17,21,8,8,13,11,6
248,1,1,0.678470531871898,0.6633972505219755,23,25,8,9,16,13,10
249,0,0,3.6577397565725134,0.025142301676726264,33,43,23,16,27,13,20
250,0,0,1.3684954492913137,0.20286303799672656,17,17,3,9,8,7,10
251,1,1,0.43490868066382626,0.6070452048492876,7,6,0,2,4,5,2
252,1,1,6.076650723114169,0.9977094056300765,26,36,19,4,32,20,6
253,0,0,4.527438512275047,0.010692755254524955,18,19,6,5,14,6,12
254,1,0,0.5793749050850836,0.35907644067671773,11,11,3,5,6,4,7
255,1,0,0.003677636691963304,0.49908059186325937,21,21,5,11,10,11,10
256,1,1,0.09231622438143194,0.5230626795267844,19,19,2,9,10,9,10
257,1,1,3.124098467788569,0.9578759105868526,27,33,16,9,24,19,8
258,1,1,6.5003868588269365,0.9984993975052513,24,31,16,7,24,19,5
259,1,1,9.954234554796285,0.9999524763026439,28,34,15,7,27,22,6
260,0,0,3.284269915553109,0.03611478368106602,19,18,4,5,13,5,14
261,1,0,2.4633333691972195,0.07846895703356171,7,6,0,1,5,1,6
262,0,0,1.012255185476906,0.26653873932497874,11,10,1,5,5,5,6
263,0,0,0.751329281604177,0.32053172603101665,15,16,4,7,9,7,8
264,0,1,0.6072122979399524,0.6473046275977554,18,23,10,7,16,10,8
265,1,0,0.508357572535195,0.37557862772386086,14,14,4,6,8,7,7
266,1,1,5.38459257003834,0.9954342331384562,31,41,20,13,28,20,11
267,0,0,1.2569470482198601,0.2214998885309134,7,6,0,2,4,2,5
268,0,0,7.162414304594766,0.0007745803299152865,17,16,6,2,14,1,16
269,1,1,4.3941260218977245,0.9878009848481808,10,11,3,1,10,9,1
270,0,0,3.368012490239921,0.03331024866884558,23,26,12,9,17,6,17
271,1,1,2.0171763206791504,0.8825887188494435,17,18,4,6,12,11,6
272,0,0,1.9886546192018786,0.12039926996480399,13,12,1,4,8,4,9
273,0,0,7.3981847180139635,0.0006119886055785395,25,31,16,9,22,6,19
274,1,1,2.1119903068960255,0.892063122533612,16,19,8,6,13,9,7
275,0,0,9.007305939553437,0.00012249645789808028,30,31,7,9,22,7,23
276,1,1,1.7960212627260406,0.8576639155323792,16,17,5,7,10,10,6
277,1,1,1.491531176498055,0.8163079825725879,10,10,2,4,6,6,4
278,0,0,3.3905436583479003,0.03259230937493662,22,25,11,8,17,8,14
279,1,1,2.387960552835226,0.915904616232671,16,18,8,5,13,11,5
280,0,0,2.9721614864903874,0.048699488243058586,18,19,5,8,11,6,12
281,1,1,2.863324419196048,0.9460033661685214,24,25,8,9,16,13,11
282,0,0,0.6815330113009281,0.33591923628702813,23,23,4,9,14,8,15
283,0,0,7.5605449363503405,0.0005203206028835394,28,27,3,8,19,8,20
284,1,1,0.876461608761117,0.70608844326844,20,23,10,9,14,11,9
285,0,0,2.246984996705778,0.09560985036468728,29,34,16,13,21,11,18
286,0,0,3.2371667341295476,0.03779078071881292,10,10,3,3,7,3,7
287,1,0,0.8540910274851439,0.2985753759298251,5,4,0,2,2,2,3
288,0,0,6.593878806493649,0.0013668498158778686,25,26,8,9,17,6,19
289,1,1,2.326815343067487,0.9110736583369742,18,18,3,8,10,11,7
290,0,0,1.0559021535762199,0.2580933369536027,10,9,2,4,5,4,6
291,1,1,3.462719249810243,0.9696082003718817,16,16,2,4,12,12,4
292,0,0,3.823787113621756,0.021377916111718465,25,30,14,9,21,10,15
293,1,0,1.2312502499736375,0.22596267765890532,19,20,6,7,13,6,13
294,0,1,1.9284302955019959,0.8730755755204791,26,36,22,16,20,15,11
295,0,0,0.23531360329570106,0.44144156069268736,23,30,15,11,19,13,10
296,1,1,0.8228415027096698,0.6948391791386641,21,22,4,8,14,13,8
297,1,0,1.0871349072810088,0.25215817787633177,4,3,0,2,1,2,2
298,0,1,0.4359859693894119,0.6073021530725895,23,26,10,10,16,13,10
299,0,0,6.0696516030229795,0.002306645641383276,27,26,2,7,19,7,20
300,0,0,0.6293747846413025,0.3476523170040704,26,27,7,12,15,12,14
301,0,0,5.245171028653827,0.005245261951534408,29,33,13,13,20,9,20
302,1,1,4.608743631037268,0.990133978961643,20,27,14,8,19,15,5
303,1,1,4.461110321776559,0.9885823362104394,16,16,3,4,12,12,4
304,0,1,1.408961113759501,0.8036020322896702,29,35,15,11,24,18,11
305,0,0,5.799003955002496,0.0030214152126349925,23,23,4,8,15,8,15
306,0,1,1.1002198119299837,0.7503012894642649,15,19,9,5,14,10,5
307,1,1,6.080408100055986,0.9977179765039359,17,23,12,4,19,14,3
308,0,0,2.7293465485755832,0.06126373235760019,11,10,0,4,6,4,7
309,1,1,4.664389684009999,0.990663002493385,27,40,24,14,26,17,10
310,1,0,2.609944711253015,0.06850113154469795,13,12,1,4,8,4,9
311,1,1,1.5651247702172277,0.8270874946913411,20,20,5,9,11,11,9
312,0,0,7.146841402818783,0.0007867276423978442,17,16,3,5,11,4,13
313,0,0,1.7687213995785762,0.14570140745203208,16,15,2,6,9,5,11
314,0,0,4.1212785483847885,0.015964750069234146,24,27,10,9,18,8,16
315,1,1,2.268191412514888,0.9062081799153523,19,24,11,6,18,13,6
316,1,1,2.4807888776824694,0.9227840270415332,19,26,15,9,17,13,6
317,0,0,0.05308842190829566,0.4867310107982954,23,22,2,13,9,14,9
318,0,0,9.08219401213031,0.00011365901621884777,14,14,2,0,14,0,14
319,1,1,5.076759696741784,0.9937986012284034,14,15,3,3,12,11,3
